ur,ur,ur,ur,ur,ur,ur,ur,ur,ur,ux,ux,ux,ux,ux,ux,ux,cb,ux,ux,ug,ug,ur
ur,ur,ur,ur,cb,ur,ur,cr,ur,ur,ux,ux,ux,ux,ur,ur,cg,ux,ux,ux,ug,ug,ug
ur,ur,ub,ub,ub,ub,ub,ug,ur,ur,ur,ur,ur,ur,ur,ur,ug,ug,ug,ux,ug,ur,ug
ur,ur,ub,ub,ug,ub,cg,ug,ur,ur,ur,ur,ur,ur,ur,ur,ur,ux,cr,ux,ug,ur,ug
cb,ur,ub,ub,ur,ur,ur,ur,ur,ur,ur,ur,ur,ur,ur,ur,ur,ur,ur,ux,ug,ur,ug
ur,ur,ur,ur,ur,ur,ur,ur,ur,ur,ur,ur,ur,ur,ur,ur,ur,ur,ur,ux,ug,ur,ug
ur,ur,ur,ur,ur,ur,ur,ur,ur,ur,ur,ur,ub,ub,ur,ur,ug,ub,ug,ub,ug,ur,ug
ur,ur,ur,ur,ur,ur,ur,ur,ur,ur,ur,ur,ub,ub,ub,ux,ug,ub,ug,ub,ug,ur,ug
ur,ur,ur,ur,ur,ur,ur,ur,ur,ub,ub,ug,ub,cb,ub,ug,ug,ub,ug,ub,ug,ug,ug
ur,ur,ur,ur,ur,ur,ur,ur,ur,cr,cb,ub,ub,ug,ug,ug,ur,ur,ug,ug,ug,ug,ur
ur,ur,ur,ur,ur,ur,cr,cr,cg,ug,ur,ur,ur,ug,ug,ur,ux,ub,ur,ug,ug,ug,ur
ur,ur,ur,ur,ur,ur,ub,ub,ug,ug,ub,ub,ub,ux,ug,ur,ug,ub,ur,ug,ug,ug,ur
ur,ur,ur,ur,ur,ux,ub,ub,ub,ub,ub,ux,ug,ug,ug,ur,ur,ub,ug,ug,ub,ug,cg
ux,ug,ux,ug,ug,ug,ux,ux,ux,ug,ug,ux,ux,ug,ug,ur,ur,ub,cr,ug,ub,ug,ug
ux,ug,ux,ug,ux,ug,ux,ux,ub,ub,ub,ub,ub,ub,cg,ug,ub,ub,ur,ug,ub,ux,ug
ux,ug,ux,ug,ux,ug,ux,ub,ub,ug,ug,ug,ug,ug,ug,ug,ur,ux,ur,ug,ub,ux,ug
ux,ug,ux,ug,ux,ub,ub,ub,ux,ug,ug,ug,ug,ug,ug,ug,ur,ug,ur,ug,ub,ux,ug
cg,ug,ux,ug,ux,ub,ug,ux,ux,ug,ug,ug,ug,ug,ug,ug,ug,ug,ur,ug,ub,ux,ug
ux,ug,ux,ug,ux,ub,ug,ug,ug,ug,ug,ug,ug,ug,ug,ug,ug,ug,ur,ug,ub,ux,ug
ux,ug,ux,ub,ub,ub,ug,ug,ug,ug,ug,ug,ug,ug,ug,ug,ux,ux,ur,ux,ux,ux,ug
ux,ug,ub,ub,ug,ug,ug,ug,ug,ug,ug,ug,ug,ug,ug,ur,ug,ug,ur,ug,ug,ug,ug
cr,ux,ub,ub,ub,cb,ux,ux,ux,ur,ux,ux,ur,ux,ux,ur,ux,ux,ur,ux,ux,cb,cr
cg,ux,ub,ub,ux,ux,ux,ux,ux,ur,ur,ur,ur,cb,ux,ur,ur,ur,ur,cg,cb,ux,cr