ub,cb,cb,ux,ur,ur,ur,ur,ur,ur,ur,ur,ur,ur,ub,ur,ur,ur,ur,ur,ur,ur,ur
ur,ub,ur,ur,ur,ur,ur,ur,ur,ur,ur,ur,ur,ur,ur,ur,ur,ur,ur,ur,ur,ur,ug
ur,cr,ub,ub,ur,ur,ur,ur,ur,ur,ur,ur,ur,cr,ub,ur,ur,ur,ur,ur,ur,ur,ug
ur,ur,ub,ub,ub,ur,ur,ur,ur,ur,ur,ur,ur,ub,ub,ub,ur,ur,ur,ur,cr,ur,ug
ur,ub,cb,ub,ub,ur,ur,ur,ur,ur,ur,ur,ug,ub,ub,ub,ug,ux,ur,ur,ub,ur,ur
ur,ur,ur,ub,ub,ur,ur,ur,ur,ur,cr,ur,cb,ub,ug,ub,ug,ur,ur,ur,ur,ur,cr
ub,ub,ub,ub,ub,ux,ux,ug,ug,ug,ug,ug,ug,ug,ug,ub,ub,cg,ug,ug,ug,ug,ug
ub,ur,ux,ux,ub,ux,ux,ug,ug,ug,ug,ug,ug,ug,ug,ug,ub,ub,ub,ub,ub,ux,ux
ux,ur,ux,ux,ub,ux,ux,ug,ug,ug,ug,ug,ug,ug,ug,ug,ub,ub,cr,ub,ub,ub,ux
ux,ur,ur,ur,ub,ug,ug,ug,ug,ug,ug,ug,ug,ug,ug,ug,ub,ur,ur,ug,ug,ug,ug
ux,ux,ux,ux,ux,ux,ug,ug,ug,ug,ug,ug,ug,ug,ug,ug,ub,ub,ur,ub,ub,ub,cb
ux,ux,ug,ug,ug,ug,ug,ug,ux,cg,ug,ub,ub,ub,ub,ub,ub,ux,ur,ub,ux,ux,ug
ub,ux,ug,ug,ug,ug,ug,ug,ux,ux,ux,ub,ub,ux,ub,cb,ub,ub,ur,ub,ub,ux,ug
ux,ux,ug,ug,ug,ug,ug,ug,ux,ug,ug,ug,ug,ug,ug,cg,ub,ub,ur,ux,ub,ux,ug
ux,ux,ug,ug,ux,ug,ug,ug,ub,ug,ug,ug,ux,ug,ug,ug,ug,ub,ur,ux,cb,ux,ug
cg,ug,ug,ug,ux,ux,ug,ug,ux,ux,ug,ug,ux,ub,ug,ug,ug,ux,ur,cg,ug,ux,ug
ux,ug,ug,ug,ug,ug,ux,ug,ug,ug,ug,ux,ux,ux,ux,ub,ux,ug,ur,ug,ux,ux,ug
ug,ug,ug,ug,ug,ug,ug,ug,ug,ug,ug,ux,ux,ux,ux,ux,ux,ug,ur,ug,ug,ug,ug
ug,ug,ug,ug,ug,ux,ug,ug,ug,ug,ug,ug,ug,ug,ug,ug,ug,ug,ur,ug,ug,ug,ug
ug,ug,ug,ug,ug,ug,ug,ug,ug,ug,ug,ug,ux,ug,ug,ug,ug,ug,ur,ug,ug,ug,ug
cr,ug,ug,ug,ug,ug,ug,ug,ug,ug,ug,ug,ug,ug,ug,ug,ug,ug,ur,ug,ug,ug,ug
cg,ug,ug,ug,ug,ug,ug,ug,ug,ux,ux,ux,ux,ux,ub,ub,ub,ub,ur,ug,ux,cb,cr
cr,ug,ug,ug,ug,ug,ug,ug,cg,ur,ur,ur,ur,ur,ur,ur,ur,ur,ur,cg,cb,ux,cr