ur,ur,cb,ur,ur,ur,ur,ur,ur,ur,ur,cr,ur,ur,ur,ur,ur,cb,ur,cg,ux,ux,ux
ur,ur,ur,ur,ur,ur,ur,ux,ux,ur,ur,ur,ur,ur,ur,ur,ur,ur,ur,ux,ux,ux,ux
ur,ur,ur,ur,ur,ub,cr,ur,ur,ur,ur,ur,ur,ur,ur,ur,ur,ur,ur,ux,ux,ux,ux
ur,ur,ux,ur,ur,ub,ur,ur,ur,ur,cr,ur,ur,ur,ur,ur,ux,ur,ux,ux,ux,ux,ux
ur,ur,ux,ur,ug,ub,ur,ug,ug,ur,ug,ur,ur,ur,ur,ug,ug,ug,ug,ug,ug,ug,ux
ur,ur,ux,ur,ug,cb,ur,ur,ug,ur,ug,ur,ur,ur,ur,ug,ug,ug,ug,ug,ug,ug,ug
ur,ur,ur,ur,cg,ur,ur,ug,ug,ur,cg,ur,ur,ur,ur,ur,ur,ug,ux,ux,ug,ug,ug
ur,ur,ur,ux,ur,ur,ur,cr,ur,ur,ur,ur,ur,ur,ur,ug,cb,ug,ux,ug,ug,ug,ug
ur,ur,ux,ur,ur,ur,ub,ur,ur,ur,ur,ub,ub,ub,ub,ub,ub,ub,ub,cg,ug,ug,ug
ur,ur,ur,ur,ur,ur,ub,cb,ur,ub,ub,ub,ub,ub,ub,ub,ux,ux,ug,ug,ub,ub,ur
ur,ur,ur,ur,ur,ur,ub,ub,ub,ub,ux,ug,ux,ug,ug,ug,ug,ug,ug,ux,ux,ug,ug
ur,ur,ur,ur,ur,cr,ug,ux,ug,ug,ux,ug,ub,ub,ub,ug,ub,ug,ug,ux,ux,ug,ug
cg,ug,ug,ug,ub,ug,ug,ug,ug,ug,ub,ug,ub,ub,ub,ug,ub,ug,ug,ux,ux,ug,ug
ux,ux,ux,ux,ux,ug,ug,ux,ux,ux,ub,ug,ub,ub,ub,ug,ub,ug,ug,ug,ux,ug,ug
ur,ur,ur,ur,ur,ur,ur,ur,ur,ur,ur,ur,ur,ur,ur,ur,ur,ur,ur,ur,cg,ug,ug
ur,ux,ux,ux,ux,ug,ug,ug,ug,ub,ub,ub,ub,ub,ub,ux,ug,ug,ug,ug,ug,ug,ug
ur,ur,ur,ur,ur,ur,ur,ur,ur,cr,ug,ub,ug,ug,ug,ug,ug,ug,ux,ux,ux,ug,ug
cg,ux,ux,ux,ux,ug,ug,ug,ug,ub,ug,ux,ug,ug,ux,ug,ux,ug,ux,ux,ux,ug,ug
ux,ux,ux,ux,ux,ug,ug,ug,ug,ub,ug,ub,ug,ug,ug,ug,ug,ug,ug,ug,ug,ug,ug
ux,ux,ux,ub,ub,ub,ub,ub,ub,ub,ub,ub,ub,ub,ub,ub,ub,ub,ub,ub,ub,ug,ub
cr,ux,ux,ub,ub,ub,ux,ux,ub,ub,ug,ug,ug,ug,ug,ug,ug,ug,ug,ug,ug,ug,ub
cg,ux,ux,ub,ub,ub,ub,cb,ub,ub,ux,ux,ux,ux,ux,ux,ux,ux,ux,ux,ux,cb,cr
cr,ux,ux,ub,ub,ug,ub,ub,ub,ub,ux,ux,ux,cb,ux,ux,ux,ux,ux,ux,cb,ux,cr