ur,ur,ur,ug,ug,ug,ug,ug,ug,ug,ug,ug,ug,ug,ug,ug,ug,ug,ug,ug,ug,ug,cg
ur,ur,ur,ur,ur,ur,ur,ur,ur,ur,ur,ur,ur,ur,ur,ur,ur,ur,ur,ur,ur,ur,ur
ur,ur,ur,ur,ur,ur,ur,ur,ur,ur,ur,ur,ur,ur,ur,ur,ur,ur,ur,ur,ux,ur,ur
ur,ur,ur,ur,ur,ur,ur,ur,ur,ur,ur,ur,ur,ur,cr,ur,ur,ur,ur,ur,ur,ur,ur
ur,ur,ur,ur,ur,ur,ur,ur,ur,ur,ur,ur,ub,ub,cr,ur,ur,ur,ur,ur,ur,ur,ur
ur,ur,ur,ur,ur,cg,ur,ur,ur,ur,ur,ur,ub,ub,ur,ur,ur,ur,ur,ur,ur,ur,ur
ur,ur,ur,ur,ur,ug,ur,ur,ur,ur,ur,cb,ub,ub,ur,ur,ur,ur,ur,ur,ux,ur,ur
ur,ur,ur,ur,ur,ug,ur,ur,ur,ur,ur,ux,ur,ug,ug,ur,ur,ur,ur,ur,ur,cr,ur
ur,ur,ur,ur,ur,cr,ug,ug,cr,ug,ug,ug,ub,ug,cr,ub,ur,ur,ur,ur,ur,ux,ux
ur,cb,ur,ug,ux,ux,ux,ux,ub,ub,ub,ub,ub,ug,ur,ub,ub,ug,ux,ur,ur,ux,ux
ux,ub,ug,ug,ug,ug,ug,ug,ub,ub,ug,ug,cg,ug,ur,ub,ub,ug,ux,ur,ur,ux,ux
ux,ub,ub,ug,ux,ux,ub,ub,ub,ub,ub,ug,ub,ug,ur,ub,ub,ug,ux,ur,ur,ux,ux
ux,ux,ub,ug,ux,ux,ub,cb,ub,ub,ub,ub,ub,ug,ur,ug,ug,ux,ux,ur,ur,ux,ux
ux,ux,ub,ug,ux,ux,ub,ub,ub,ub,ub,ub,ub,ub,ur,ux,ug,ux,ux,ur,ur,ux,ux
ux,ux,ub,ug,ux,ux,ub,ub,ub,ub,ub,ub,ub,ub,ur,ug,ug,ug,ug,ur,ur,ux,ux
ux,ux,ub,ux,ux,ux,ux,ux,ub,ub,ub,ug,ug,ub,ur,ug,ug,ug,ug,ur,ur,ux,ux
ux,ux,ub,ux,ux,ux,ux,ux,ub,ub,ub,cb,ub,ub,ur,ug,ug,ug,ug,ur,ur,ux,ux
ux,ux,ub,ux,ux,ux,ux,ux,ux,ux,ub,ub,ub,ub,ur,ug,ug,ug,ug,ur,ur,ux,ux
ux,ux,ub,ux,ux,ux,ux,ux,ux,ux,ub,ub,ub,ub,ur,ug,ux,ux,ux,ur,ur,ux,ux
ux,ux,ub,ub,ux,ux,ux,ux,ux,ux,ux,ux,ub,ur,ur,ux,ux,ux,ux,ur,ur,ux,ux
ux,ux,ux,ub,ub,ub,ub,ub,ub,ub,ub,ub,ub,ub,ur,ub,ub,ub,ub,ur,ur,ux,ux
ux,ux,ux,ux,ux,ux,ux,ux,ux,ux,ux,ux,ux,ur,ur,ur,ur,ur,ur,ur,ur,ux,ux
cb,ux,ux,ux,ux,ux,ux,ux,ux,ux,ux,ux,ux,ur,ur,ur,ur,ur,ur,ur,ur,cb,ux