ur,ur,ur,ur,ur,ur,ur,ux,ur,ur,ur,ur,ur,ur,ur,ur,ur,ur,cb,ur,ur,ur,ur
ur,ur,ur,ur,ur,ur,ur,ur,ur,ur,ur,ur,ur,ur,ur,ux,ur,cr,ub,ur,ur,ur,ur
ur,ur,ur,ur,ur,ur,ur,ur,ur,ur,ur,ur,ur,ur,ur,ux,ur,ur,ur,ur,ur,ur,ur
ux,ux,ur,ur,ur,ur,ur,ur,ur,ur,ur,ur,ur,ur,ur,ur,ur,ur,ur,ur,ur,ur,ur
ux,ux,ur,ur,ur,ur,ur,ur,ur,cr,ur,ux,ux,ur,ur,ur,ur,ur,ur,ur,ur,cr,ur
ux,ux,ur,ux,ur,cg,ur,ur,ur,cr,ur,ur,ux,ur,ux,ux,ur,ur,ux,ux,ux,ur,ur
ux,ux,ur,ur,ur,cr,ur,ur,ur,ug,ur,ur,ur,ur,ur,ur,ur,ur,ux,ux,ux,cr,ur
ux,ux,ur,ux,ur,ur,ur,ur,cg,ug,ur,ur,ur,ur,ur,ur,ur,ur,ux,ux,ux,ur,cb
cg,ur,ur,ur,ur,ur,ur,ur,ur,ur,ur,ur,ub,ub,ux,ug,ug,ux,ux,ux,ux,ur,cg
ur,ur,ur,ur,ur,ur,ur,ur,ug,ub,ur,ur,ub,ub,ug,ug,ux,ux,ux,ux,ux,ur,ug
ur,ur,ur,ur,ur,ur,ur,ur,ug,ub,ug,ug,ug,ub,ux,ux,ux,ux,ux,ub,ub,ur,ug
ur,ur,ur,ur,ur,ug,ug,ur,ub,ub,ub,ub,ug,ub,ux,ux,ux,ux,ux,ub,ub,ur,ug
ur,ur,ur,ur,ur,ug,ug,ur,cb,ub,ub,ub,ug,ub,ug,ux,ux,ux,ux,ub,ub,ur,ug
ur,ur,ur,ur,ur,ur,ur,ur,ur,ur,ux,ug,ug,ub,ub,ub,ux,ub,ub,ub,ux,ur,ug
cg,ur,ur,ur,ur,ur,ub,ub,ug,ug,ug,ug,ug,ug,ux,ub,ub,ub,ux,ux,ux,ur,ug
ux,ux,ub,ux,ux,ux,ub,ub,ug,ug,ug,ug,ug,ug,ub,ux,ub,ub,ux,ux,ux,ur,ug
ux,ux,ub,ux,ub,ub,ub,ub,ug,ug,ug,ug,ug,ub,cb,ub,ub,ub,ub,ub,ub,ub,cb
ux,ux,ub,ux,ux,ux,ub,ub,ub,ub,ub,ur,ug,ug,ux,ux,ux,ux,ux,ux,ux,ur,ug
ux,ux,ub,ux,ux,ux,ub,ub,ub,ub,ux,ur,ux,ug,ux,ux,ux,ux,ux,ux,ux,ur,ug
ux,ux,ub,ux,ux,ux,ux,ux,ub,cb,ux,ur,ux,ug,ux,ux,ux,ux,ux,ux,ux,ur,ug
ur,ur,ub,ur,ur,ur,ux,ux,ur,ub,ub,ur,ur,ug,ux,ur,ur,ur,ur,ur,ur,ur,ug
ur,ux,ub,ub,ub,ub,ub,ub,ub,ub,ub,ub,ur,ug,ub,ur,ub,ub,ub,ub,ur,ub,ug
ur,ur,ur,ur,ur,ur,ur,ur,ur,cg,ux,ux,ur,ug,ug,ug,ug,ug,ug,ug,ug,ug,ug