cr,ur,ur,ur,ur,ur,ur,ur,ug,ug,ug,cr,ur,ur,ur,ur,ur,cb,ur,ur,ur,ur,ur
ug,ur,ur,ur,ur,ux,ux,ur,ur,ur,ux,ux,ux,ux,ug,ur,ur,ur,ur,cr,cr,ur,ur
ug,ur,ur,ur,ur,cb,ur,ur,ur,ur,ur,ur,ur,ur,ur,ur,ur,ur,ur,ur,ur,ur,ub
ug,ug,cg,ur,ur,ub,ur,ur,ur,ur,ur,ur,ur,ur,ur,ur,ur,ur,ub,ug,ug,ur,ub
cb,ur,ur,ub,ub,ub,ur,ur,ur,ur,ur,ur,ur,ur,ur,ur,ur,ug,ub,ug,ug,ur,ub
ur,ur,ur,ub,ub,ub,ur,cr,ug,ur,ur,ur,ur,ur,ur,ug,ug,ug,ub,ug,ug,ur,ub
ur,ur,ur,ur,ug,cg,ug,ug,ug,ug,ug,ub,ur,ur,ur,ug,ug,ub,ub,ug,ug,ub,ub
ur,ur,ur,ur,ur,ub,ur,ug,ug,ug,ug,ub,ur,ur,cr,ug,ub,ub,ug,ug,ug,ub,ub
ux,ux,ug,ug,ur,ur,ur,ug,ug,cg,ug,ug,ur,ug,ux,ug,ub,ub,ug,ug,ug,ub,ub
ux,ux,ux,ug,ux,ub,ub,ug,ug,ug,ug,ux,ur,ux,ux,ug,ub,ug,ub,ug,ug,ub,ug
ux,ux,ux,ug,ux,ub,ub,ub,ub,ux,ux,ux,ur,ux,ug,ug,ub,ug,ux,ug,ux,ur,ug
ux,ux,ux,ug,ug,ug,ub,ub,ub,ug,ug,ug,ur,ug,ug,ug,ub,ug,ug,ug,ug,ug,ug
ux,ux,ux,ux,ux,ux,ub,ub,ub,ub,ug,ug,ur,ug,ug,ug,ub,ug,ux,ug,ux,ux,cg
ux,ux,ux,ux,ux,ub,ub,ub,ug,ub,ub,ux,ur,ux,ux,ux,ub,ug,ux,cg,ux,ux,ux
ux,ux,ux,ux,ux,ub,ub,ub,ug,cb,ub,ug,cb,ug,ug,ug,ub,ug,ux,ux,ux,ux,ux
ux,ux,ux,ux,ux,ub,ub,ub,ug,ub,ub,ub,ub,ux,ux,ug,ub,ug,ux,ux,ux,ux,ux
ux,ux,ux,ux,ux,ux,ub,ub,ug,ug,ub,ub,ur,ug,ug,ug,ub,ug,ux,ux,ux,ux,ux
cg,ux,ux,ux,ux,ux,ub,ub,ux,ug,ub,ub,ur,ug,ug,ug,cb,ug,ux,ux,ux,ux,ux
ux,ux,ux,ux,ux,ux,ub,ub,ux,ub,ub,ux,ur,ux,ux,ux,ux,ux,ux,ux,ux,ux,ux
ux,ux,ux,ux,ux,ux,ub,ux,ux,ub,ux,ux,ur,ux,ux,ux,ux,ux,ux,ux,ux,ux,ux
ux,ux,ux,ux,ux,ux,ub,ux,ux,ub,ux,ux,ur,ux,ux,ux,ux,ux,ux,ux,ux,ux,ux
cr,ux,ux,ux,ux,ux,ub,ux,ux,ub,ux,ux,ur,ux,ux,ux,ux,ux,ux,ux,ux,cb,cr
cg,ux,ux,ux,ux,ux,ub,ub,ub,ub,ur,ur,ur,cb,ux,ux,ux,ux,ux,cg,cb,ux,cr