ux,cb,cb,cr,cb,ur,ur,ur,ur,ur,ur,ub,cb,ur,ur,ur,ur,ur,ur,ur,ur,ur,cb
ux,ux,cb,ux,ur,ur,ur,ur,ur,ur,cr,ub,cr,ur,ur,ur,ur,ur,ur,ur,ur,ur,ur
ux,ux,ux,ux,ur,ur,ur,ur,ur,ur,ur,ur,ur,ur,ur,ur,ur,ur,ur,ur,ur,ur,ur
ur,ur,ur,ur,ur,ur,ur,ur,ur,ur,ur,ur,ur,ur,ug,ug,ux,ur,ur,ur,ur,ur,ur
ur,ur,ur,ur,ur,ur,ur,ur,ur,ur,ur,ur,ur,ug,ug,ug,ur,ur,ur,ur,ur,ur,ur
ur,ur,ur,ur,ur,ur,ug,ur,ur,ur,ur,ur,ur,ug,ug,ug,ur,ug,ux,ux,cr,ur,ug
ur,ur,ur,ur,ur,ug,cg,ur,ur,ur,ur,ur,ur,ug,ug,ug,ug,ug,ux,ux,ux,ux,ug
cb,ur,ur,ur,cr,ur,cr,ur,ur,ur,ug,ur,ur,ug,ug,ur,ug,ur,ux,ux,ux,ux,ug
ur,ur,ux,ur,ug,cg,ur,ur,ur,ug,ur,ur,ug,ug,ug,ug,ug,cg,ux,ux,ux,ux,ug
ur,ur,ux,ur,ur,ur,ur,ur,ug,ug,ux,ux,ug,ug,ug,ug,ux,ux,ux,ux,ux,ux,ug
ur,ur,ur,ur,ur,ur,ur,ur,ug,ug,ux,ux,ug,ug,ug,ug,ux,ux,ux,ux,ux,ux,ug
ur,ug,ug,ug,ug,ug,ug,ug,ug,ug,ub,ub,ug,ug,ug,ug,ug,ub,ub,ub,ub,ub,cb
cb,ub,ub,ub,ub,ux,ux,ux,ux,ug,ub,ug,ug,ug,ug,ug,ug,ug,ug,ux,cb,ug,cg
cb,ub,ub,ub,ub,ub,ug,ug,ub,ug,ub,ug,ug,ug,ug,ug,ug,ug,ug,ux,ub,ub,ub
ub,ug,ub,ug,ug,ug,ug,ub,ub,cg,ub,ug,ug,ug,ug,ug,ug,ug,ux,ux,ub,ub,ub
ug,ug,ug,ug,ug,ug,ug,ug,ub,ub,ub,ub,ug,ug,ur,ug,ux,ux,ux,ux,ub,ub,ub
ug,ug,ug,ug,ug,ug,ug,ug,ub,ub,ub,ux,ux,ug,ub,ub,ub,ub,ub,ub,ub,ub,ub
ug,ug,ug,ug,ug,ug,ug,ug,ur,ur,ub,ub,ub,ub,ub,ur,ur,ur,ur,ur,ur,ur,ur
ub,ug,ug,ug,ug,ug,ug,ug,ux,ux,ux,ux,ux,ux,ug,ux,ux,ux,ux,ux,ux,ux,ur
cr,ur,cg,ug,ug,ug,ug,ug,ug,ur,ur,ur,ur,ur,ur,ur,ur,ur,ur,ur,ur,ur,ur
cg,ur,ug,ug,ug,ug,ug,ug,ug,ux,ux,ux,ux,ux,ug,ug,ug,ug,ux,ux,ux,ux,cr
cr,ur,ur,ur,ur,ur,ur,ur,ug,ux,ux,ux,ux,cr,ug,ug,ug,ug,ux,cb,cb,ux,cr
cg,ur,cg,cb,ug,ug,ug,ur,ur,ur,ur,ur,ur,ur,ur,cg,ug,ug,ux,cg,cg,cb,cr