ur,cb,cb,cr,cb,ur,ur,ur,ur,ur,ur,ur,ur,ur,ur,ug,ug,ug,ur,ur,ub,ub,cb
ur,ur,cb,ur,ur,ur,ur,ur,ur,ur,ur,ur,ur,ur,ug,ug,ur,ug,ur,ur,ub,ub,ux
ur,ur,ur,ur,ur,ur,ur,ur,ur,ur,ur,ur,ur,ur,ug,ur,ur,ug,ur,ur,ug,ug,ug
ur,ur,ur,ur,ur,ur,ur,ur,ur,ur,ur,ur,ur,ur,ug,ug,ur,ug,ur,ur,ux,ux,ug
ur,ur,ur,ur,ur,ux,ur,ur,ur,ur,ur,ug,cr,ur,ur,ug,ur,ug,ux,ux,ux,ux,ug
ur,ur,ur,ur,ur,ur,ur,ur,ur,ur,cg,ug,ur,ur,cr,ug,ur,ug,ux,ux,ux,ur,ug
ur,ur,ur,ur,ur,ur,ug,cr,ur,ur,ub,ub,cb,ur,ur,ug,ug,ug,ug,ux,ux,ur,ug
cb,ur,ur,ur,ur,ur,cg,cr,ur,ur,ur,ur,ur,ur,ur,ur,ug,ur,ug,ug,ug,ur,ug
ur,ur,ur,ux,ur,ur,ur,ur,ur,ub,ub,ub,ub,ur,ur,ux,ug,ug,ug,ug,ug,ur,ug
ur,ur,ur,ur,ur,ur,ur,ur,ug,ug,ug,ux,ux,ux,ux,ux,ug,ug,ug,ug,ug,ur,ug
ur,ur,ur,ux,ur,ur,ur,ur,ug,ug,ug,ux,ub,ub,ux,ux,ug,ux,ug,ug,ug,ur,ug
ur,ur,ur,ub,ug,ug,ux,ug,ux,ug,ub,ub,cg,ug,ug,ug,ug,ub,ub,ub,ub,ub,cb
cb,ur,ur,cr,ug,ug,ug,ub,ux,ux,ub,ug,ug,ug,ug,ug,ug,ug,ug,ug,ur,ug,cg
cb,ub,ub,ub,ub,ub,ub,ug,ub,ub,ub,ug,ug,ug,ug,ug,ug,ug,ug,ug,ur,ug,ux
ub,ub,ub,ub,ub,ub,ub,ub,ub,ub,ub,ug,ug,ug,ug,ug,ug,ug,ux,ux,ur,ug,ux
ub,ub,ub,ub,cg,ub,ug,ug,ub,ub,ub,ub,ug,ug,ur,ug,ux,ux,ux,ux,ur,ug,ux
ub,ub,cb,ug,ug,ug,ug,ug,ug,ug,ug,ug,ug,ug,ug,ug,ux,ux,ux,ux,ur,ug,ux
ug,ug,ug,ug,ug,ug,ug,ur,ur,ur,ur,ur,ur,ur,ur,ur,ur,ur,ur,ur,ur,ur,ur
ub,ub,ug,ug,ug,ug,ub,ux,ux,ux,ux,ux,ug,ux,ug,ub,ub,ub,ub,ub,ub,ub,ur
cr,ux,ug,ug,ug,ux,ux,ux,ux,ux,ux,ug,ug,ub,ug,cr,ur,ur,ur,ur,ur,ur,ur
cg,cg,ug,ug,ug,ux,ux,ug,ug,ug,ug,ug,ux,ub,ug,ug,ug,ug,ux,ux,ux,ux,cr
cr,ug,ug,ug,ug,ug,ug,ug,ug,ug,ug,ux,ux,ug,ug,ug,ug,ug,ux,cb,cb,ux,cr
cg,ug,cg,cb,ug,ug,ug,ug,ug,ug,ug,ug,ug,ug,ur,cg,ug,ug,ux,cg,cg,cb,cr