ub,ub,ub,ub,ub,ub,cr,ur,ur,ur,ur,ur,ur,ur,ub,ub,ub,ub,ur,ub,ub,ub,ub
ub,ub,ub,ur,ur,ur,ur,cr,ur,ur,ur,ub,ub,ub,ub,ur,ur,ub,ub,ub,ur,ub,ub
ur,ur,ub,ur,ur,ur,ur,ur,ug,ug,ug,ug,ug,ug,cg,ur,ur,ur,ur,ur,ur,ub,ur
ub,ub,ub,ur,ur,ur,ur,ub,ur,ur,cr,ub,ub,ug,ug,ug,ug,ug,ug,ug,cg,ub,ur
cb,ur,ur,ur,ur,ur,ur,ub,ur,ur,ur,ur,ub,ur,ug,ux,ug,ug,ug,ug,ug,ub,ub
ur,ur,ur,ur,ur,ug,ug,ur,ug,ur,ug,ur,ub,ug,ug,ub,ug,ub,ub,ug,ug,ub,ub
ur,ur,ur,ub,cr,cb,ub,ur,ur,ux,ug,ug,ub,ug,ug,ug,ug,ux,ub,ug,ug,ub,ub
ur,ur,ur,ub,ur,ug,ub,ur,ur,ug,ug,ub,ub,ug,ux,ub,ub,ub,ub,ug,ug,ub,ub
ur,ux,ux,ub,ur,ur,ub,ug,ug,ug,ug,ub,ug,ug,ub,ub,ub,ub,ux,ug,ug,ux,ub
ur,ur,cr,ux,ux,ub,ub,ub,ub,ub,ub,ub,ug,ux,ub,ub,ub,ub,ub,ug,ug,ur,ub
ub,ux,ux,ux,ux,ub,ub,ub,ub,ub,ub,ub,ub,ug,ub,ub,ub,ub,ub,ug,ug,ux,ub
ub,ux,ux,ux,ux,ux,ux,ux,ub,ub,cb,ub,ub,ub,ub,ub,ux,ux,ux,ug,ug,ub,ub
ub,ux,ux,ux,ux,ux,ux,ux,ub,ub,ub,ub,ub,ub,ub,ub,ug,ug,ub,ug,ug,ub,ub
ub,ux,ux,ux,ux,ux,ub,ub,ub,ub,ub,ug,ub,ug,ug,ug,ug,ug,ux,ug,ug,ub,ub
ub,ux,ux,ux,ux,ux,ux,ub,ub,ux,ub,ug,ub,ug,ug,ug,ug,ug,ux,ug,ug,ub,ub
ub,ux,ux,ux,ux,ux,ux,ub,ub,ux,ub,ug,ug,ug,ug,ug,ug,ug,ug,cg,ub,ux,ub
ub,ux,ux,ux,ux,ux,ux,ux,ux,ux,ux,ux,ug,ug,ug,ub,ug,ug,ub,ub,ub,ux,ub
ub,ux,ux,ux,ux,ux,ux,ux,ux,ux,ux,ux,ug,ug,ug,ub,ug,ux,ux,ur,ux,ux,ub
ub,ux,ux,ux,ux,ux,ux,ux,ux,ux,ux,ux,ux,ub,ub,ub,ug,ux,ux,ur,ux,ux,ub
ub,ub,ub,ub,ub,ub,ub,ub,ub,ub,ub,ub,ub,ub,ub,ub,ub,ub,ub,ub,ux,ux,ub
ub,ub,ub,ub,cb,ux,ux,ux,ux,ux,ux,ux,ux,cb,ux,ux,ux,ux,ux,ub,ub,ub,ub
ub,ux,ux,ux,ux,ux,ux,ux,ux,ux,ux,ux,ux,ux,ux,ux,ux,ux,ux,ur,ur,ur,ur
cb,ur,ur,ur,ur,ur,ur,ur,ur,ur,ur,ur,ur,ur,ur,ur,ur,cr,ux,ur,ur,ur,ur