ux,ux,ur,ur,ur,ur,ur,ur,ur,ur,ur,ur,ur,ur,ur,cr,ux,ux,ur,ur,ub,ub,cb
ux,ux,ux,ur,ur,ur,ur,ur,ur,ur,ur,ur,ur,ux,ux,ux,ur,ur,ur,ur,cr,ur,ur
ux,ur,ur,ur,ur,ur,ur,ur,ur,ur,ur,ur,ur,ux,ux,ux,ur,ub,ub,ub,ub,ub,ub
ux,ur,ur,ur,ur,ur,ur,ur,ur,ur,ur,ur,ur,cr,ug,ug,ur,ub,ub,ub,ub,ux,ub
ux,ur,ur,ur,ur,ur,ur,ur,ur,ur,ur,ur,ur,ug,ur,ug,ur,ur,ub,ub,ub,ub,ub
ur,ur,ux,ur,ur,ur,ur,ur,ur,ur,ur,ur,ur,ur,ur,ug,ur,ur,ur,ur,ub,ub,ub
ur,cb,ux,ur,ur,ur,cr,ur,ur,ur,ur,ur,ur,ur,ur,ug,ur,ur,ux,ur,ub,ub,ub
ur,ub,ur,ur,ur,ur,ug,ur,ur,ur,ur,ur,ur,ur,ur,cr,ug,ug,ug,ug,ug,ug,ug
cg,ub,ur,ur,ur,ur,ug,ur,ur,ug,cg,ur,ur,ur,ur,ur,ub,ub,ub,ub,ub,ub,ug
ub,ub,ur,ur,ux,ux,ug,ug,ur,ug,ur,ub,ur,ur,cb,ub,ub,ub,ub,ub,ub,ub,ug
ub,ur,ur,ur,ux,ux,cg,ug,ub,ug,ug,ug,ug,ug,ub,ug,ub,ub,ur,ur,ur,ur,cg
ub,ub,ur,ur,ur,ur,ur,ub,ub,ub,ur,ub,ub,ub,ub,ug,ub,ub,ux,ub,ub,ub,ub
ub,ub,ur,ur,ur,ur,ur,cb,ub,ub,ur,ur,ur,ug,ug,ug,ub,ub,ux,ux,ux,ux,ux
ub,ub,ur,ur,ur,ur,ur,ur,ub,ux,ux,ux,ub,ug,ur,ub,ub,ub,ux,ux,ux,ux,ux
cg,ub,ux,ux,ux,ux,ub,ub,ub,ub,ub,ux,ub,ug,ub,ub,ux,ub,ux,ux,ux,ux,ux
ub,ub,ug,ug,ug,ug,ub,ub,ub,cb,ub,ub,ub,ub,ub,ub,ub,ub,ux,ux,ux,ux,ux
ub,ur,ug,ug,ug,ug,ub,ub,ub,ub,ub,ub,ub,ub,ub,ub,ub,ub,ux,ux,ux,ux,ux
ub,ub,ug,ux,ug,ug,ub,ub,ub,ub,ub,ub,ub,ux,ub,ux,ux,ub,ux,ux,ux,ux,ux
ub,ub,ug,ug,ug,ug,ub,ub,ug,ux,ub,ub,ux,ux,ub,ux,ux,ub,ux,ux,ux,ux,ux
ub,ub,ug,ug,ug,ug,ub,ub,ug,ug,ug,ux,ux,ux,ub,ux,ux,ub,ux,ux,ux,ux,ux
ub,ub,ux,ux,ux,ux,ux,ur,ux,ux,ux,ux,ux,ux,ub,ux,ub,ub,ux,ux,ux,ux,ux
ub,ub,ub,ub,ub,ub,ub,ub,ub,ub,ub,ub,ux,ux,ub,ux,ub,ux,ux,ux,ux,ux,cb
ub,ub,ux,ux,ux,ux,ux,ux,ux,cg,ux,ub,ub,ub,cb,ur,ur,ur,ur,cr,ux,ux,ux