ur,cb,cb,cr,ux,ux,ux,ux,ux,ur,ur,ur,ur,ur,ur,ur,ur,ur,ur,cb,ub,ur,cb
ur,cb,cb,ux,ux,ux,ux,ux,ux,ur,ur,ur,ur,cr,ur,ur,ur,ur,ur,ur,ub,ur,ur
cr,ub,ub,ub,ur,ur,ur,ur,ur,ur,ur,ur,ur,ug,cg,ug,ur,ur,ur,cr,ub,ur,ur
ub,ux,ub,ub,ur,ur,ur,ur,ur,ur,ur,ur,ur,ur,ug,ur,ur,ur,ur,ur,ur,ur,ur
cb,ux,ub,ub,ur,ur,ur,ug,cg,ur,ur,ur,ur,ur,ur,ur,ur,ur,ur,ur,ur,ur,ur
ur,ux,ux,ux,ur,ur,ug,ug,ur,ur,ur,ur,ur,ur,ur,ur,ur,ur,ur,ur,ur,ur,ur
ur,ur,ur,ur,ug,ug,ug,ur,ur,ur,ur,ur,ur,ug,ug,ug,ug,ug,ur,ur,ur,ur,ur
cb,ur,ur,ur,ug,ur,ur,ur,ur,ur,ur,ur,ur,ur,ur,ur,ux,ux,ux,ug,ub,ux,ux
ur,ur,ur,ug,cr,ur,ur,ur,ur,ub,ub,ur,ur,ur,ug,ux,ux,ug,ug,ug,ub,ub,ub
ur,ur,ur,ur,ur,ur,ur,ur,cb,ub,ub,ug,ug,ug,ug,ux,ux,ug,ux,ux,ux,ux,ub
ur,ur,ur,ur,ur,ur,ur,ur,ub,ub,ub,ug,ug,ug,ug,ux,ux,ug,ux,ub,ub,ub,ub
ur,ur,ur,ur,ur,ur,ug,ug,ug,ub,ug,ug,cg,ug,ug,ux,ux,ug,ux,ub,ub,ub,ub
cb,ur,ur,ub,ug,ug,ug,ug,ug,ub,ub,ub,ub,ug,ug,ug,ux,ug,ub,ub,ub,ub,ub
ur,ur,ug,ug,ug,ug,ug,ug,ug,ub,ub,ub,ub,ub,ub,ug,ub,ug,ug,ux,ux,ux,ux
cr,ug,ug,cr,ug,ug,ux,ug,ug,ub,ub,ug,ug,ub,ug,ug,ub,ug,ug,ux,ux,ux,ux
cg,ug,ug,ur,ug,ug,ug,ug,ug,ug,ug,cb,ub,ub,ug,ug,cg,ug,ug,ux,ux,ux,ux
ux,ug,ug,ur,ug,ug,ug,ug,ug,ug,ug,ub,ub,ub,ub,ub,ug,ug,ug,ub,ub,ub,ub
ux,ug,ug,ur,ug,ug,ug,ug,ux,ux,ug,ug,ux,ux,ub,ux,ub,ug,ug,ub,ub,ub,ub
ux,ug,ug,ur,ug,ux,ug,ug,ux,ux,ub,ux,ux,ux,ub,ux,ug,ug,ux,ux,ux,ux,ub
ux,ug,ug,ur,ug,ux,ug,ug,ug,ug,ug,ug,ug,ug,ug,ug,ug,ur,ub,ub,ub,ub,ub
cr,ug,ug,cb,ub,ub,ug,ur,ur,ur,ur,ur,ur,ur,ur,ur,ur,ur,ub,ux,ux,ux,cr
cg,ug,ug,ug,ug,cg,ub,ub,ub,ub,ub,ub,ub,ub,ub,ub,ub,ub,ub,cb,cb,ux,cr
cr,cg,cg,cb,ug,ug,ux,ux,ux,ux,ux,ux,ux,ux,ux,cg,ur,ur,ur,cg,cg,ux,cr