ur,cb,ub,ur,ur,ur,ur,ur,ur,ur,ur,ur,ur,ur,ur,ur,ur,ur,ur,ur,ur,ur,cb
ur,cr,ub,ug,ug,ug,ug,ug,ug,ug,ug,ug,ug,ug,ug,ug,ur,ur,ur,ur,ur,ur,ur
ur,ug,ug,ux,ux,ur,ug,ug,ug,ug,ug,ug,ug,ug,ug,ug,ur,ur,ur,ur,ur,ur,ur
ur,ur,cr,ug,ux,ur,ug,ug,ug,ug,cg,ur,ux,ur,ur,ur,ur,ur,ur,ur,ur,ur,ur
ur,ur,ur,ug,ug,ug,ux,ux,ur,ur,ux,ur,ur,ur,ur,ur,ur,ux,ur,ur,ur,ur,ur
ur,ur,ur,ur,ur,ug,ur,ur,ur,ur,ur,ug,ug,ug,ur,ur,ur,ur,ur,ur,ur,ur,cr
ur,ur,ur,ur,ur,ur,ur,ur,ur,ur,ur,cg,ub,ub,cb,ur,ux,ux,ux,ur,ur,ur,ur
ur,cb,ur,ur,ur,ur,ug,ug,ug,ug,cr,ub,ub,ug,ug,ug,ux,ux,ur,ur,ur,ur,ub
cg,ub,ur,ur,ur,ur,ug,ug,ug,ug,ur,ur,ur,ug,ur,ug,ug,ug,ur,ur,ub,ub,ub
ur,cr,ur,ur,ur,ur,ug,ug,ug,ur,ug,ub,ur,ur,ur,ug,ug,ug,ur,ur,ub,ux,ug
ur,ur,ur,ur,ur,ur,ur,ur,ub,ub,ub,ub,ub,ub,ug,ug,ug,ug,ux,ux,ub,ub,ub
ur,ur,ur,ur,ur,ur,ur,ur,ub,ur,ur,ub,ub,ub,ur,ug,ux,ux,ux,ux,ux,ub,ub
ub,ur,ur,ur,ur,ur,ur,cb,ub,ub,ub,ub,ub,ub,ub,ug,ux,ux,ux,ux,ux,ub,cb
ub,ux,ub,ur,ur,ur,ur,ug,ug,ug,ug,ub,ub,ub,ub,ub,ub,ub,ub,ub,ub,ub,ub
ub,ux,ub,ug,ux,ux,ur,ub,ub,ub,ug,ug,ug,ug,ug,ug,ug,ug,ug,ug,ug,ug,ug
ub,ux,ux,ug,ux,ux,ur,ub,ub,ub,ub,ub,ux,ux,ux,ux,ux,ux,ux,ux,ux,ux,ug
ub,ux,ux,ux,ux,ux,ur,ub,ub,ub,ub,ub,ux,ux,ux,ux,ux,ux,ux,ux,ux,ux,ug
ub,ux,ux,ux,ux,ux,ur,ub,ub,ug,ux,ux,ux,ux,ux,ux,ux,ux,ux,ux,ux,ux,cg
ub,ux,ux,ux,ux,ux,ur,ub,ub,ux,ux,ux,ux,ux,ux,ux,ux,ux,ux,ux,ux,ux,ub
ub,ux,ux,ux,ux,ux,ur,ub,ux,ux,ux,ux,ux,ug,ug,ug,ug,ug,ux,ux,ux,ux,ub
ub,ug,ug,ug,ug,ug,ur,ub,ug,ug,ug,ug,ug,ug,ux,ux,ux,ug,ux,ug,ug,ug,ub
ub,ux,ux,ux,ux,ux,ur,ub,ux,ux,ux,ux,ux,ux,ux,ux,ux,ug,ug,ug,ux,ux,ub
ub,ub,ub,ub,ub,ub,ur,ur,ur,ur,ur,ur,ur,ur,ur,cr,ub,ub,ub,ub,ub,ub,ub