cb,cb,cb,cr,ur,ur,ur,ur,ur,ur,ur,ur,ur,ur,ur,ub,ub,ub,ur,ur,ur,ur,cb
ur,ur,ur,ur,ur,ur,ur,ur,ur,ur,ur,ur,ur,ur,cr,ug,ub,ub,cb,ur,ur,ur,ux
ub,ub,cr,ub,ub,ub,ur,ur,ur,ur,ur,ur,ur,ub,ur,cg,ub,ub,ub,ub,cr,ur,ur
ub,ur,ur,cg,ug,ub,ur,ur,ur,ub,ub,cb,ur,cr,ur,ub,ub,ub,ur,ub,ub,ur,ur
ub,ub,cb,ug,ug,ub,ur,ur,ur,cr,ur,ur,ur,ur,ur,ub,ub,ub,ub,ub,ub,ux,ux
ug,ug,ug,ur,ur,ub,ur,ur,ur,ub,ur,ur,ur,ur,ur,ub,ub,ub,ub,cb,ub,ur,ur
ug,ug,ug,ub,ub,ug,ug,ug,ur,ur,ur,ux,ux,ub,ur,ur,ur,ur,ur,ur,ub,ur,ur
cb,ug,ug,ub,ub,ug,ug,ug,ug,ug,ug,ug,ug,ug,ug,cg,ub,ub,ub,ub,ub,ur,ur
ux,ux,ux,ub,ux,ub,ub,ub,ub,ux,ux,ux,ux,ug,ug,ur,ur,ur,ur,ur,ur,ur,ur
ux,ub,ub,ub,ub,ub,ub,ub,ub,ug,ug,ug,ux,ug,ux,ur,ub,ur,ur,ur,ur,ur,ur
ux,ub,ub,ub,ux,ux,ub,ub,ub,ug,ub,ug,ug,ug,ux,ur,ub,ur,ur,ur,ur,ur,ur
ux,ux,ub,ub,ub,ub,ub,ux,ux,ug,ub,ug,ug,ug,ux,ur,ub,ur,ur,ur,ur,ur,ur
cb,ux,ub,ub,ub,ux,ug,ug,ug,ug,ug,cg,ub,ug,ub,ub,ub,ub,ug,ug,ug,ur,ur
ub,ub,ub,ub,ub,ub,ug,ux,ug,ug,ub,ug,ub,ub,cb,ub,ug,ub,ug,ug,ug,ur,ur
ur,ur,ur,ur,ur,ur,ur,ur,ur,ur,ur,ug,ug,ug,ub,ug,ug,ub,ur,ur,ur,ur,ur
ur,ux,ux,ux,ug,ub,ug,ug,ug,ug,ux,ug,ug,ub,ub,ub,ub,ub,ug,ug,ug,ug,ug
ur,cr,ux,ux,ub,ub,ug,ux,ux,ug,ug,ug,ug,ug,ug,ug,ub,ub,ug,ug,ug,ug,ug
cr,ux,ux,ux,ub,ux,ug,ug,ug,ug,ug,cg,ug,ug,ux,ux,ur,ug,ug,ug,ug,ug,ug
cg,ux,ux,ux,ub,ux,ux,ux,ux,ug,ug,ug,ug,ug,ux,ux,ur,ug,ug,ug,ug,ug,ug
cb,ux,ux,ux,ub,ub,ub,ub,ub,ug,ug,ug,ug,ug,ub,ub,ur,ug,ug,ug,ug,ug,ug
ux,ux,ux,ux,ux,ux,ux,ux,ux,ux,ux,ux,ux,ux,ux,ux,ur,ux,ur,ur,ur,ur,cr
cr,ux,ux,ux,ux,ux,ux,ux,ux,ux,ub,ub,ub,ub,ub,ub,ur,cb,cg,ux,cb,ur,cr
cg,cb,cg,cb,ux,ux,ux,ux,ux,ux,ux,ux,ux,ux,ux,cg,ur,ur,ur,cg,cg,ur,cr