cb,cb,cb,cr,ur,ur,cr,ur,ur,ur,ur,ur,ur,ur,ur,ur,ur,ur,ur,ur,ur,ur,cb
ur,ur,ur,ur,ur,ur,ur,ur,ur,ur,ur,ur,ur,ur,ur,ur,ur,ur,ur,ur,ur,ur,ur
ur,ur,ur,ur,ur,ur,ur,ur,ur,cr,ug,ug,ug,ur,ur,ur,ur,ur,ur,ur,ur,ur,ur
ur,ur,ur,ur,ur,ur,ur,ur,ur,ur,ur,ur,ug,ug,ug,ug,ug,ug,cg,ur,ur,ur,ur
ub,ub,ub,ur,ur,ur,cg,ub,ub,ub,ub,ur,ur,ur,ur,ur,cr,ug,ur,ur,ur,ur,ur
ub,ur,cr,ub,ub,ur,ug,ug,ur,ur,ub,ur,ur,ur,ur,ur,ur,ug,ug,ur,ur,ur,ur
ub,ub,ur,ur,cb,ur,ur,cr,ur,ur,ub,ur,ur,ur,ur,ur,ur,cg,ug,ug,ux,ux,ub
cb,ub,ub,ub,ug,ug,ug,ur,ur,ur,cb,ur,ur,ur,ur,ur,ur,ug,ug,ux,ux,ub,ub
ur,ug,ug,cg,ug,ub,cg,ub,ur,ur,ur,ur,ur,ur,ug,ur,ug,ug,ub,ub,ub,ub,ux
ur,ug,ug,ub,ug,ug,ug,ub,ux,ug,ub,ub,ub,ub,ug,ug,ug,ug,ux,ux,ux,ux,ux
ub,ug,ug,ug,ug,ub,ug,ub,ux,ux,ub,ub,ub,ub,ub,ug,ug,ug,ux,ux,ux,ux,ux
ub,ug,cb,ub,ub,ub,ug,ub,ux,ux,ub,ub,ub,ub,ub,ub,ub,ug,ug,ux,ux,ux,ux
cb,ug,ug,ub,ub,ug,ug,ub,ux,ux,ub,ug,ug,ug,ug,ub,cb,ub,ug,ux,ux,ux,ux
ux,ug,ug,ug,ub,ub,ug,ub,ux,ux,ub,ug,ug,ug,ug,ug,ug,ug,ug,ux,ux,ux,ux
ub,ug,ug,ub,ub,ub,ug,ub,ub,ub,ub,ux,ug,ug,ug,ug,ub,ux,ux,ux,ux,ux,ux
ub,ub,ub,ub,ub,ub,ux,ub,ux,ux,ug,ux,ug,ux,ug,ub,ux,ux,ux,ux,ux,ux,ux
ux,ux,ux,ux,ug,ug,ux,ub,ux,ux,ug,ug,ug,ux,ub,ub,ux,ux,ux,ux,ux,ux,ux
cr,ug,ug,ug,ug,ug,ug,ub,ux,ux,ur,ux,ux,ux,ux,ux,ux,ux,ux,ux,ux,ux,ux
cg,ug,ug,ux,ug,ug,ug,ub,cb,ux,ur,ux,ux,ux,ux,ux,ux,ux,ux,ux,ux,ux,ux
cb,ux,ug,ug,ug,ug,ug,ug,ux,ux,ur,ux,ux,ux,ux,ux,ux,ux,ux,ux,ux,ux,ux
ug,ug,ug,ug,ug,ug,ug,ug,ug,ug,ur,ux,ux,ux,ux,ux,ux,ux,ux,ux,ux,ux,cr
cr,ug,ug,ug,ug,ug,ug,ug,ug,ug,ur,ur,ur,ur,ur,ur,ur,cb,cg,ux,cb,ux,cr
cg,cb,cg,cb,ux,ux,ux,ux,ux,ux,ux,ux,ux,ux,ux,cg,ur,cr,ur,cg,cg,ux,cr