ux,cb,cb,cr,ur,cg,ug,ug,ug,ug,ug,ug,ug,ug,ug,ug,ug,ug,cr,cb,ub,ur,cb
ux,cb,cb,ur,ur,ur,ur,ur,ur,ub,ur,cg,ub,ub,ub,ur,ur,ur,ur,ur,ub,ur,ur
ur,ur,ur,ug,ug,ug,ug,ur,cr,ub,ub,ug,ug,ug,ub,ub,ug,ug,ur,ub,ub,ur,ur
ur,cr,ur,ug,ur,ur,ur,ur,ur,ur,ug,ub,ug,ug,ug,ug,cg,ug,ur,ur,ur,ur,ur
ur,ug,ur,ur,ur,ug,ug,ug,ur,ur,ug,ub,ur,ur,ub,ug,ux,ug,ug,ur,ur,ur,ug
ur,ur,ur,ug,ug,ug,ub,ug,cr,ur,ug,ub,ux,ub,ub,ug,ux,ug,ug,ub,ub,ux,ug
ug,ug,ug,ur,ur,ug,ug,ug,ux,ur,ug,ub,ub,ub,ub,ug,ux,ug,ug,ub,ub,ux,ug
cb,ux,ux,ur,ur,ub,ub,ub,ug,ug,ug,ub,ux,ug,ug,ug,ub,ug,ug,ub,ub,ux,ug
ur,ur,cr,ur,ur,ur,ub,ub,ug,ux,ub,ub,ux,ug,ug,ug,ub,ug,ug,ub,ub,ux,ug
ur,ux,ux,ux,ub,ub,ub,ub,ub,ub,ub,ub,ub,ub,ug,ug,ux,ug,ug,ub,ub,ux,ug
ur,ux,ux,ux,ux,ur,ux,ux,ub,ub,ub,ub,ug,ug,ug,ug,ux,ug,ug,ub,ub,ux,ug
ur,ur,ur,ur,ur,ur,ug,ur,cb,ub,ug,ug,ug,ug,ug,ug,ug,ug,ug,ub,ug,ug,ug
cb,ux,ux,ux,ux,ur,ug,ux,ug,ub,ug,ug,ug,ug,cr,ug,ug,ug,ug,ux,ux,ux,cg
ub,ub,ub,ub,ub,ur,ug,ub,cg,ub,ub,ub,ub,ub,ur,ug,ug,ug,ug,ug,ug,ug,ug
ux,ux,ux,ux,ux,ur,ug,ug,ug,ub,ub,ub,ub,ub,ur,ux,ux,ux,ux,ug,ux,ux,ug
ux,ux,ux,ux,ux,ur,ux,ux,ug,ug,ug,ub,ug,ug,ur,ug,ug,ug,ux,ug,ug,ug,ug
ux,ux,ux,ux,ux,ur,ux,ux,ug,ug,ug,ub,ug,ug,ur,ux,ux,ug,ug,ug,ug,ug,cb
ux,ux,ux,ux,ub,ur,ug,ug,ug,ux,ux,ub,ux,ux,ur,ux,ux,ux,ux,ux,ux,ug,ux
ux,cg,ux,ub,ub,ub,ub,ub,ug,ug,ux,cb,ux,ux,ur,ux,ux,ux,ux,ux,ux,ug,ux
ux,ug,ub,ub,ub,ub,ub,ub,ux,ug,ug,ug,ug,ug,ur,ug,ug,ug,ug,ug,ug,ug,ux
cr,ug,cb,ub,ub,ux,ub,ub,ux,ux,ux,ux,ux,ux,ur,ux,ux,ux,ux,ux,ux,ux,cr
cg,ub,ub,ub,ub,ux,ub,ub,ux,ux,ux,ux,ux,ux,ur,ux,ux,ux,ux,cb,cb,ux,cr
cr,cg,cg,cb,ub,ub,ur,ur,ur,ur,ur,ur,ur,ur,ur,cg,ux,ux,ux,cg,cg,ux,cr