ur,ur,ur,ur,ur,ur,ur,ur,ur,ur,ur,ur,ur,ur,ur,ur,ur,cb,ux,ux,ug,ug,ur
ur,ur,ur,ur,ur,ur,ur,ur,ur,cr,ur,ur,ur,ur,ur,ur,ur,ur,ur,ur,ug,ug,ug
ur,ur,ur,ur,cg,cr,ur,ur,ur,ur,cr,ur,ur,ur,ur,ur,ur,ux,ux,ur,ug,ur,ug
ur,ur,ur,ug,ug,cb,ub,ur,ur,ur,ur,ur,ur,ur,ur,ur,ur,ux,ux,ur,ug,ur,ug
cb,ur,ur,ug,ur,ur,ub,ur,ur,cr,ur,ug,ug,ug,ug,ur,ur,ur,ur,ur,ug,ur,ug
ur,ur,ur,ur,ur,ur,ub,ub,cb,ub,ur,ug,ug,ug,ug,ug,ug,ug,ur,ug,ug,ur,ug
ur,ur,ur,ur,ur,ur,ur,ub,ur,ur,ur,ug,ug,ug,ug,ux,ug,ub,ub,ub,ug,ur,cg
ur,ur,ur,ur,ur,ur,ub,ub,ub,ur,ur,ug,ug,ug,ug,ur,ug,ub,ub,ub,ug,ur,ur
ur,ur,ur,ur,ur,ur,ub,ub,ub,ur,ur,ur,ug,ug,ug,ug,ug,ub,ub,ub,ug,ub,ur
ur,ur,ur,ur,ur,ur,ub,ux,ug,ug,ur,ur,cg,ug,ug,ug,ur,ur,ur,ur,ur,ur,ur
ur,ur,ur,ur,ur,ub,ub,ub,ub,ug,ur,ur,ur,ug,ug,ur,ur,ub,ur,ug,ug,ug,ur
ux,ug,cr,ur,ub,ub,ub,cb,ub,ub,ub,ub,ub,ux,ug,ur,ug,ub,ur,ug,ug,ug,ur
ux,ug,ux,ug,ug,ux,ub,ub,ux,ub,ub,ux,ug,ug,ug,ur,ur,ub,ug,ug,ub,ug,cg
ux,ug,ux,ug,ug,ug,ug,ug,ug,ug,ug,ug,ug,ug,ug,ur,ur,ub,ug,ug,ub,ug,ug
ux,ug,ux,ug,ux,ug,ug,ug,ub,ub,ub,ub,ub,ub,ub,ur,ub,ub,ug,ug,ub,ux,ug
ux,ug,ux,ug,ux,ug,ux,ux,cb,ug,ug,ug,ug,ug,ug,ur,ur,ux,ug,ug,ub,ux,ug
ux,ug,ux,ug,ux,ug,ux,ux,ux,ug,ug,ug,ug,ug,ug,ur,ur,ug,ug,ug,ub,ux,ug
cg,ug,ux,ug,ux,ug,ug,ux,ux,ug,ug,ug,ug,ug,ug,cr,ug,ug,ux,ug,ub,ux,ug
ux,ug,ux,ug,ux,ux,ug,ug,ug,ug,ug,ug,ug,ug,ug,ug,ug,ug,ug,ug,ub,ux,ug
ux,ug,ux,ug,cg,ux,ux,ux,ux,ur,ux,ux,ur,ux,ux,ux,ux,ux,ux,ux,ux,ux,ug
ux,ug,ug,ug,ug,ug,ug,ug,ug,ug,ug,ug,ug,ug,ug,ug,ug,ug,ug,ug,ug,ug,ug
cr,ux,ux,ux,ux,ux,ux,ux,ux,ur,ux,ux,ur,ux,ux,ux,ux,ux,ux,ux,ux,cb,cr
cg,ux,ux,ux,ux,ux,ux,ux,ux,ur,ur,ur,ur,cb,ux,ux,ux,ux,ux,cg,cb,ux,cr