ur,ur,ur,ur,ur,ux,ux,ux,ux,ux,ux,ur,ur,ur,ur,ux,ux,ur,ur,ur,ur,ur,ur
ur,ur,ur,ur,ur,ux,ur,ur,ur,ur,ur,ur,ur,ur,ur,ur,ur,ur,ur,ur,ur,ur,ur
ur,ur,ug,ug,ur,ur,ur,ur,ur,ur,ur,ur,ur,ux,ur,ur,ur,ur,ur,ur,ur,ur,ur
ur,ur,cg,cr,ur,ur,ur,ur,ur,ur,ur,ur,ur,ux,ur,ux,ur,ur,ur,cr,ur,ux,ur
ur,ur,ur,ur,ur,ur,ur,ur,ur,cr,ub,ug,ug,ug,ug,ug,ug,ug,ub,ux,ur,ux,ur
ur,ur,ur,ur,ur,ur,cg,ug,ur,ur,ub,ug,ug,ug,ug,ug,ug,ug,ux,ux,ur,ur,ur
ur,ur,ur,cr,ur,ur,ur,ug,ug,ug,ub,ub,ur,ur,ur,ur,ur,ur,ux,ux,ux,ub,ur
ur,ur,ur,ub,cb,ux,ux,ug,ur,cb,ub,ub,ub,ur,ur,ur,ur,ur,ur,ur,ur,ub,ub
ur,ur,ur,ur,cr,ux,ur,ug,ur,ug,ug,ug,ub,ug,ug,ug,ug,ug,ur,ux,ur,ur,ub
ur,ug,ug,ug,ug,ux,ur,ug,ub,ug,ug,ug,ub,ub,ug,ug,ug,ug,ur,ur,ur,ur,ub
ur,ux,ux,ux,ug,ug,ur,ug,ub,ub,ub,ur,ug,ub,ug,ug,ug,ug,ur,ur,ur,ur,ub
ur,ux,ux,ux,ux,ug,ug,ug,ub,cb,ub,ub,ug,ub,ub,ub,ub,ub,ub,ub,ub,ur,ub
ur,ux,ux,ux,ur,ur,ub,ub,ub,ug,ub,ub,ub,ub,ug,ug,ux,ub,ub,ub,ur,ur,ub
ur,ur,ur,ur,ur,ur,ur,ub,ub,ug,cg,ub,ub,ub,ub,ub,ub,ub,ub,ur,ur,ur,ub
ur,ur,ur,ur,ur,ur,ur,ug,ug,ug,ub,ug,ug,ub,ug,ug,ub,ub,ub,ur,ur,ur,ub
ur,ur,ur,ur,ur,ur,ur,ug,ug,ug,ug,ug,cg,ub,cb,ur,ub,ub,ub,ur,ur,ur,ub
ur,ur,ur,ur,ur,ur,ur,ug,ur,ur,ur,ug,ug,ub,ub,ub,ub,ub,ub,ub,ub,ub,ub
ur,ux,ux,ux,ux,ub,ub,ug,ug,ug,ub,ub,ub,ub,ub,ux,ux,ub,ug,ux,ur,ur,ur
ur,ux,ux,ux,ux,ux,ub,ub,ug,ug,ub,ub,ub,cb,ub,ux,ux,ub,ug,ux,ur,ur,ur
ur,ux,ux,ux,ux,ux,ub,ub,ug,ug,ub,ub,ub,ub,ub,ub,ux,ub,ug,ub,ur,ur,ur
ur,ux,ux,ub,ub,ux,ux,ub,ug,ug,ux,ux,ux,ux,ux,ub,ux,ux,ug,ub,ur,ur,ur
ur,ux,ub,ub,ub,ub,ux,ub,ux,ux,ux,ux,ux,ux,ux,ur,ur,ur,ur,ur,ur,ur,ur
ur,ur,ur,ur,cr,ug,ug,ug,ug,ug,ug,ug,ug,ug,ug,ur,ur,ur,ur,ur,ur,cb,ur