ux,cb,cb,cr,ux,ur,ur,ur,ur,ur,ux,ux,ur,ur,ur,ur,ur,ur,ug,ur,ur,ux,cb
ux,cb,cb,ux,ux,ur,ux,ux,ur,ur,ux,ug,ur,ur,ur,ur,ur,ur,ug,ug,ur,ur,ur
ux,cr,ur,ur,ur,ur,ux,ux,ur,ur,ur,ug,cr,ur,ur,ur,ur,ur,ug,ug,ur,ur,ur
ur,ub,cb,ur,ur,ur,ur,ur,ur,ur,ur,cg,ur,ur,ur,ur,ur,ur,ug,ug,ur,ur,ur
ur,ub,ub,ur,ur,ur,ur,ur,ur,ur,ur,ur,ur,ur,ur,ur,ur,ur,ug,ug,ug,ug,ur
ur,ur,ur,ur,ur,ur,ur,ur,ur,ur,ur,ur,ur,ur,ur,ur,ur,ur,ug,ug,ug,ug,ug
ur,ur,ur,ur,cb,ur,ur,ur,ur,ur,ur,ur,ur,ur,ur,ur,ur,ub,ub,ug,ug,ug,ug
cb,ur,ur,ur,ub,ur,ur,ur,ur,ur,ur,cr,ur,ur,ur,ur,ur,ub,ub,ub,ub,ub,ug
ub,ub,cr,ur,ub,ur,ur,ur,ur,ur,ub,ug,ub,ub,ub,ub,ub,ub,ub,ub,ug,ub,ug
ub,ub,ub,ur,ur,ur,ur,ur,cb,ub,ub,cg,ug,ug,ug,ug,ug,ug,ug,ug,ug,ub,ug
ux,cg,ug,ug,ug,ux,ug,cr,ur,ux,ug,ug,ug,ug,ug,ub,ub,ug,ur,ub,ug,ub,ug
ux,ux,ux,ug,ug,ug,ug,ux,ux,ux,ub,ub,ub,ub,ug,ub,ub,ub,ug,ug,ub,ub,ug
cb,ux,ux,ug,ux,ux,ux,ux,ux,ux,ub,ub,ub,ub,ub,ub,cb,ug,ug,ug,ug,ub,ug
ux,ux,ux,ug,ux,ux,ux,ux,ux,ux,ub,ub,ub,ub,ug,ug,ug,ug,ug,ug,ug,ub,ug
ug,ug,ux,ug,ug,ug,ux,ux,ux,ux,ub,ug,ug,ug,ug,ug,ux,ug,ug,ug,ub,ub,ug
ug,ug,ug,ug,ug,ug,ug,ug,ux,ux,ux,ug,ux,ub,ub,ub,ug,ug,ug,ug,ug,ub,cg
ug,ug,ug,ug,ug,ug,ug,ug,ux,ux,ux,ug,ug,ug,ux,ux,ux,ug,ux,ug,ug,ux,cb
ug,ug,ug,ug,ug,ug,ug,ug,ug,ug,ux,ug,ug,ug,ux,ux,ux,ug,ux,ug,ug,ux,ux
ur,ur,ur,ur,cg,ug,ug,ug,ug,ug,ur,ur,ur,cg,ur,ur,ur,ur,ur,ur,ug,ux,ux
ur,ur,ur,ur,ug,ug,ug,ug,ug,ur,ur,ur,ur,ur,ur,ur,cr,ug,ug,ug,ug,ux,ux
cr,ug,ug,ug,ug,ug,ug,ug,ug,ug,ug,ux,ux,ux,ux,ux,ux,ux,ux,ux,ux,ux,cr
cg,ux,ux,ux,ux,ug,ug,ug,ug,ug,ux,ux,ux,ux,ux,ux,ux,ux,ux,cb,cb,ux,cr
cr,cg,cg,cb,ux,ux,ux,ux,ux,ux,ux,ux,ux,ux,ux,cg,ux,ux,ux,cg,cg,ux,cr