ur,ur,ur,ur,ur,ur,ur,ur,ur,ur,ur,ur,ur,ur,ur,ur,cr,ub,ub,cb,ur,cr,ug
ur,ur,ur,ur,ur,ur,ur,ur,ur,ur,ur,ur,ur,ur,ur,ur,ur,ub,ub,ub,ub,ub,ug
ur,ur,ur,ur,ur,ur,ur,ur,ur,ur,ur,ur,ur,ur,ur,ur,ur,cr,ug,ug,ug,ug,ug
ur,ur,ur,ur,ur,ur,ur,ur,ur,ur,ur,ur,ur,ur,ur,ur,ur,ur,ur,ur,ur,ug,ug
ur,ur,ur,ur,ur,ur,ur,cr,ur,ub,ub,ub,ub,ub,ub,ug,ug,ug,ur,ur,ur,ug,ug
ur,ur,ur,ur,ur,ur,ux,ug,ug,ug,ug,ub,ub,ub,ub,cb,ub,ug,ug,ug,ur,ug,ug
ur,ur,ur,ur,ur,ur,ur,ur,ur,ug,ug,ug,ux,ub,ub,ub,ub,ug,ug,ug,ur,ug,ug
ur,ur,ur,ur,ur,ur,ur,ux,ux,ur,ug,ug,ur,ur,ur,ub,ub,ug,ug,ug,ur,ug,cr
cg,ur,ur,ur,ur,ur,ur,ur,ur,ur,cr,ug,ug,ug,ug,ub,ub,ux,ux,ug,ux,ug,ur
ur,ur,ur,ur,ur,ur,ur,ur,ur,ur,ur,cb,cg,ug,ug,ug,ug,ug,ug,ug,ub,ug,ur
ur,ur,ur,ur,ur,ur,ur,ur,ur,ur,ub,ub,ub,ub,ub,ub,ub,cg,ug,ug,ug,ug,ur
ur,ur,ur,ur,ur,ur,ur,ug,ub,ub,ub,ub,ux,ub,ub,ub,ub,ux,ux,ux,ux,ub,ur
ur,ur,ur,ur,ur,ur,ur,ug,ub,ub,ub,ug,ug,ug,ug,ub,cb,ux,ux,ux,ux,ub,ur
ux,ux,ub,ux,ux,ub,ug,ug,ub,ur,ug,ug,ub,ub,ub,ub,ug,ug,ug,ug,ug,ub,ur
ug,ux,ub,ux,ux,ux,ug,ug,ug,ub,ub,ub,ub,ub,ub,ub,ug,ug,ug,ur,ug,ub,ur
ux,ux,ub,ux,ux,cg,ug,ug,ug,ub,ub,cb,ub,ub,ub,ub,ub,ub,ug,ug,ug,ug,ur
ux,ux,ub,ux,ux,ug,ug,ug,ug,ub,ub,ub,ub,ub,ux,ux,ux,ux,ux,ug,ub,ug,ur
ux,ux,ub,ux,ux,ug,ug,ug,ug,ur,ub,ub,ub,ub,ux,ux,ux,ux,ux,ug,ux,ug,ur
ux,ux,ub,ux,ux,ux,ux,ug,ug,ur,ug,ub,ub,ub,ux,ux,ux,ux,ux,ug,ux,ux,ur
ux,ux,ub,ux,ux,ux,ux,ug,ug,ur,ux,ux,ub,ub,ux,ux,ux,ux,ux,ug,ux,ux,ur
ux,ux,ub,ux,ux,ux,ux,ug,ug,ur,ux,ux,ux,ux,ux,ux,ux,ux,ux,ug,ux,ux,ur
ux,ux,ub,ub,ub,ub,ub,ub,ub,ub,ux,ux,ux,ux,ux,ux,ux,ux,ux,ug,ux,ux,ur
ux,ux,ux,ux,ux,ux,ux,ux,ux,ub,ub,ub,ub,ub,ub,ub,ub,ub,ub,ub,ub,ub,cb