ur,ur,ur,ux,ux,ux,ux,ur,ur,ug,ur,ur,ur,ur,ur,ur,ur,cb,ux,ub,ub,ux,ux
ur,cr,ur,ux,ur,ur,ux,ur,ur,ug,ug,ug,ug,ur,ur,ur,ur,ux,ux,ub,ub,ux,ux
ur,ub,cr,ur,ur,ur,ub,ur,ur,ug,ug,ur,ug,ur,ur,cr,ur,ug,ug,ug,ub,ux,ux
ur,ur,ur,ur,ur,ur,ub,cr,ur,ug,ur,ub,ug,ur,cr,ub,ur,ur,ub,ug,ub,ux,ux
ur,ur,ub,ub,ub,ur,ub,ub,ub,cg,ub,cb,ub,ub,ur,ur,ug,ug,ug,ug,ub,ux,ux
ub,ub,ub,ub,ur,ux,ux,ur,ub,ub,ub,ub,ub,ug,ux,ug,ug,ug,ug,ug,ug,ux,ux
ub,ub,ur,ur,ur,ug,ug,ug,ug,ub,ub,ug,cg,ux,ux,ux,ux,ux,ub,ux,ug,ug,ux
ux,ub,ux,ux,ux,ub,ub,ug,ub,ub,cb,ub,ub,ug,ug,ug,ug,ub,ub,ub,ub,ug,ur
ur,ur,ur,ur,ur,ug,ug,ug,ug,ug,ub,ub,ub,ub,ux,ug,ug,ub,ub,ub,ub,ug,ur
ur,ub,ub,ug,ug,ug,ug,ug,cg,ug,ub,ub,ug,ug,ug,ug,ub,ub,ux,ub,ub,ug,ur
ur,ug,ux,ug,ux,ug,ug,ub,ug,ug,ug,ub,ub,ug,ur,ub,ug,ub,ug,ub,ub,ug,ub
ur,ug,ux,ug,ug,ug,ub,ub,ug,ub,cg,ug,ug,ug,ur,ug,ug,ub,ug,ub,ux,ug,ug
ur,ug,ux,ub,ug,ug,ug,ub,ug,ub,ub,ub,ub,ub,ur,ug,ug,ub,ug,cb,ub,ux,ug
ur,ug,ux,ux,ug,ub,ug,ub,ug,ug,ug,ug,ug,ug,ur,ug,ug,ub,ub,ug,ub,ub,ug
ur,ux,ux,ux,ug,ug,cb,ub,ug,ug,ug,ub,ub,ub,ur,ug,ug,ub,ub,ug,ub,ux,ug
ur,ux,ux,ux,ux,ux,ub,ub,ug,ux,ug,ub,ub,ub,ur,ub,ub,ub,ub,ug,ub,ug,ug
ur,ux,ux,ux,ux,ux,ub,ug,ug,ux,ux,ub,ub,ub,ur,ug,ug,ub,ug,ug,ug,ug,ub
ur,ux,ux,ux,ux,ux,ub,ux,ux,ux,ux,ub,ux,ug,ur,ug,ub,ub,ub,ug,ub,ub,ub
ur,ux,ug,ug,ug,ug,ub,ug,ug,ug,ug,cg,ux,ug,ur,ux,ub,ub,ub,ug,ub,ub,ub
ur,ux,ug,ux,ux,ux,ux,ux,ux,ux,ub,ub,ub,ub,ur,ux,ub,cg,ug,ug,ub,ub,ub
ur,ur,ug,ug,ug,ug,ug,ug,ug,ug,ub,ub,ub,ub,ur,ug,ub,ub,ub,ub,ub,ub,ub
cr,ux,ux,ux,ux,ux,ux,ux,ux,ux,ub,ux,cb,ub,ur,ux,ub,ux,ux,ux,ux,ux,cb
cg,ux,ux,ux,ux,ux,ux,ux,ux,ux,ub,ub,ub,ux,ur,cr,ub,ub,cb,ux,ux,ux,ux