ur,cb,cb,cr,ur,ur,ur,ur,ur,ur,ur,ur,ur,ur,ur,ur,ur,ur,ur,cb,ur,ur,cb
ur,ur,cb,ur,ur,ur,ur,ur,ur,ur,ur,ur,ur,ur,ur,ub,ub,ub,ub,ub,cr,ur,ux
ur,ur,ur,ur,ur,ur,ur,ur,ur,ur,ur,ur,ur,ur,ur,ug,ug,ug,ub,ub,ub,ur,ux
ur,ug,cr,ur,ug,ug,ug,ug,ug,cr,ur,ur,ur,ur,ur,ur,ur,ur,ur,ur,ur,ur,ux
ur,ug,ur,ur,ur,ur,ur,ur,ur,ur,ur,ur,ur,ur,ur,ur,ur,ur,ur,ur,ur,ur,ur
ur,cg,ur,ur,ur,ur,ur,ug,cg,ur,ug,ug,ug,ur,ur,ug,ug,ug,ug,ug,ur,ur,ur
ur,ur,ur,ur,ur,ur,ug,ug,ug,ur,ug,ur,ug,ur,ur,ug,ug,ug,ug,ug,ug,ur,ur
cb,ur,cr,ur,ur,ur,ur,ur,ug,ug,ug,ug,ug,ur,ug,ug,cg,ug,ug,ug,ug,ur,ur
ur,ur,ub,ur,ur,ur,ur,ur,ug,ug,ug,ug,ug,ub,ug,ug,ug,ug,ug,ug,ug,ux,ux
ur,ur,ub,cb,ur,ur,ur,ur,ub,ub,ub,cb,ub,ub,ug,ub,ug,ug,ug,ug,ug,ux,ux
ur,ur,cg,ur,ur,ux,ux,ug,ux,ux,ux,ug,ug,ur,ug,ug,ug,ug,ug,ug,ug,ux,ux
ur,ur,ug,ug,cb,ug,ug,ug,ux,ux,ug,ug,ux,ur,ug,ug,ux,ug,ug,ug,ug,ux,ux
cb,ur,ur,ur,ub,ug,ug,ug,ug,ux,ug,ug,ub,ur,ug,ug,ux,ug,ug,ug,ug,ux,ux
ub,cr,ur,ub,ub,ug,ug,ug,ug,ux,ub,ub,ub,ur,ug,ug,ug,ug,ug,ug,ug,ux,ux
ub,ub,ub,ub,ug,ug,ug,ux,ux,ux,ux,ux,ub,ur,ug,ug,ug,ug,ug,ug,ug,ux,ux
ux,ux,ux,ux,ur,ug,ug,ux,ux,ux,ux,ub,ug,ur,ug,ug,ug,ug,ug,ug,ug,ug,ux
ux,ux,ux,ug,ug,ug,ug,ug,ug,ux,ub,ug,ug,ur,ug,ug,ux,ux,ux,ug,ug,ug,ux
ur,ux,ux,ug,ur,ug,ug,ug,ug,ug,ug,ug,ug,ur,cr,ur,ur,ug,ug,ug,ug,ur,ur
ur,ux,ux,ug,ug,ug,ub,ub,cg,ug,ux,ux,ug,ur,ur,ug,ug,ug,ux,ug,ux,ug,ur
cr,ug,ug,ub,ub,ub,ub,ub,ub,ug,ub,ub,ub,ur,ur,ub,ub,cg,ug,ub,ub,ub,cb
cg,ug,ug,ub,ub,ub,ub,ub,ub,cb,ug,ux,ug,ur,ur,ug,ug,ux,ux,ug,ug,ug,cr
cr,ub,ub,ub,ub,ub,ub,ug,ug,ug,ug,ux,ug,ur,ur,ux,ux,ux,ux,cb,cb,ug,cr
cg,ur,cg,cb,ux,ug,ug,ug,ux,ux,ug,ug,ug,ur,ur,cg,ux,ux,ux,cg,cg,ug,cr