cb,ur,ur,ur,ur,ur,ur,ur,ur,ur,ur,ur,ux,ur,ur,ur,ur,ux,ur,cg,ur,ug,ug
ub,ub,ur,ur,ur,ur,ur,ur,ur,ur,ur,ur,ub,ub,ub,ur,ur,ur,ur,ur,ur,ug,ur
ub,ub,ub,ur,ur,ur,ur,ur,ur,ur,ur,ur,ub,ur,ub,ur,ur,ur,ug,ug,ug,ug,ur
ub,ub,ur,ur,ur,ur,ur,ur,ur,cr,cr,ur,ub,ur,ub,ub,ub,ur,ur,ur,ur,ur,ur
ub,ur,ur,ux,cr,cb,ur,ur,ur,ub,ur,ub,ub,ur,ub,ub,ub,ub,ub,ub,ub,ur,ur
ur,ur,ur,ur,ur,ub,ur,ur,ur,cb,ur,cr,ug,ur,ur,ub,ub,ub,ub,ug,ub,ur,ur
ur,ur,ur,ur,ur,ur,ur,cr,ug,cg,ur,ur,ub,ub,ub,ub,ub,ub,ug,ug,ub,cb,ug
ur,ur,ur,ur,ur,ur,ur,ur,ur,ur,ug,ub,ub,ub,ub,cg,ub,ug,ug,ug,ux,ux,ug
ur,ur,ur,ur,ur,ur,ur,ur,ub,ub,ug,ub,ub,ub,ub,ug,ug,ug,ug,ug,ux,ux,ug
ur,ur,ur,ur,ur,ub,ub,ub,ug,ub,ug,ub,ub,ub,ub,ub,ux,ux,ux,ub,ub,ub,ug
ur,ur,ur,ub,ub,ub,ub,ug,ug,ub,ug,ub,ux,ug,ug,ug,ux,ux,ux,ug,ug,ug,ug
ux,ux,ux,ux,ug,ux,ux,ug,ug,ub,ug,ug,ub,cb,ub,ug,ug,ug,ux,ug,ux,ux,ux
ux,ux,ug,ug,ug,ux,ux,ug,ug,ub,ub,ub,ub,ub,ub,ug,ug,ug,ug,ug,ub,ub,ub
ux,ug,ug,ug,ug,ux,ux,ug,ug,ub,ub,ub,ub,ub,ug,ug,cg,ug,ug,ug,ug,ug,cg
ux,ug,ux,ug,ug,ux,ux,ug,ux,ub,ug,ub,ub,ux,ux,ug,ug,ug,ub,ub,ub,ux,ux
ux,ug,ux,ug,ug,ux,ux,ug,ux,ub,ug,ug,ux,ug,ug,ub,ub,ug,ub,ub,ub,ub,ub
ux,ug,ux,ug,cr,ug,ug,ug,ux,ub,ug,ug,ug,ug,ug,ub,ug,ug,ub,ub,ub,ub,ub
cg,ug,ux,ug,ur,ux,ug,ug,ux,ub,ug,ug,ug,ug,ug,ub,ug,ug,ub,ub,ub,ub,ub
ux,ug,ur,ur,ur,ug,ug,ug,ug,ub,ur,ur,ug,ug,ug,ug,ug,ug,ug,ug,ur,ur,ur
ux,ug,ur,ug,ur,ub,ub,ub,ub,ub,ug,ug,ug,ub,ux,ub,ub,ub,ub,ug,ub,ub,ur
cr,ug,ur,ug,ur,cg,ur,ur,ur,ub,ur,ur,ur,ur,ur,ur,ur,ur,ur,ur,ur,ur,ur
cg,ug,ur,ug,ug,ug,ur,ur,ur,ub,ur,cb,ur,ur,ur,ug,ug,ug,ug,ur,ur,cb,cr
cr,ug,ug,ub,ub,ub,ub,ub,ub,cb,ub,ub,ug,ug,ug,ug,ur,ur,ur,ur,cb,ux,cr