ur,ur,ur,ur,ur,ur,ur,ur,ur,ur,ur,ur,ur,ur,ur,ur,ux,cb,ur,ur,ux,ur,ur
ur,ur,ur,ur,ur,ur,ur,ur,ur,ur,ur,ur,ur,ux,ur,ur,ur,ur,ur,ur,ur,ur,ur
ur,ur,ur,ur,ur,ur,ur,ur,ur,ur,ur,ur,ur,ur,ur,ur,ur,ur,ur,cb,ub,ub,cr
ur,ur,ur,ur,ur,ur,ur,ur,cb,ur,ug,cg,ur,ur,ur,ur,ur,ur,ur,ur,ur,ur,ur
ur,ur,ur,ur,ur,ur,cr,ur,ub,ur,ug,ur,ur,ur,ug,ug,ub,ug,ux,ug,ux,ux,ux
ur,cr,ur,ur,ur,ur,ug,ur,ub,ug,ug,ur,ur,ux,ub,ug,ub,ug,ug,ug,ux,ux,ux
ub,cr,cr,ux,ur,ur,cg,ur,ub,ug,ur,ug,ug,ug,ug,ug,ux,ub,ux,ux,ux,ux,ux
cb,ur,ux,ux,ux,ux,ub,ub,ub,ub,ub,ux,ux,ug,ug,ug,ux,ub,ux,ux,ux,ux,ux
ub,ub,ub,ub,ub,ub,ub,ub,ub,ub,ub,ug,ug,ug,ug,ub,ub,ub,ux,ux,ux,ux,ux
ub,cb,ux,ux,ux,ux,ub,ub,ub,ub,ub,ug,ux,ug,ug,ux,ux,ux,ux,ux,ux,ux,ux
ub,ub,ub,ub,ub,ub,ub,ub,ub,ub,ug,ug,ub,ug,ug,ug,ug,ug,ub,ub,ux,ux,ux
ug,ug,ug,ug,ug,ug,ub,ub,ub,ub,ug,ug,ub,ug,ub,ug,ug,ub,ub,ub,ub,ur,ux
ug,ug,cg,ug,ug,ug,ug,ug,ug,ug,ug,ug,ug,ug,ug,ug,ug,ub,ub,ub,ub,ug,cg
ux,ug,ux,ux,ux,ux,ux,ux,ug,ug,ug,ug,ug,ug,ug,ub,ub,ub,ub,ug,ux,ur,ur
ux,ug,ux,ux,ux,ux,ux,ux,ug,ug,ug,ug,ug,ug,ub,ub,ub,ur,ur,ur,ur,ur,ur
ux,ug,ux,ux,ux,ux,ux,ux,ug,ug,ug,ug,ug,ug,ub,ub,ub,ub,ub,ub,ux,ur,ur
ux,ug,ux,ux,ux,ux,ux,ux,ug,ug,ug,ug,ug,ug,ux,ub,ub,ub,ub,ux,ux,ur,ur
cg,ug,ux,ux,ux,ux,ux,ux,ug,ug,ug,ug,ux,ug,ux,cr,ub,ub,ub,ux,ux,ur,ur
ux,ug,ux,ux,ux,ux,ux,ux,ug,ug,ug,ug,ux,ux,ux,ur,ub,ux,ux,ux,ux,ur,ur
ur,ug,ur,ur,ur,ur,ur,ur,ur,ur,ug,ug,ur,ur,ur,cb,ub,ur,ur,ur,ur,ur,ur
ur,ug,ur,ur,ur,ur,ur,ur,ur,ug,ug,ug,cg,ur,ur,ur,ur,ur,ur,ur,ur,ur,ur
cr,ug,ux,ux,ux,ux,ux,ux,ux,ux,ux,ug,ux,ux,ux,ux,ux,ux,ux,ux,ux,cb,cr
cg,ug,ug,ug,ug,ug,ug,ug,ug,ug,ug,ug,ux,cb,ux,ux,ux,ux,ux,cg,cb,ux,cr