ur,cb,cb,cr,ux,ux,ux,ur,ur,ur,ur,ur,ur,ur,ur,ur,ur,ur,ur,ur,ur,ur,cb
ub,ub,cb,ur,ur,ur,ur,ur,ur,ur,ub,ub,cb,ur,ur,ur,ur,ur,ur,ur,ur,ur,cg
cb,ur,ur,cr,ur,ur,ur,ur,ur,ur,cg,ug,ug,cr,ur,ur,ur,ur,ur,ur,ur,ur,ug
ur,ur,ub,ub,ur,ub,ub,ub,ub,ub,ub,ur,ur,ur,cr,ur,ur,ur,ur,ur,ur,ur,ug
cr,ur,ub,ub,ug,ub,ug,ug,ug,ug,ug,ug,ug,cr,ur,ur,ug,ug,ug,ug,ug,ub,ug
ur,ur,ug,ug,ug,ub,ub,ub,ur,ug,ub,ug,ug,ug,ug,ug,ug,ug,ug,ug,ug,ub,ug
ur,ur,ur,ug,ub,ub,ub,ub,ur,ug,ub,ug,ug,ug,ug,ug,ug,ug,ug,ug,ug,ub,ug
cb,ug,ur,ug,ub,ub,ub,ub,ug,ug,ub,ug,ux,ug,ug,ug,ug,ug,ug,ug,ug,ug,ug
ux,ub,ux,ug,ug,ub,ub,ub,ug,ub,ux,ug,ux,ug,ug,ug,ug,ug,ug,ug,ug,ug,ur
ub,ub,ub,ub,ub,ub,ub,ub,ux,ub,ux,ug,ug,cg,ug,ug,ug,ug,ug,ug,ug,ug,ub
ub,ub,ub,ub,ub,ug,ug,ub,cg,ub,ug,ug,ug,ug,ug,ug,ug,ub,ub,ub,ub,ug,ug
ub,ub,ug,ug,ub,ug,ug,ub,ug,ux,ug,ug,ug,ug,ur,ux,ux,ub,ug,ug,ug,ug,ug
cb,ub,ug,ug,ub,ug,ug,ug,ug,ug,ug,ug,ug,ug,ur,ux,ux,ub,ub,ub,ub,ug,ub
ub,cb,ug,cg,ub,ug,ub,ub,ux,ug,ux,ux,ug,ug,ug,ug,ug,ug,ub,ub,ub,ug,ub
ub,ub,ub,ug,ub,ug,ug,ux,ux,ug,ux,ux,ux,ux,ug,ug,ug,ub,ub,ux,ux,ug,ur
ub,ub,ub,ug,cb,ug,ug,ug,ug,ug,ug,ux,ux,ux,ur,ux,ug,cr,ug,ux,ux,ug,ur
ub,ub,ug,ug,ug,ug,ug,ug,ug,ux,ug,ug,ug,ug,ug,ug,ug,ur,ug,ux,ux,ug,cb
ub,ug,ug,ug,ug,ug,ux,ux,ux,ux,ug,ug,ug,ux,ur,ux,ug,ur,ub,ub,ub,ub,ub
ub,ug,ug,ug,ug,ug,ug,ux,ux,ux,ug,ug,ux,ux,ur,ur,ur,ur,ur,ug,ug,ug,ur
ub,ug,ug,ug,ug,ug,ug,ug,ux,ux,ux,ux,ux,ux,ur,ur,ur,ur,ug,ug,ur,ur,cb
cr,ug,ug,ug,ug,ug,ug,ug,ug,ug,ug,ug,ug,ug,ug,ur,cg,ug,ug,ur,ur,ur,cr
cg,ug,ug,ug,ug,ug,ug,ug,ux,ux,ux,ux,ux,ux,ur,ur,ur,ur,ur,cb,cb,ur,cr
cr,cg,cg,cb,ux,ur,ur,ur,ur,ur,ur,ur,ur,ur,ur,cg,ur,ur,ur,cg,cg,ur,cr