ur,ur,ur,ur,ur,ur,ur,ur,ur,ur,cb,ub,ub,ub,ub,ub,ub,ub,ub,ub,ub,ur,cb
ur,ur,ur,ur,ur,ur,ur,ur,ur,ur,ur,ur,ur,ur,ur,ur,ur,ur,ur,ur,ub,ur,ur
ur,ur,ur,ur,ur,ur,ur,ur,ur,ur,ur,ur,ur,ur,ur,ur,ur,ur,ur,ub,ub,ur,ur
ur,ur,ur,ur,ur,ur,ur,ur,ur,ur,ur,ur,ur,ur,ur,ub,ub,ub,ub,ub,ur,ur,ur
ur,ur,ur,ur,ur,ur,cr,ur,ur,ur,ur,ug,ug,ug,ur,ur,ur,ug,ug,ur,ur,ur,ur
ur,cr,ux,ux,ug,ug,ur,ur,cr,ug,ug,ug,ur,ur,ug,ug,ur,ug,ug,ur,ur,ur,ur
ur,ux,ux,ux,ug,ug,ug,ug,ug,ug,ug,ug,ug,cg,ur,ur,ur,ur,ur,ur,ur,ur,ur
ur,ur,ur,ux,ux,ur,ur,ur,ug,ug,ux,ur,ur,ur,ur,ur,ur,ur,ur,ur,ur,ur,ur
cg,ur,ur,ur,ux,ur,ur,ur,ur,ur,ug,cg,ur,ur,ur,ur,ur,ur,ur,ur,ur,ur,ur
ur,ur,ur,ur,ur,ur,ur,ur,ur,ur,ug,ur,ur,ur,ur,cr,ub,ur,ur,ur,ur,ur,ur
ur,ur,ur,ur,ur,ur,ur,ug,ug,ug,ug,ur,ur,ub,ur,ur,cb,ur,ur,ur,ur,cb,ub
ur,ur,ur,ur,ur,ur,ur,ug,ur,ur,ur,ur,cb,ub,ur,ur,ub,ub,cr,cr,ug,ux,ub
ur,ur,ur,ur,ur,ux,ux,ug,ug,ug,ug,ub,ub,ub,ub,ub,ub,ub,ub,ux,ux,ux,ub
ux,ux,ux,ug,ux,ux,ub,ug,ug,ug,ug,ug,ug,ug,ub,ub,ub,ux,ux,ux,ux,ux,ub
ux,ux,ux,ug,ux,ub,cb,ug,ug,ug,ug,ug,ug,ug,ub,ub,ub,ux,ux,ux,ux,ux,ub
ux,ux,ux,ug,ub,ub,ub,ug,ug,ug,ug,ug,ug,ux,ub,ub,ux,ux,ux,ux,ux,ux,cg
ub,ub,ub,ug,ub,ub,ub,ub,ug,ug,ug,ug,ug,ub,ub,ub,ub,ub,ub,ub,ub,ub,ug
ub,ux,ux,ug,ux,ux,ub,ub,ub,ub,ux,ub,ub,ux,ux,ux,ux,ux,ux,ux,ux,ux,ug
ub,ux,ux,ug,ux,ux,ub,ub,ub,ub,ux,ub,ub,ub,ub,ux,ux,ux,ux,ux,ux,ux,ug
ub,ux,ux,ug,ux,ux,ux,ub,ux,ux,ux,ub,ub,ub,ux,ux,ux,ux,ux,ux,ux,ux,ug
ub,ux,ux,ug,ux,ux,ux,ux,ux,ux,ux,ub,ux,ux,ux,ux,ux,ux,ux,ux,ux,ux,ug
ub,ux,ux,ug,ux,ux,ux,ux,ux,ux,ux,ub,ux,ux,ux,ux,ux,ux,ux,ux,ux,ux,ug
ub,ub,ub,ug,ug,ug,ug,ug,ug,ug,ug,ug,ug,ug,ug,ug,ug,ug,ug,ug,ug,ug,ug