ur,ur,ur,cb,ur,ur,ur,ur,ur,ur,ur,ur,ur,ur,ur,ur,ur,ur,ur,ur,ur,ur,ur
ur,ur,ur,ub,cr,ur,ur,ur,ux,ur,ur,ur,ur,ux,ur,ur,ur,ur,ur,ur,ur,ur,ur
ur,ur,cr,ur,ug,ux,ur,ur,ux,ur,ur,ur,ur,ur,ur,ur,ur,ur,ur,ur,cr,ur,ur
ur,ur,ur,ur,ug,ux,ur,ur,ur,ur,ub,ub,ux,ux,ur,ur,ur,ur,ur,ur,ub,ur,ur
ur,ur,ur,ur,ug,ug,ur,ux,ux,ux,ux,ux,ux,ur,ur,ur,ur,ur,ur,ur,cb,ur,ur
ur,ur,ur,ur,ux,ug,ur,ur,ug,ug,ug,ug,ug,cr,ug,ug,cg,ur,ur,ur,ur,ur,ur
ur,ub,ub,ub,cr,ub,ub,ub,ug,ug,ug,ug,ug,ur,ur,ux,ur,ur,ur,ur,ur,ur,ur
ur,ub,ur,ur,ur,ub,ub,cb,ub,ug,ug,ug,ug,ug,ur,ur,ur,ur,ur,ur,ur,ur,ur
cg,ub,ur,ur,ur,ub,ub,ub,ub,ub,ug,ug,ug,ug,ug,ur,ur,ur,ur,ur,ur,ur,ur
ur,cb,ur,cb,ub,ub,ub,ub,ub,ub,ug,ug,ur,ug,ug,ug,ug,ug,ur,ur,ur,ur,ur
ur,ur,ur,ur,ub,ub,ub,ub,ug,ub,ug,ug,ug,ug,ug,ug,ug,ug,ur,ur,ur,ur,ur
ux,ux,ux,ug,ub,ub,ub,ub,ug,ub,ug,ur,ur,ur,ug,ug,ug,ug,ur,ux,ux,ur,ur
ux,ux,ux,ub,ub,ub,ub,ug,ug,ub,ug,ug,ug,ub,ug,cb,ux,ux,ux,ux,ux,ur,ur
ux,ux,ux,ub,ub,ub,ub,ug,ug,ub,ub,cg,ug,ub,ub,ub,ux,ux,ux,ux,ux,ur,ur
cg,ux,ux,ub,ub,ub,ub,ux,ux,ub,ub,ub,ub,ub,ub,ub,ux,ub,ub,ux,ux,ur,ur
ub,ub,ub,ub,ux,ux,ug,ug,ug,ug,ug,ug,ub,ub,ub,ub,ub,ub,ub,ux,ux,ur,ur
ub,ub,ub,ux,ux,ub,ug,ub,ub,ux,ub,ug,ub,ub,ug,ug,ub,ub,ux,ux,ux,ur,ur
ux,ux,ub,ub,ub,ub,ug,ug,ug,ug,ug,ug,ug,ug,ug,ug,ug,ug,ug,ur,ur,ur,ur
ux,ux,ub,ub,ux,ux,ux,ux,ux,ux,ux,cg,ub,ub,ug,ub,ur,ur,ur,ur,ur,ur,ur
ur,ur,ur,ur,ur,ur,ur,ur,ur,ur,ur,ub,ur,ur,ur,ur,ur,ur,ur,ur,ur,ur,ur
ur,ux,ux,ux,ux,ux,ux,ux,ux,ux,ux,ub,ub,ug,ub,ux,ur,ug,ux,ur,ur,ur,ur
ur,ux,ux,ux,ux,ux,ux,ux,ux,ux,ux,ub,ux,ug,ug,ug,ug,ug,ur,ur,ur,ur,cb
ur,cr,ux,ux,ux,ux,ux,ux,ux,cg,ux,ux,ux,ux,ux,ux,ug,ug,ur,ur,ur,ur,ur