ur,ur,cb,ur,ur,ur,ur,ur,ur,ur,ur,ur,ub,ub,ur,ur,ur,ur,ur,cg,ug,ug,ug
ur,ur,ur,ur,ur,ur,ur,ur,ur,ur,ur,ur,ub,cr,ur,cr,ur,ur,ur,ug,ug,ug,ug
ur,ur,ur,ur,ur,ur,ub,ur,ur,ur,ur,ur,cb,ur,ux,ux,ux,ux,ux,ug,ug,ur,ug
ur,ur,ur,ur,ur,ur,ub,ub,cr,cr,ur,ur,ub,ub,ux,ug,ux,ux,ux,ug,ug,ug,ug
ur,ur,ux,ur,ur,ur,ur,ur,ur,ur,cr,ur,ub,ur,ur,ug,ux,ux,ux,ux,ug,ug,ug
ur,ur,ur,ur,ur,ur,ur,ur,ur,ur,ur,ur,ug,ug,ug,ug,ug,ug,ug,ug,cg,ug,ug
ur,ur,ur,ur,ur,ur,ur,ur,ur,ur,ux,ur,ur,ux,ur,ug,ug,ug,ug,ux,ux,ug,ug
ur,ur,ur,ur,cg,ug,ug,ux,ux,ub,ug,ug,ug,ub,ub,ug,ux,ub,ug,ug,ug,ug,ug
cb,ur,ur,ur,ux,ux,ug,ug,ux,ub,ug,ug,cb,ub,ub,ug,ug,ug,ug,ug,ux,ug,ug
ub,ub,ux,ub,ub,ub,ub,ug,ug,ug,ug,ug,ug,ub,ub,ug,ux,ug,ug,ug,ub,ug,ug
cb,ub,ux,ub,ux,ux,ux,ux,ux,ux,ux,ux,ug,ub,ub,ub,ub,ub,ug,ug,ug,ug,ug
ux,ub,ux,ub,ux,ux,ux,ux,ug,ug,ug,ug,ug,ug,ug,ug,cg,ub,ub,ub,ug,ug,ug
ub,ub,ux,ub,ux,ux,ux,ux,ug,ug,ug,ug,ug,ug,ug,ur,ug,ug,ub,ub,ug,ug,ug
ub,ub,ub,ub,ux,ux,ux,ux,ux,ux,ug,ug,ub,ub,ub,ub,cb,ub,ub,ub,ug,ug,ug
ux,ux,ux,ux,ux,ux,ux,ug,ug,ug,ug,ux,ub,ub,ub,cg,ug,ug,ug,ug,ug,ug,ug
cg,ug,ug,ug,ug,ug,ur,ur,ur,cb,ur,ub,ub,ur,ug,ug,ug,ug,ur,ub,ug,ug,ug
ux,ug,ug,ug,ug,ug,ug,ug,ux,ub,ub,ub,ub,ub,ug,ub,ug,ug,ug,ug,ug,ub,ug
ux,ug,ug,ug,ug,ug,ux,ug,ux,ux,ub,ub,ub,ub,ug,ub,ub,ug,ug,ug,ug,ub,ug
ux,ug,ug,ug,ug,ug,ux,ug,ug,ux,ux,ub,ub,ux,ux,ub,ub,ug,ug,ug,ub,ub,ug
ux,ug,ug,ug,ug,ug,ux,ug,ug,ug,ug,ug,ub,ub,ug,ub,ub,ug,ug,ug,ub,ug,ug
cr,ug,ug,ug,ug,ug,ux,ug,ux,ug,ug,ub,ub,ub,ug,ub,ub,ub,ub,ub,ub,ub,ub
cg,ug,ug,ug,ug,ug,ug,ug,ug,ug,ug,ug,ux,ux,ux,ux,ux,ux,ux,ux,ux,cb,cr
cr,cg,ur,ur,ur,ur,ur,ur,ur,ur,ur,ur,ur,ur,ur,ur,ur,ur,cr,ux,cb,ux,cr