ub,ub,cb,ur,ub,cr,ub,ur,ur,ur,cr,ur,ur,ur,ur,ur,ur,ur,ur,cg,ux,ur,cg
ub,ub,ub,ub,ub,ur,cb,ur,ur,ur,ug,cr,ur,ur,ur,ur,ur,ur,ur,ur,ur,ur,ug
ub,ub,ub,ub,cr,ur,ur,ur,ur,ur,ug,ug,ug,cg,ur,ur,ur,ug,ug,ur,ur,ux,ug
ur,ur,ur,cg,ur,ur,ur,ur,ur,ur,ug,ur,ug,ur,ur,ur,ug,ur,ug,ur,ur,ur,ug
ur,ur,ur,ug,ur,ur,ux,ur,ub,ub,ub,ub,ug,ug,ug,ug,ug,ug,ug,ur,ur,ub,ug
ur,ur,ur,ug,ug,ug,cb,ub,ub,ub,ub,ub,ux,ug,ur,ur,ur,ur,ur,ur,ur,ub,ug
ur,ur,ur,ur,ur,ur,ub,ub,ug,ub,ub,ug,ug,ug,ug,ug,ug,ur,ub,ub,ux,ub,ug
ur,ur,ur,ur,ur,ur,ug,ux,ug,ub,ub,ug,ub,ub,ub,ux,ux,ur,ug,ub,ux,ub,ug
ur,ur,ur,ur,ur,cr,ug,ug,ug,ug,ug,ug,ug,ub,ub,ub,ub,ur,ug,ub,ux,ub,ug
ux,ux,ux,ug,ug,ur,ur,ux,ub,ub,ub,ub,ub,ub,ub,ug,ug,ur,ug,ug,ug,ug,ug
ux,ux,ux,ug,ug,ug,ub,ub,ub,ub,ub,ub,cb,ug,ub,ux,ux,ur,cb,ub,ub,ub,ub
ug,ux,ux,ug,ug,ug,ub,ub,ub,ug,ug,ub,ub,cg,ub,ub,ub,ur,ug,ug,ug,ub,ux
ub,ug,ug,ug,ug,ug,ub,ub,ub,ux,ug,ug,cb,ub,ub,ug,ub,ur,ug,ug,ug,ub,ux
ub,ub,ug,ug,ug,ug,ub,ux,ux,ug,ug,ug,ub,ux,ux,ux,ub,ur,ug,ug,ug,ub,ux
ux,ug,ug,ub,ub,ub,ub,ux,ub,ug,ug,ug,ug,ux,ux,ux,ux,ur,ub,ug,ug,ub,ux
cg,ug,ug,ug,ug,ub,ux,ub,ub,ug,ub,ug,ug,ux,ub,ux,ux,ur,ub,ub,cr,ub,ux
ux,cg,ug,ux,ug,ug,ug,ug,ux,ug,ug,ux,ux,ub,ub,ub,ub,ur,ub,ux,ur,ub,ux
ux,ub,ug,ug,ug,ux,ux,ug,ug,ug,ug,ux,cb,ub,ux,ux,ux,ur,ux,ux,ur,ub,ub
ux,ub,ug,ug,ug,ux,ux,ug,ug,ux,ug,ux,ub,ux,ux,ux,ux,ur,ux,ux,ur,ub,ub
ux,ub,ug,ug,ug,ux,ux,ug,ug,ux,ug,ux,ux,ux,ux,ux,ux,ur,ux,ux,ur,ub,ub
cr,ub,ug,ug,ug,ux,ux,ug,ug,ub,ug,ug,ug,ug,ug,ug,ux,ur,ux,ur,ur,ub,ub
cg,ub,ug,ug,ug,ux,ug,ug,ub,ub,ur,ur,ur,ur,ur,ur,ur,ur,ur,ur,ux,cb,cr
cr,ux,ux,ux,ug,ug,ug,ux,ub,ux,ux,ux,ux,ux,ux,ux,ux,ux,ur,ur,cb,ux,cr