ur,cb,cb,cr,ur,ur,ur,ur,ur,ur,ur,ur,ur,cr,ug,ub,ub,ur,ur,ub,ub,ux,cb
ur,cb,cb,ur,ur,ur,ur,ur,ur,ur,ur,ug,ug,ug,ub,ub,ub,ur,ub,ub,ub,ur,ur
ur,ur,ur,ur,ur,cr,ur,ur,ur,ur,ur,ur,cb,ux,ub,ub,ub,ug,ub,ub,ub,ur,ur
ur,ur,ur,ur,ur,cr,ug,ug,ur,ur,ub,ub,ub,ux,ub,ug,ub,ug,ub,ur,ux,ur,ur
ur,ur,ur,ur,ur,ur,ur,cg,ur,ur,ub,ur,ux,ux,ub,ug,ub,ug,cr,ur,ur,ur,ur
ur,ur,ur,ur,ur,ur,ur,ur,ur,ur,ub,ur,ux,ux,cb,ug,ub,ug,ug,ux,ux,ub,ur
ur,ur,ur,ur,ux,ux,ur,cr,ux,cr,ub,ur,ub,ug,ug,ug,ub,ub,ug,ux,ux,ub,ur
cb,ur,ub,ub,ur,ur,ub,ur,ur,ur,ub,ur,ux,ug,ug,ug,ug,ub,ug,ux,ux,ub,ur
ub,ub,ub,ub,ub,ub,ub,ux,ux,ux,ux,ur,ux,ug,ug,ug,ug,ub,ug,ux,ux,ub,ur
ub,ux,ur,ur,ux,ug,cg,ub,ub,ub,ub,ub,ub,ug,ug,ug,ug,ub,ug,ux,ux,ub,ur
ub,ux,ux,ux,ux,ug,ux,ux,ub,ub,ub,ub,ub,ug,ug,ug,ux,ub,ug,ux,ub,ub,ur
ub,ub,ub,ub,ux,ug,ux,ux,ub,ub,ub,ub,ub,ug,ug,ug,cg,ur,ur,ur,ur,ur,ur
cb,ux,ux,ub,ux,ug,ux,ux,ug,ug,ub,ug,cb,ub,ug,ug,ug,ub,ub,ub,ub,ub,cg
ux,ux,ux,ub,ux,ug,ux,ux,ug,ug,ug,ug,ug,ug,ur,ux,ux,ub,ub,ub,ub,ub,ub
ux,ux,ux,ub,ux,ug,ux,ux,ux,ug,ub,ug,ug,ug,ur,ux,ux,ub,ub,ub,ub,ub,ub
ux,ub,ub,ub,ux,ug,ux,ux,ub,ub,ub,ur,ug,ug,ur,ux,ux,ub,ub,ub,ux,ux,ux
ug,ub,ub,ub,ub,ug,ug,ug,ug,ug,ug,ug,ug,ug,ug,ug,ug,ug,ug,ux,ux,ux,cb
ug,ub,ub,ub,ug,ub,ug,ux,ux,ux,ug,ug,ug,ur,ug,ux,ux,ux,ug,ux,ux,ux,ux
ug,ub,ub,ub,ug,ub,ug,ug,ug,ug,ug,ur,ub,ur,ug,ux,ux,ug,ug,ux,ux,ux,ux
ug,ug,ug,ub,ug,ug,ug,ug,ug,ug,ug,ug,ug,ug,ug,ug,ug,ug,ux,ux,ux,ux,ux
cr,cg,ug,cb,ug,cg,ub,ub,ux,ux,ux,ur,ux,ur,ug,ux,ux,ux,ux,ux,ux,ux,cr
cg,ub,ub,ux,ug,ux,ub,ub,ux,ux,ux,ur,ur,ur,ug,ux,ux,ux,ux,cb,cb,ux,cr
cr,cg,cg,cb,ug,ug,ug,ug,ug,ug,ug,ug,ug,ug,ug,cg,ux,ux,ux,cg,cg,ux,cr