cr,ur,ub,ub,ur,ur,ur,ur,ur,ur,ur,ur,ur,ur,ur,ur,ur,cb,ur,ur,ug,ug,ug
ub,cb,ub,ub,ur,ur,ur,cr,ur,ur,ur,ur,cr,ur,ur,ur,ur,ur,ux,ur,ug,ub,ug
ux,ux,cg,ug,ug,ug,ur,ur,ur,ur,ur,ur,ur,cr,ug,ug,ur,ur,ur,ub,ug,ur,cg
ux,ur,ur,ur,ur,ur,ur,ur,ur,ur,ug,ur,ur,ux,ur,ug,ux,ux,ug,ug,ug,ur,ub
ur,ur,ur,ur,ur,ur,ur,ur,ur,ur,ug,ur,ur,ur,ug,ug,ur,ub,ug,ub,ur,ur,ub
ur,ur,ur,ur,ur,ur,ur,ur,ur,ug,ug,ub,ub,ub,ub,ug,ug,ug,ug,ur,ur,ur,ub
ur,ur,ur,ug,ug,ug,ur,ug,ug,ug,ug,cb,ub,ub,ub,ub,ub,ub,ub,ub,ub,ub,ub
ur,ur,ur,cg,ur,ug,ug,ug,ug,ug,ug,ur,ug,ug,ug,ug,ug,ug,ug,ux,ur,ux,ur
ur,ur,ur,ur,ur,ug,ug,ur,ug,ub,ur,ug,ug,ug,ug,ug,ug,ug,ug,ux,ur,ux,ur
ur,ur,ur,ur,ur,ur,ur,ux,ub,ub,ur,ur,ug,ug,ug,ug,ux,ux,ug,ux,ur,ux,ur
ur,ur,ur,ur,ur,ur,ux,ub,ub,ub,ub,ub,ub,ug,ug,ug,ug,ug,ug,ux,ux,ux,ur
ur,ur,ur,ur,ur,ug,ub,ub,ub,ub,ub,ub,cg,ug,ug,ug,ub,ub,ug,ug,ux,ux,ur
ub,ub,ub,cr,ux,ug,ub,ub,ub,ub,ub,ub,ub,ub,ub,ub,ub,ub,ux,ug,ux,ux,ur
ux,ub,ux,ub,cb,ug,ug,ug,ug,ug,cb,ub,ub,ub,ub,ub,ub,ub,ub,ug,ux,ux,ur
cg,ux,ux,ub,ub,ux,ux,ux,ux,ug,ub,ug,ub,ub,ub,ux,ux,ug,ux,ug,ux,ux,ur
ub,ub,ub,ub,ub,ub,ub,ub,ub,ub,ub,ub,ub,ub,ub,ub,ub,ub,ub,ub,ub,ux,ur
ub,ub,ub,ux,ux,ux,ux,ux,ux,ug,ub,ub,ub,ub,ux,ux,ux,ug,ux,ug,ub,ub,ub
ub,ub,ub,ux,ux,ux,ux,ux,ux,ug,ub,cb,cr,ur,ur,cb,ub,ub,ub,ub,ub,ub,ub
ub,ub,ub,ux,ux,ux,ux,ux,ux,ux,ub,ub,ub,ux,ux,ux,ug,ug,ug,ux,ug,ux,ur
ub,ub,ub,ux,ux,ux,ux,ux,ux,ux,ux,ub,ux,ux,ux,ux,ux,ug,ug,ug,ug,ux,ur
ub,ub,ub,ur,ur,ur,ur,ur,ur,ur,ur,ur,ur,ur,ur,ur,ur,ur,ur,ur,ur,ur,ur
cr,ux,ux,ux,ux,ux,ux,ux,ux,ux,ux,ux,ux,ux,ux,ux,ux,ux,ux,ux,ug,ux,cb
cg,ux,ux,ux,ux,ux,ux,ux,ux,cg,ux,ux,ux,ux,ux,ux,ux,ux,ug,ug,ug,ux,ux