cr,ur,ur,ur,ur,ur,ur,ur,ur,ur,ux,ux,ur,ur,ur,cb,ub,ur,ur,ur,ur,ur,ur
ug,ug,ug,ug,ug,ug,ur,ur,ur,ur,ur,ur,ur,ur,ur,ur,cr,cr,ur,ur,ur,ur,ur
ug,ug,ug,ug,ug,ug,ug,ug,ug,ug,ur,ux,ux,ur,ur,ur,ur,ur,ur,ur,ur,ur,ur
ug,ug,ug,ug,ug,ug,ur,ur,ur,cg,ur,ux,ux,ur,ur,ur,ur,ur,ur,ur,ur,ur,ur
ux,ux,ur,ug,ug,ug,ur,ur,ur,ur,ur,ur,ur,ur,ur,ur,ur,ur,ur,ur,ur,ur,ur
ur,ur,ur,ux,ur,ug,ur,ur,ur,ur,ur,ur,ur,ur,ur,ur,ur,ur,ur,ur,ur,ur,ur
ur,ux,ur,ur,ur,ur,ur,ux,ux,ur,ur,ur,ur,ur,ur,ur,ur,ur,ur,ur,ur,ur,ur
ur,ur,ur,ub,ub,ub,ub,ub,ub,ub,ub,ub,ub,ub,ub,cb,ur,ur,ur,ur,ur,ur,ur
cg,ux,ur,ub,ux,ug,ux,ug,ug,ug,ug,ur,ur,ur,cr,ur,ur,ur,ur,ur,ur,ur,ur
ux,ux,ur,ub,ux,ug,ug,ug,ug,ug,ug,ur,cb,ub,ur,ur,ur,ur,ur,ur,ur,ur,ur
ux,ux,ur,ub,ur,ug,ug,ug,ub,ug,ub,ug,ug,ug,ur,ur,ur,ur,ur,ur,ur,ur,ur
ug,ug,ug,ub,ug,ug,ug,ug,ub,ub,ub,ug,ug,ug,ug,cg,ub,cr,ur,ur,ur,ur,ur
ug,ur,ur,ub,ur,ub,ub,ub,ub,ub,ub,ub,ub,ug,ug,ug,ub,ub,ub,ux,ux,ux,ur
ug,ug,ub,ub,ug,ug,cg,ub,ub,cb,ux,ux,ux,ug,ug,ug,ub,ub,ub,ub,ux,ux,ur
ug,ug,ub,ub,ug,ub,ub,ub,ub,ub,ub,ub,ub,ug,ub,ub,ub,ub,ux,ub,ux,ux,ur
ux,ug,ub,ub,ug,ub,ug,ub,ug,ub,ub,ub,ub,ub,ub,ub,ux,ux,ux,ub,ux,ux,ur
ux,ug,ub,ub,ug,ug,ug,ub,ug,ug,ub,ub,ub,ub,ub,ub,ub,ub,ub,ub,ux,ub,ub
ux,ug,ub,ux,ub,ug,ug,ub,ub,ug,ub,ub,ub,ub,ub,ub,ub,ub,ux,ux,ux,ub,ub
ux,ug,ub,ux,ub,ub,ub,ub,ub,ug,ux,ub,ub,ub,cb,ub,ux,ux,ux,ux,ux,ub,ub
ux,ug,ub,ux,ux,ux,ub,ub,ub,ug,ux,ux,ux,ux,ub,ub,ub,ub,ub,ub,ub,ub,ub
cr,ug,ug,ug,ug,ug,ug,ub,ub,ug,ub,ub,ub,ub,ub,ux,ux,ux,ux,ub,ub,ub,ub
ur,ux,ub,ub,ub,ub,ub,ub,ub,ub,ux,ux,ux,ux,ux,ux,ux,ux,ux,ub,ub,ub,ub
ur,cb,ub,ub,ub,ub,ub,ub,ub,ub,ub,ub,ub,ub,ub,ub,ub,ub,ub,ub,ub,ub,ub