cb,cb,cb,cr,ux,cr,ux,ur,ur,ur,ur,ur,ur,ur,ur,ur,ur,ur,ur,ur,ur,ur,cb
ur,ur,ur,ur,ux,ur,ur,ur,ur,ur,ur,ur,ur,ur,ur,ur,ur,ur,ur,ur,ur,ur,ur
ur,ur,ur,ur,ur,ur,ur,ug,ug,ug,ug,ug,ug,ur,ur,ur,ur,ur,ur,ur,ur,ur,ur
ur,ur,ur,ur,ur,ur,ub,ub,ur,ur,ur,ur,ug,cg,ur,ur,ur,ur,ur,ur,ur,ur,ur
ub,cb,ur,ur,ur,ur,cr,ub,cb,ur,ur,ur,ur,ur,ur,ur,ug,ug,ur,ur,ur,ur,ur
ub,ur,ur,ur,ur,ur,ur,ur,ur,ur,ur,ur,ur,ur,ur,ur,ug,cg,ug,ur,ur,ur,ur
ub,ub,ub,ub,ub,ub,cr,ur,ur,ur,ur,ur,ur,ur,ur,ur,ug,ur,ug,ur,ux,ux,ub
cb,ub,ub,ub,ub,ub,ub,ug,cg,cr,ur,ur,ur,ur,cr,ug,ug,ug,ug,ux,ux,ub,ub
ur,ug,ug,ug,ub,ub,ub,ub,ug,ug,ur,ur,ur,ur,ug,ur,ug,ug,ub,ub,ub,ub,ux
ur,ug,ub,ub,cg,ug,ug,ub,ug,ug,ub,ub,ub,ub,ug,ug,ug,ug,ux,ux,ux,ux,ux
ub,ug,ub,ug,ug,ub,ug,ub,ug,ux,ub,ub,ub,ub,ub,ug,ug,ug,ux,ux,ux,ux,ux
ub,ug,ub,ug,ub,ub,ug,ub,ug,ux,ub,ub,ub,ub,ub,ub,ub,ug,ug,ux,ux,ux,ux
cb,ug,cg,ub,cb,ug,ug,ub,ux,ux,ub,ug,ug,ug,ug,cb,ub,ug,ug,ux,ux,ux,ux
ux,ug,ug,ug,ub,ub,ug,ub,ux,ux,ub,ug,ug,ug,ug,ug,ug,ug,ug,ux,ux,ux,ux
ub,ug,ug,ub,ub,ub,ug,cb,ub,ub,ub,ux,ug,ug,ug,ug,ub,ux,ux,ux,ux,ux,ux
ub,ub,ub,ub,ub,ub,ug,ug,ux,ux,ug,ux,ug,ug,ug,ub,ux,ux,ux,ux,ux,ux,ux
ux,ux,ux,ux,ug,ug,ug,ug,ux,ux,ug,ug,ug,ug,ub,ub,ux,ux,ux,ux,ux,ux,ux
cr,ug,ug,ug,ug,ug,ug,ug,ux,ux,ur,ux,ux,ux,ug,ux,ux,ux,ux,ux,ux,ux,ux
cg,ug,ug,ux,ug,ug,ug,ug,ux,ux,ur,ux,ux,ux,ux,ux,ux,ux,ux,ux,ux,ux,ux
cb,ux,ug,ug,ug,ug,ug,ug,ux,ux,ur,ux,ux,ux,ux,ux,ux,ux,ux,ux,ux,ux,ux
ug,ug,ug,ug,ug,ug,ug,ug,ug,ug,ur,ux,ux,ux,ux,ux,ux,ux,ux,ux,ux,ux,cr
cr,ug,ug,ug,ug,ug,ug,ug,ug,ug,ur,ur,ur,ur,ur,ur,ur,cb,cg,ux,cb,ux,cr
cg,cb,cg,cb,ux,ux,ux,ux,ux,ux,ux,ux,ux,ux,ux,cg,ur,ur,cr,cg,cg,ux,cr