ur,ur,cb,ur,ur,ur,ur,ur,ur,ur,ur,ur,ur,ur,ur,cb,ur,cb,ur,cg,ur,ur,ux
ur,ur,ur,ur,ur,ur,ur,ux,ur,ur,ur,ur,ur,ur,ur,ub,cr,ur,cr,ur,ur,ur,ux
ur,ur,ur,ur,ur,ur,ur,ur,ur,ur,ur,ur,cr,ur,ur,ur,ur,ur,ur,ur,ur,ur,ux
ur,ur,ur,ur,cr,ur,ur,ur,ur,ur,ur,ur,cr,ur,ug,ur,ur,ur,ur,ur,ur,ur,ux
ur,ur,ur,ur,ur,ur,ur,cb,ur,ur,ur,ur,ug,ug,ug,ur,ur,ur,ur,ur,ur,ur,ur
ur,ur,ur,ur,ur,ur,ur,ub,ur,ur,ur,ur,ur,ur,ug,ur,ur,ur,ug,ur,ur,ur,ur
ur,ur,ur,ur,ug,ug,ug,ub,ug,ug,ur,ur,ur,ur,cg,ur,ur,ur,ug,ug,ur,ur,ur
ur,ur,ur,ur,ur,ur,ur,ub,ur,ur,ur,ur,ug,cg,ur,ur,ur,ur,ug,ur,ur,ur,ur
ur,ug,ur,ur,ur,ur,cr,ub,ub,ub,ug,ub,ug,ug,ug,ux,ug,ug,ug,ur,ux,ux,ux
ur,ug,ug,ug,ug,ug,ub,ub,ub,ub,ug,ug,ug,ug,ug,ux,ux,ux,ug,ur,ux,ux,ux
ux,ux,ub,ux,ub,ug,ub,ub,ub,ug,ug,ug,ux,ug,ug,ux,ux,ux,ub,ub,ub,ub,ub
ux,ux,ub,ux,ub,ug,ub,ug,ug,ug,ug,ug,ux,ug,ug,ux,ux,ug,ug,ur,ug,ux,ub
cg,ug,ug,ug,ub,ug,ub,ug,ug,ug,ug,ug,ux,ug,ug,ux,ux,ug,ug,ub,ug,ux,ub
ux,ux,ub,ux,ux,ug,ub,ug,ug,ug,ug,ug,ux,ug,ug,ux,ux,ug,ug,ug,ub,ub,ub
ux,ux,ub,ux,ux,cg,ux,ug,ug,ug,ug,ug,ug,ug,ug,ug,ug,ug,ug,ug,ub,ux,ub
ux,ux,ub,ux,ux,ux,ux,ug,ug,ug,cb,ug,ux,ug,ur,ux,ub,ub,cg,ub,ub,ub,cb
ux,ux,ub,ux,ux,ux,ux,ug,ux,ug,ub,ub,ub,ub,ub,ub,ux,ub,ub,ub,ub,ub,ub
cg,ux,ub,ux,ux,ux,ux,ug,ug,ug,ug,ug,ux,ug,ur,ub,ux,ux,ub,ur,ub,ub,ub
ux,ux,ub,ux,ux,ux,ux,ux,ux,ux,ub,ub,ub,ub,ub,ub,ux,ux,ux,ur,ug,ub,ub
ux,ux,ub,ux,ux,ux,ux,ux,ux,ux,ub,ub,ub,ub,ub,ub,ub,ub,ub,ub,ub,ub,ub
cr,ux,ub,ux,ux,ux,ux,ub,ub,ub,ub,ub,ub,ub,ub,ub,ub,ub,ub,ub,ub,ub,ub
cg,ux,ub,ub,ub,ub,ub,ub,ux,ux,ux,ux,ux,ux,ur,ux,ux,ux,ux,ur,ux,cb,cr
cr,ux,ub,ub,ux,ub,ub,ux,ux,ux,ux,ux,ux,cb,ur,ur,ur,ur,ur,ur,cb,ux,cr