ur,ur,ur,ur,ur,ur,ur,ur,ur,cr,ub,cb,ur,ur,ub,cg,ug,ug,ug,ug,ub,ur,cb
ur,ur,ur,ur,ur,ur,ur,ur,ur,ur,ub,ub,ub,ub,ub,ur,ur,ur,ur,ug,ub,ur,ur
ur,ur,ur,ur,ur,ur,ur,ur,ur,ur,ur,ur,ug,ug,ug,ug,ug,ug,ug,ug,ub,ur,ur
ur,ur,ur,ur,ur,ur,ur,ur,ur,ur,ur,ur,ur,ug,ur,ur,ug,ur,ux,ur,cr,ux,ur
ur,ur,ur,ur,ur,ub,cb,ur,ur,cr,ur,ur,ur,cr,ux,ug,ug,ur,ur,ur,ur,ur,ur
ur,ub,ug,ug,ur,ub,ur,ur,ur,ur,ug,ug,ub,ug,ux,ug,ug,ug,ux,ux,ux,ur,ux
ub,ub,ug,ug,ug,ub,cr,ub,ub,ub,ub,ub,ub,ub,ub,ub,ug,ug,ux,ux,ux,ux,ux
ub,ub,ug,ug,ur,ub,ub,ub,ux,ub,ug,ug,ug,ug,ux,ub,ug,ug,ux,ux,ux,ux,ux
cg,ub,ug,ub,ub,ub,ub,ub,ux,ub,ub,ub,ug,ub,ub,ub,ug,ug,ux,ux,ux,ux,ux
ur,ur,ug,ug,ur,ur,ub,ub,ub,ub,ub,ub,ur,ur,ur,ur,ug,ug,ug,ur,ur,ur,ur
ur,ub,ux,ug,ug,ux,ux,ux,ub,cb,ub,ub,ub,ub,ub,ug,ug,ux,ug,ub,ux,ux,ur
ur,ux,ux,ug,ux,ux,ux,ux,ux,ux,ub,ub,cb,ub,ug,ug,ug,ub,ug,ub,ux,ux,ur
ur,ux,ux,ug,ux,ux,ug,ug,ux,ux,ub,ub,ub,ub,ug,cg,ug,cb,ug,ub,ub,ux,ur
ur,ux,ux,ug,ux,ux,ug,ug,ux,ug,ub,ub,ub,ug,ug,ug,ub,ub,ub,ux,ub,ux,ur
ur,ux,ux,ug,ux,ux,ug,ug,ux,ug,ug,ub,ug,ug,ug,ug,ug,ub,ub,ux,ub,ux,ur
ur,ux,ux,ug,ux,ux,ug,ug,ug,cr,ur,ur,ur,ur,ur,ur,ur,ur,ur,ur,ur,ur,ur
ur,ux,ux,ug,ux,ux,ug,ux,ub,ug,ug,ug,ug,ug,ug,ug,ug,ub,ub,ub,ub,ub,ur
ur,ux,ux,ug,ux,ux,ug,ug,ug,ug,ug,ug,ug,ug,ug,ug,ug,ux,ub,ub,ux,ub,ur
ur,ur,ur,ug,ug,ug,ug,ug,ug,ug,ur,ur,ur,ur,ug,ug,ug,ur,ur,ur,ur,ub,ub
ur,ur,ux,ub,cg,ug,ug,ug,ux,ux,ux,ux,ux,ux,ux,ug,ug,ug,ug,ug,ux,ux,ub
ur,ur,ub,ub,ux,ux,ux,ux,ux,ux,ux,ux,ux,ux,ux,ux,ux,ux,ux,ux,ux,ux,ux
ur,ur,ub,ux,ux,ux,ux,ux,ux,ux,ux,ux,ux,ux,ux,ux,ux,ux,ux,ux,ux,ux,ux
ur,ur,ux,ux,ux,ux,ux,ux,ux,ux,ux,ux,ux,ux,ux,ux,ux,ux,ux,ux,ux,ux,ux