ur,ur,ur,ur,ur,ur,ur,ur,ur,ur,ur,cr,ur,ur,ur,ur,ur,ur,ur,ur,ur,ur,ur
ur,ur,ur,ur,ur,ur,ur,ur,ur,ur,ur,ug,ur,ur,ur,ur,ur,ur,ur,ur,ur,ur,ur
ur,ur,ur,ur,ug,ug,ug,ug,ug,ug,ug,ug,ur,ug,ug,ur,ur,ur,ur,ur,ur,ur,ur
ur,ur,ur,cg,ug,ur,ur,ur,ur,ur,ur,ur,ur,ur,ug,cb,ur,ug,ur,ur,ur,ur,ur
ur,ur,ur,ur,ur,cg,ur,ur,ur,ur,ur,ur,ur,ur,ug,ub,ub,ub,ur,ur,ur,ur,ur
cr,ur,ur,ur,ur,ug,ur,ur,ur,ur,cr,ub,ub,ub,ub,ub,ub,ub,ur,ur,ur,ur,ur
ur,ur,ur,ur,ur,ug,ur,ur,ur,ur,cr,ur,ug,ur,ug,ur,ur,ur,ur,ur,cb,ub,ub
ur,ur,ur,ur,ur,ug,ur,ur,ub,ur,ub,ur,ug,ug,ug,ug,ug,ur,ux,cr,ub,ub,ub
ur,ur,ur,ur,ur,ug,ug,ub,ub,ub,ub,ur,ug,ug,ug,ug,ug,ug,ub,ub,ux,ub,ux
ur,ur,ur,ux,ux,ub,ub,ub,ur,ur,ur,ur,ug,ux,ux,ux,ug,ug,ub,ux,ux,ub,ux
ur,ur,ur,ur,ur,cb,ub,ub,ur,ux,ux,ug,ug,ug,ug,ux,ux,ux,ub,ux,ux,ub,ux
ur,ur,ux,ux,ur,ux,ur,ur,ur,ur,ur,ub,ug,ug,ug,ug,ux,ux,ub,ub,ub,ub,ux
ur,ur,ur,ur,ur,ur,ub,ug,ug,ub,ub,ub,ug,ub,ug,ug,ug,ux,ux,ux,ub,ub,ux
ur,ur,ur,ur,ub,ub,ub,ub,ub,ub,ub,ug,ug,ug,ug,ug,ub,ub,ub,ub,ub,ub,ux
ub,ub,ub,ux,ub,ub,ub,ug,cg,ub,ub,ub,ug,ug,ug,ug,ub,ub,ub,ub,ub,ub,ux
ub,ub,ux,ux,ug,ug,ug,ug,ug,ub,cb,ug,ug,ug,ug,ug,ur,ur,ur,ur,ur,ur,ux
ub,ub,ux,ux,ug,ug,ug,ug,ub,ug,ub,ug,ug,ux,ux,ur,ur,ur,ur,ur,ur,ur,ux
ub,ub,ux,ub,ub,ug,ug,ug,ug,ug,ug,ug,ux,ux,ux,ur,ur,ux,ux,ux,ur,ur,ux
ub,ub,ux,ub,ux,ux,ub,cg,ug,ug,ux,ux,ux,ux,ux,ur,ur,ux,ux,ux,ur,ur,ux
ub,ub,ux,ub,ub,ub,ub,ux,ux,ux,ux,ux,ux,ux,ux,ur,ur,ux,ux,ux,ur,ur,ux
ub,ub,ux,ux,ux,ux,ur,ux,ux,ux,ux,ux,ux,ux,ux,ur,ur,ux,ux,ub,ur,ur,ur
ub,ub,ux,ux,ux,ux,ur,ux,ux,ux,ux,ux,ux,ux,ux,ur,cb,ub,ub,ub,cr,ur,ur
ub,ub,ux,ux,ux,ux,ur,ur,ur,ur,ur,ur,ur,ur,ur,ur,ur,ub,ub,ub,ub,cb,ur