ur,ur,ur,ur,ub,cr,ur,ur,ur,ur,cr,ur,ur,ur,ur,ur,ur,ur,ur,ur,ur,ur,ur
ur,ur,ur,ur,ur,ur,cr,ur,cb,ub,cr,ur,ur,ur,ur,ur,ur,ur,ur,ur,ur,ur,ur
ur,ur,ur,ur,ur,ur,cb,ur,ur,ur,ux,ux,ub,ub,ub,ub,ub,ub,ub,ub,ub,ux,ur
ur,ur,ur,ur,ur,ur,ub,ur,ur,ur,ur,ur,ur,ux,ux,ux,ub,ub,ub,ux,ux,ub,ur
ur,ur,ur,ug,ug,ug,ub,ur,ur,ub,ub,ub,ur,ur,ub,ub,ub,ub,ub,ub,ub,ub,ur
ur,ur,ur,ug,ur,ug,ub,ub,ub,ub,ur,ub,ur,ur,ub,ub,ub,ub,ub,ub,ux,ux,ur
ur,ur,ur,cg,ur,ur,ub,ub,cr,ub,ub,ub,ub,ub,ub,ub,ub,ub,ur,ub,ub,ub,ur
ur,ur,ur,ur,ur,ur,ur,ub,ur,ub,ub,ug,ub,ub,ub,ub,ub,ub,ur,ur,ux,ub,ur
cg,ur,ur,ur,ur,ur,ur,ur,ur,ub,ub,ur,ur,ub,ur,ur,cb,ub,ur,ug,ub,ub,ur
ur,ur,ur,ur,ur,ur,ur,ur,ur,ug,ub,cg,ub,ub,ur,ug,ug,ub,ub,cb,ub,ub,ur
ur,ur,ur,ur,ur,ur,cr,ur,ur,ug,ub,ug,ub,ub,ub,ub,ub,ux,ub,ub,ub,ub,ur
ur,ur,ur,ug,ur,ur,ug,ur,ub,ub,ub,cb,ub,ur,ur,ur,ub,ub,ub,ub,ub,ur,ur
ur,ur,ug,ug,ur,ug,ug,cg,ub,ug,ub,ub,ub,ub,ub,cb,ub,ub,ub,ub,ub,ub,ub
ur,ur,ur,ur,ub,ux,ub,ub,ub,ub,ub,ub,ux,ux,ub,ux,ux,ux,ux,ux,ux,ug,ub
cg,ux,ux,ux,ur,ux,ub,ub,ub,ub,ub,ub,ub,ub,ux,ux,ux,ux,ux,ux,ux,ug,ub
ux,ux,ux,ux,ur,ux,ux,ux,ur,ub,ub,ux,ux,ug,ux,ux,ux,ux,ux,ux,ux,ug,ub
ux,ux,ux,ux,ur,ux,ux,ux,ur,ux,ub,ux,ux,ug,ux,ux,ux,ux,ux,ux,ux,ug,ux
ux,ux,ux,ux,ur,ux,ux,ux,ur,ux,ux,ux,ux,ug,ux,ux,ux,ux,ux,ux,ux,ug,ux
ux,ux,ux,ux,ur,ux,ux,ux,ur,ux,ux,ux,ux,ug,ux,ux,ux,ux,ux,ux,ux,ug,ux
ux,ux,ux,ux,ur,ux,ux,ux,ur,ux,ux,ux,ux,ug,ux,ux,ux,ug,ug,ug,ug,ug,ux
ux,ux,ux,ux,ur,ux,ux,ux,ur,ux,ux,ux,ux,ug,ug,ug,ug,ug,ux,ux,ux,ux,ux
ux,ux,ux,ux,ur,ux,ux,ux,ur,ux,ux,ux,ux,ux,ux,ux,ux,ux,ux,ux,ux,ux,ux
ux,ux,ux,ux,ur,ur,ur,ur,ur,cg,ux,ux,ux,ux,ux,ux,ux,ux,ux,ux,ux,ux,ux