ur,ur,ur,ur,ur,ur,ur,ur,cb,ur,ur,ur,ur,ur,ur,ur,ur,ur,ur,ur,ur,ur,cb
ur,ur,ur,ur,ur,ur,ur,ur,ub,cr,ur,ur,ur,ur,ur,ur,ur,ur,ur,ur,ur,ur,ub
ur,ur,ur,ur,ur,ur,ur,ur,ur,ur,ur,ur,ur,ur,ur,ur,ur,ur,ur,ur,ur,ur,ub
ur,ur,ur,ur,ur,cr,ur,ur,ur,ur,ur,ur,ur,ur,ur,ur,ur,ur,ur,ur,ur,ur,ub
ux,ur,cr,ur,ur,ur,ur,ur,ur,ur,ur,ur,ur,ur,ur,ur,ur,ur,ur,ur,ur,ur,ub
ux,ur,ub,ub,ub,ub,ub,ub,cb,ur,ur,ur,cr,ub,ur,cg,ur,ur,ur,ur,ur,ur,ub
ur,ur,ub,ub,ub,ug,ur,ur,ur,ur,ur,ur,ur,ub,ub,ug,ub,ub,cr,ub,ur,ur,ub
ur,ur,ug,ur,ub,ub,ux,ux,ur,ur,ur,ur,ur,ur,ug,ug,ug,ub,ur,cb,ur,ux,ub
cg,ux,ug,ug,ug,ug,ux,cr,ur,ur,ur,ur,ur,ur,ug,ug,ug,ub,ug,ug,ur,ux,ub
ub,ub,ub,ux,ux,ug,ux,ux,ux,ug,ub,ug,ub,ug,ug,ub,ub,ub,ug,ug,ur,ux,ub
ub,ux,ub,ub,cb,ug,ug,ug,ug,ub,cb,ub,ub,ug,ug,ub,ub,ug,ug,ug,ur,ux,ub
ub,ux,ug,ub,ub,ub,ub,ug,ug,ub,ub,ub,ub,ug,ug,ug,ub,ug,ug,ug,ur,ux,ub
ub,ub,ug,ux,ub,ux,ux,ux,cg,ub,ub,ub,ub,ug,ub,ug,ug,ug,ub,ug,ub,ub,ub
ub,ub,ug,ug,ux,ux,ux,ux,ux,ub,ub,ub,ub,ug,ub,ub,ub,ug,ug,ug,ux,ux,ub
cg,ux,ux,ug,ux,ux,ux,ux,ux,ub,ub,ub,ub,ug,ub,ub,ub,ug,ug,ug,ux,ux,ub
ub,ub,ub,ub,ub,ub,ux,ux,ux,ux,ux,ux,ux,ug,ub,ub,ux,ug,ug,ug,ux,ux,ub
ub,ub,ub,ug,ux,ub,ub,ub,ub,ub,ub,ub,ux,ug,ux,ux,ux,ub,ub,ub,ux,ux,ub
ub,ub,ub,ug,ux,ux,ux,ux,ux,ux,ux,ub,ub,ug,ux,ux,ux,ur,ux,ux,ux,ux,ub
ub,ub,ub,ug,ub,ux,ux,ux,ux,ux,ug,ug,ug,ug,ub,ub,ub,ub,ub,ux,ux,cg,ub
ub,ub,ub,ug,ug,ux,ux,ug,ug,ug,ug,ug,ux,ug,ux,ux,ux,ug,ug,ug,ug,ug,ub
ub,ub,ub,ux,ug,ug,ug,ug,ub,ux,ug,ug,ug,ug,ug,ug,ug,ug,ux,ub,ub,ux,ub
ub,ub,ub,ux,ux,ux,ux,ub,ub,ux,ug,ux,ux,ux,ux,ux,ux,ur,ux,ux,ub,ub,ub
ub,ub,ub,ub,ub,ub,ub,ub,ux,cg,ug,ug,ug,ug,ux,ux,ux,ur,ur,ur,ur,ub,ub