ux,cb,cb,cr,cb,ux,ur,ur,ur,ur,ug,ug,ug,ug,ug,ug,cr,ur,ur,ur,ug,ub,cb
ux,ux,cb,ur,cr,ux,ur,ur,ur,ur,cg,ur,ug,ug,ug,ug,ug,ug,ug,ur,ug,cr,ur
ux,ux,ux,ur,ur,ur,ur,ur,ux,ug,ur,ur,ug,ug,ug,ug,ug,ug,ug,cr,ur,ur,ur
ux,ux,ux,ub,ur,ub,ub,ub,ux,ur,ur,ur,ug,ug,ub,ug,ug,ug,ug,ur,ug,ub,ur
ur,ur,ur,ur,ur,ug,ug,ub,ur,ur,ur,ur,ug,ug,ug,ug,ug,ug,ug,ur,ur,ur,ur
ub,ub,ur,ug,ur,ug,ug,ug,ug,ug,ur,ur,ug,ug,ug,ug,ug,ug,ug,ug,ur,ur,ur
ur,ur,ur,ug,ug,ug,ug,ub,ur,ug,ug,ur,ug,ug,ug,ug,ux,ug,ug,ux,ur,ug,ur
cb,ur,ur,ug,ur,ur,ug,ug,ug,ug,ur,ur,ug,ug,ug,ug,ux,ug,ug,ug,ur,ur,ur
ur,ur,ur,ug,ur,ug,ur,ub,ug,ug,ur,ur,ug,ug,ux,ux,ux,ug,ug,ug,ux,ux,ux
ur,ur,ur,ug,ur,ur,ug,ug,ug,ug,ug,ug,ug,ug,ug,ug,ug,ug,ug,ux,ux,ux,ux
ur,ur,ur,ug,ur,ug,ug,ub,ug,ur,ug,ur,cg,ug,cg,ux,cb,ux,ux,ug,ug,ug,ug
ur,ur,ur,ug,ug,ug,ux,ub,ug,ug,ug,ub,ub,ux,ug,ug,ub,ug,ug,ug,ux,ux,cb
cb,ux,ub,cg,ub,ub,ub,ub,ux,ux,ux,ub,ug,ug,ug,ug,ub,ux,ux,ux,ux,ux,cg
ux,ux,ub,ux,ux,ux,ux,cb,ux,ux,ux,ub,ug,ug,ug,ux,ub,ux,ux,ux,ux,ux,ux
ur,ur,ur,ur,ur,cr,ur,ug,ug,ug,ur,ur,ur,ug,ug,ur,ub,ur,ur,ur,ur,ur,ur
ur,ub,cb,ub,ub,ur,ub,ug,ug,ug,ug,ug,ux,ux,ux,ux,ub,ux,ux,ux,ux,ur,ur
ur,ub,ub,ub,ux,ur,ug,cg,ux,ub,ub,ub,ub,ub,ub,ub,ub,ux,ux,ux,ux,ur,ur
ur,ub,ug,ug,ux,ur,ug,ur,ux,ux,ux,ux,ug,ux,ux,ux,ux,ux,ux,ux,ux,ur,ur
cr,ub,ug,ux,ux,ur,ug,ur,ug,ug,ug,ug,ug,ux,ux,ux,ux,ux,ux,ux,ux,ur,ur
ug,ub,ug,ug,ug,ur,ug,ur,ug,ug,ug,ur,ur,ur,ur,ur,ur,ur,ur,ur,ur,ur,ur
cr,ug,ug,ug,ug,ur,ug,ur,ug,ug,ug,ug,ux,ux,ux,ux,ur,ur,ur,ur,ur,ur,cr
cg,ug,ug,ug,ug,ur,ug,ur,ug,ug,ug,ug,ur,ur,ur,ur,ur,ur,ur,cb,cb,ur,cr
cr,cg,cg,cb,ux,ur,ur,ur,ug,ug,ug,ux,ux,ux,ux,cg,ur,ur,ur,cg,cg,cb,cr