ur,ur,ur,ur,ur,ur,ur,ur,ur,ur,ur,ur,ur,ur,ur,ur,cb,ub,ux,ub,ub,ux,ux
ur,ur,ur,ur,ur,ur,ur,ur,ur,cb,ub,ur,ur,ur,ur,ur,ub,ub,ub,ub,ux,ux,ux
ur,ur,ur,ur,ur,ur,cr,cr,ur,ur,ub,ug,ug,ug,ur,ur,ur,ur,ub,ub,ur,ur,ur
ux,cr,ux,ur,ug,ug,ur,ur,ur,ub,ub,ux,ur,ug,ub,ub,ub,ub,ub,ub,ub,ub,ur
ux,ux,ux,ur,ug,ug,ug,ug,ug,ub,ug,ug,ug,ug,ub,ug,ug,ub,ux,ub,ub,ub,ur
ux,ur,ur,ur,ug,ur,ur,ug,ug,cg,ub,ub,ub,ub,ub,ug,ug,ub,ub,ux,ux,ux,ur
ux,ur,ur,ur,ur,ur,ug,ug,ug,ug,ub,ug,ug,ur,ub,ug,ug,ub,ub,ub,ux,ux,ur
cb,ub,ur,ug,ug,ug,ug,ur,ur,ub,ub,ub,ug,ux,ub,ug,ug,ub,ux,ux,ux,ux,ur
cg,ub,ur,cr,ur,ug,ur,ur,ub,ub,ub,ub,ug,ux,ub,ub,ub,ub,ux,ux,ux,ux,ur
ub,ub,ur,ur,ur,cg,ur,ur,ub,ub,ub,ub,ug,ub,ux,ux,ux,ub,ub,ux,ux,ux,ur
ub,ur,cr,ux,ur,ur,ur,ur,ub,ub,ub,ub,ub,ub,ux,ux,ux,cb,ub,ux,ux,ux,ur
ub,ux,ur,ur,ur,ur,ur,ur,ub,ub,ub,ub,ub,ub,ub,ux,ug,ug,ub,ub,ux,ux,ur
ub,ub,ur,ux,ux,ug,ug,ub,ux,ug,ub,ub,cb,ub,ub,ub,ug,ub,ub,ub,ux,ux,ur
ub,ub,ug,ux,ug,ug,ux,ub,ub,ub,ug,ub,ub,ub,ub,ub,ug,ub,ux,ux,ux,ux,ur
ub,ub,ub,ux,ug,ux,ug,ub,ub,ub,ug,ux,ub,ux,ux,ux,ug,ub,ux,ux,ux,ux,ur
ub,ub,ub,ux,ug,ux,ug,ub,ub,ug,ug,ug,ug,ux,ug,cg,ug,ub,ux,ub,ub,ub,ur
ub,ub,ug,ux,ug,ug,ux,ug,cb,ug,ug,ug,ug,ux,ug,ug,ub,ub,ux,ub,ux,ub,ur
ub,ub,ug,ux,ux,ug,ug,ug,ug,ux,ug,ug,ug,ux,ug,ug,ug,ub,ub,ub,ux,ub,ur
ub,ub,ub,ub,ub,ub,ub,ub,ub,ub,ub,ub,ub,ub,ub,ub,ub,ub,ub,ub,ub,ub,ur
ub,ub,ub,ub,ub,ub,ub,ub,ub,ub,ub,ub,ub,ub,ub,ux,ux,ub,ux,ux,ux,ux,ur
ub,ub,ub,ub,ub,ub,ub,ub,ub,ub,ub,ux,ug,ug,ug,ux,ux,ub,ux,ux,ux,ux,ur
ug,ub,ub,ub,ub,ub,ub,ub,ub,ub,ub,ub,ub,ub,ub,ub,ub,ub,ux,ux,ux,ux,ur
ug,ug,ug,ug,ug,cr,ur,ur,ur,ur,ur,ur,ur,ur,ur,ur,ur,ur,ur,ur,ur,ur,ur