ub,cb,cb,cr,ur,ur,ur,ur,ux,ur,ur,ur,ur,ur,ur,ur,ur,ur,ur,ur,ur,ur,cb
cb,cb,cb,ur,ur,ur,ur,ur,ur,ur,ur,ur,ur,ur,ur,ur,cr,ug,ur,ur,ur,ur,ur
ub,ux,ux,ux,ur,ur,ur,ur,ur,ur,cb,ur,ur,ur,ur,ur,ur,ug,cg,ur,ur,ur,ur
ub,ur,ur,ur,ur,ur,ur,ur,ur,ur,ub,cr,ur,ur,cr,ur,ur,ur,ur,ur,ur,ur,ur
cr,ur,ux,ur,ur,ur,ur,cg,ur,ur,ur,ur,ur,ux,ur,ur,ur,ur,ur,ur,ur,ur,ur
ur,ur,ur,ur,ur,ur,ur,ug,ur,ur,ur,ug,ug,ug,ur,ur,ur,ur,ur,ur,ur,ur,ur
ur,ur,ur,ur,ur,ur,ur,cr,ur,ur,ur,ug,ur,ug,ug,ug,ug,ug,ur,ur,ur,ur,ur
cb,ur,ur,ur,ur,ur,ur,ur,ur,ur,ug,ug,ur,ur,ur,ur,ug,ug,ux,ug,ub,ux,ux
ur,ur,ur,ur,ur,ur,ur,ur,ur,ur,ug,ur,ur,ur,ug,ux,ug,ug,ug,ug,ub,ub,ub
ur,ur,ur,ur,ur,ur,ur,ur,ug,ug,ug,ug,ug,ug,ug,ux,ug,ug,ux,ux,ux,ux,ub
ur,ur,ur,ur,ur,ur,ug,ug,ug,ur,ug,ug,ug,ug,ug,ux,ug,ug,ux,ub,ub,ub,ub
ur,ur,ur,ur,ur,ur,ug,ug,ug,ug,ug,ug,ub,ub,ug,ux,ug,ug,ux,ub,ub,ub,ub
cb,ux,ub,ub,ug,ug,ug,ug,ug,ug,ug,cb,ub,ub,ub,ug,ug,ug,ub,ub,ub,ub,ub
ux,ux,ub,ub,cg,ug,ug,ug,ug,ug,ug,ug,ub,ub,ub,ub,ub,ub,ub,ux,ux,ux,ur
ux,ux,ug,ug,ug,ug,ug,ug,ug,ug,ug,ug,ub,ug,ug,ub,ub,ub,ub,ux,ux,ux,ur
cg,ug,ug,ug,ug,ug,ug,ug,ug,cg,ug,ug,ub,ug,ub,ux,ub,ub,ub,ur,ur,ur,ur
ux,ux,ug,ug,ug,ug,ug,ug,ug,ug,ub,cb,ub,ux,ub,ub,ub,ub,ub,ub,ub,ub,ub
ux,ux,ug,ug,ug,ug,ug,ug,ug,ug,ub,ux,ug,ux,ub,ux,ub,ub,ub,ub,ub,ub,ub
ux,ux,ug,ug,ug,ux,ug,ug,ux,ug,ub,ug,ug,ub,ub,ub,ub,ur,ub,ub,ub,ub,ub
ux,ux,ug,ug,ug,ug,ug,ug,ug,ug,ug,cg,ub,ub,ub,ub,ub,ur,ur,cb,ub,ub,ub
cr,ux,ug,ug,ug,ug,ug,ur,ur,ur,ur,ur,ur,ur,ur,ur,ur,ur,ur,ux,ux,ux,cr
cg,ux,ux,ux,ux,ug,ug,ux,ux,ug,ux,ux,ux,ux,ux,cr,ur,ur,ur,cb,cb,ux,cr
cr,cg,cg,cb,ux,ux,ug,ug,ug,ug,ux,ux,ux,ux,ux,cg,ur,ur,ur,cg,cg,ux,cr