ur,cb,cb,cr,ur,ur,ur,ur,ur,ur,ur,ur,ur,ur,ur,ur,ur,ur,ur,ur,ur,ur,cb
ur,ur,cb,ur,ur,ur,ur,ur,ur,ur,cg,ug,cb,ur,ur,ur,ur,ur,ur,ur,ur,ur,cg
cr,ur,ur,ur,ur,ur,ur,ur,ur,ur,ur,ur,ub,ub,ub,ub,ub,ug,ug,ug,ur,ur,ug
ur,ub,ur,ub,ur,ur,ur,ur,ur,ub,ur,ub,ub,ub,ub,ub,ub,ug,ug,ug,ux,ux,ug
ub,ub,ur,ub,ur,ur,ur,ur,ur,cr,ur,ug,ug,ug,ug,ug,ug,ug,ug,ur,ur,ur,ur
ub,cb,ur,ub,ur,ur,ur,ur,ur,ug,ur,ug,ug,ur,ug,ug,ug,ur,ug,ug,ug,ux,ur
cr,ur,ur,ur,ur,cr,ur,ur,ur,ur,ur,cg,ug,ug,ug,ug,ug,ug,ug,ug,ug,ux,ur
cb,ux,ur,ur,ur,ur,ur,ur,ur,ur,ur,ur,ur,ur,ur,ur,ur,ur,ur,ug,ur,ur,ur
ux,ux,ux,cr,ur,ur,ug,ub,ux,ux,ux,ug,ug,ug,ug,ug,ug,ug,cg,ug,ux,ux,ur
ub,ub,ug,ug,ub,cr,ug,ub,ux,ux,ux,ux,ug,ug,ug,ug,ug,ur,ug,ug,ug,cb,ub
ub,ug,ug,ug,ug,ug,ug,ug,ug,ux,ux,ux,ug,ug,ug,ux,ux,ur,ub,ub,ub,ub,ub
ub,ug,ug,ug,ug,ug,ug,ub,ug,ux,ux,ug,ug,ug,ux,ux,ux,ur,ug,ug,ux,ub,ub
cb,ug,ug,ug,ug,ug,ug,ug,ug,ug,ug,ug,ux,ug,ux,ux,ux,ur,ub,ub,ub,ub,ub
ub,ub,ug,ug,ug,ug,ub,ub,ux,ug,ux,ux,ux,ug,ug,ux,ux,ur,ub,ub,ub,ub,ub
ub,ub,cg,ug,ug,ug,ug,ux,ux,ug,ux,ux,ux,ux,ug,ug,ug,ur,ub,ux,cg,ub,ub
ub,ub,ub,ug,ug,ug,ug,ug,ug,ug,ug,ug,ug,ug,ug,ug,ug,ug,ug,ug,ug,ub,ub
ub,ub,ub,ug,ug,ug,ug,ug,ug,ug,ug,ug,ug,ug,ub,ug,ug,ub,ub,ub,ub,ub,ub
ub,ub,ug,cb,ug,ug,ux,ug,ug,ug,ug,ug,ug,ux,ub,ux,ug,ub,ub,ub,ub,ub,ub
ub,ug,ug,ub,ub,ug,ug,ug,ug,ug,ug,ug,ux,ug,ub,ug,ur,ub,ur,ug,ug,ug,ur
ub,ux,ug,ub,ub,ux,ug,ug,ux,ug,ux,ug,ug,ug,ub,ub,ug,ub,ug,ug,ur,ur,cb
cr,cb,ux,ub,ub,ux,ux,ug,ux,ug,ux,ug,ux,ux,ux,ub,ub,ub,ug,ur,ur,ur,cr
cg,ub,ub,ub,ub,ug,ug,ug,ux,ug,ux,ug,ug,ux,ux,ur,ub,ub,ur,cb,cb,ur,cr
cr,cg,cg,cb,ux,ux,ux,ux,ux,ug,ug,ug,ug,ux,ux,cg,ub,ub,ur,cg,cg,ur,cr