ub,cb,cb,cr,ur,ur,ur,ur,ur,ur,ux,ux,ux,ux,ux,ux,ux,ux,ux,cg,ux,ub,ub
cr,ur,ux,ux,ux,ux,ux,ux,ux,ur,ux,ux,ux,ur,ur,ur,ur,ux,ux,ux,ub,ub,ub
ub,ux,ur,ur,ur,ux,ux,ux,ux,ur,ux,ur,ur,ux,ux,ur,ur,ux,ux,cb,ub,ux,cr
ub,ux,ur,ux,ur,ux,ux,ur,ux,ur,ux,ur,ur,ur,ur,ur,ux,ux,ux,ux,ux,ux,ur
ub,ub,ur,ur,ur,ur,ur,ur,ug,ur,ur,ur,ur,ur,ur,ur,ur,ur,ur,ux,ux,ux,ur
ub,ub,ur,ur,ug,ug,ug,ur,ug,ur,ur,ur,ur,ur,ug,ur,ur,ur,ur,ux,ux,ux,ur
ur,ur,ur,ur,ug,ug,ug,ur,ug,ur,ub,cg,ur,ur,ug,ur,ur,ur,ur,ur,ur,ur,ur
ur,ur,ur,ur,cg,ug,ug,ur,ug,ug,cb,ug,ub,ug,ug,ug,ug,cg,ur,ur,ur,ur,ur
ur,ur,ur,ur,ur,ur,ug,ur,ur,ur,ub,ug,ub,ug,ug,ur,ug,ug,ug,ug,ur,ur,ub
ur,ur,ur,ur,ur,ur,ug,ur,ur,ur,ur,ug,ug,ug,ug,ub,ug,ug,ug,ur,ur,ur,ub
ur,ur,ur,ur,ur,ur,cr,ur,ur,ur,ur,ur,ug,ug,ug,ur,ug,ug,ug,ur,ur,ux,ub
ur,ur,ur,ur,ur,ur,ug,ug,ur,ur,ur,ur,ur,ur,ug,ug,ug,ug,ug,ur,ur,ux,ub
cg,ur,ur,ur,cr,ub,ub,ur,ur,ur,ur,ur,ur,ur,ug,ux,ux,ux,ug,ur,ur,ux,ub
ur,ur,ur,ur,ur,ur,cb,ur,ur,ur,ur,ux,ug,ux,ux,ux,ux,ug,ug,ur,ur,ug,ub
ur,ur,ur,ub,ug,ug,ug,ur,ur,ur,ur,ub,ug,ug,ug,ug,ug,ug,ub,ub,ur,ug,ub
ur,ur,ur,ub,ug,ub,ug,ub,ub,ug,ug,ub,ub,ub,ux,ux,ug,ug,ug,ug,ug,ug,ub
ur,ur,ur,ur,ug,ub,ug,cb,ub,ur,ur,ur,ur,ur,ur,ur,ur,ur,ur,ur,ur,ur,ub
cg,ub,ub,ur,ug,ub,ub,ub,ub,ub,ub,ub,ux,ux,ux,ub,ub,ub,ub,ub,ub,ub,ub
ub,ub,ub,ur,ug,ub,ub,ub,ub,ub,cb,ub,ub,ux,ux,ub,ux,ub,ub,ub,ur,ub,ur
ub,ub,ub,ur,ug,ub,ub,ub,ub,ux,ub,ub,ug,ug,ug,ub,ux,ub,ub,ub,ur,ub,ur
cr,ub,ug,ur,ug,ug,ub,ux,ug,ug,ug,ub,ub,ub,ug,ug,ug,ug,ug,ur,ur,ur,ur
cg,ub,ug,ur,ux,cg,ub,ux,ub,ub,ub,ub,ug,ug,ub,ug,ub,ug,ug,ur,ur,cb,cr
cr,ub,ub,ur,ur,ur,ur,ur,ur,ur,ur,ur,cr,ub,ub,ug,ug,ug,ur,ur,cb,ux,cr