ur,ur,ur,ur,ur,ur,ur,ur,ux,ux,ux,ux,ux,ux,ux,ux,ur,cb,ur,ur,ur,ur,ur
ur,ur,ur,ur,ur,ur,ur,ur,ur,ur,ux,ux,ux,ux,ux,ux,ur,ur,ur,ur,ur,ur,ur
ur,ur,ur,ur,ur,ur,ur,ur,ur,ur,ur,ux,ux,ux,ux,ux,ur,ur,ur,ur,ur,ur,ur
ur,ur,ur,ur,ur,ur,ur,ur,ur,ur,ur,ux,ur,ur,ur,ur,ur,ur,ur,ur,ur,ur,ur
ur,ur,ur,ur,ur,ur,ur,ur,ur,ur,ur,ur,ur,ur,ur,ur,ur,ur,ur,ur,ur,ur,ur
ur,ur,ur,ur,ur,ur,ur,ur,cr,ur,ur,ur,ur,ug,ug,ug,ug,ug,ug,ug,ur,ur,ur
ur,ur,ur,ur,ur,cb,ur,ur,cr,ur,ur,ur,ur,ur,cg,ug,ug,ug,ur,ug,ur,ur,ur
ur,ur,ur,ur,ur,cg,cb,ub,cr,ur,ur,ur,ur,ur,ur,ur,ur,ug,ug,ug,ur,ux,ur
ur,ur,ur,ur,ur,ug,cr,ug,ur,ub,ub,ug,ug,ug,ug,ux,ug,ug,ug,ug,ux,ux,ux
ur,ur,ur,ur,ur,cb,ug,ug,ur,ub,ub,ub,ub,ug,ug,ux,ug,ug,ux,ub,ux,ux,ux
cr,cb,ur,ur,ur,ub,ub,ub,ur,ub,ug,ug,ub,ux,ug,ux,ug,ux,ux,ub,ux,ux,ux
ur,ub,ub,ub,cr,ub,ug,ug,ur,ub,ug,ub,ub,ug,ug,ux,ug,ux,ux,ub,ux,ux,ux
ub,ug,ub,ub,ug,ub,ug,ug,ub,ub,ub,ub,ub,ug,ug,ug,ug,ux,ux,ub,ux,ux,ux
ub,ug,ub,ub,ub,ub,ug,ug,cg,ug,ub,ub,cb,ub,ux,ug,ug,ux,ux,ub,ux,ux,ux
cg,ug,ug,ug,ub,ub,ub,ub,ug,ub,ux,ug,ub,ub,ux,ug,ug,ux,ux,ub,ux,ux,ux
ux,ux,ux,ug,ub,ub,ub,ub,ur,ux,ug,ug,ug,ug,ug,ug,ug,ux,ux,ub,ux,ux,ux
ux,ux,ux,ug,ub,ub,ux,ub,ur,ux,ug,ug,ug,ug,ug,ug,ug,ux,ux,ub,ux,ux,ux
ux,ux,ux,ug,ux,ug,ux,ux,ub,ub,ub,ub,ub,ux,ug,ux,ur,ux,ub,ub,ux,ux,ux
ux,ux,ux,ug,ub,ug,ug,ub,ub,ug,ug,ub,ub,ub,ub,ug,ur,ub,ub,ux,ux,ux,ux
ux,ux,ux,ug,ub,ux,ux,ub,ur,ux,ub,ub,ub,ub,ub,ux,ur,ux,ux,ux,ux,ux,ux
ux,ux,ub,ug,ux,ux,ux,ub,ur,ub,ub,ux,ub,ub,ub,ub,ub,ub,ub,ub,ub,ux,ux
cr,ur,ur,ug,ur,ur,ur,ub,ur,ub,ub,ub,ub,ub,ub,ub,ub,ub,ub,ux,ub,ux,cb
cg,ur,ur,cg,ur,ur,ur,cb,ur,cg,ux,ub,ub,ux,ux,ub,ub,ur,ub,ub,ub,ux,ux