ur,ug,cr,ur,ug,ug,ug,ug,ug,ug,ug,ug,ug,ug,cr,ur,ur,ug,ug,ug,ug,ug,ug
ur,cg,ur,ur,ur,ur,ur,ur,ug,ur,ur,ur,ur,ur,ur,ur,ur,ub,ub,ux,ux,ux,ug
ur,cr,ur,ur,ur,ur,ur,ur,ur,ur,ur,ur,ur,ux,ur,ur,cr,ub,ub,ub,ub,ub,ug
ub,cb,ur,ur,ur,ur,ur,ur,ur,ur,ur,ur,ur,ur,ur,ur,ur,ub,ub,ux,ux,ux,ug
ub,ub,ur,ur,ur,ur,ur,ur,ur,ur,ub,ub,ub,ux,ux,ux,ub,ub,ub,ux,ux,ux,ug
ub,ub,ur,ur,ur,ur,ur,ur,ur,ur,ug,ub,ub,ub,ub,ub,ub,ub,ub,ux,ux,ux,ug
ub,ub,ur,ur,ur,ur,ur,ur,ur,ur,ug,ug,ug,ub,ug,ug,ux,ux,cb,ux,ux,ux,ug
ub,ur,ur,ur,ur,ur,ur,ur,ug,ug,ug,ug,ub,ub,ub,ub,ub,ub,ur,ux,ux,ux,ug
cg,ur,ur,cr,ub,ur,ur,ub,ub,ub,ug,ug,ub,ub,ub,ub,ub,ub,ub,ub,ur,ur,ur
ux,ux,ux,ur,ur,ur,ub,ub,ub,ub,ug,ug,ub,ub,ub,ub,ub,ub,ub,ux,ux,ux,ur
ux,ux,ux,ux,ub,ub,ub,ub,ub,ub,ug,ug,ug,ug,ub,ub,ub,ux,ub,ub,ub,ub,ur
ux,ux,ux,ux,ux,ub,ub,ub,ub,ub,ub,cg,ug,cb,ub,ub,ux,ux,ux,ux,ux,ux,ur
ux,ux,ux,ux,ux,ux,cg,ub,ub,ub,ub,ub,ub,ug,ub,ub,ux,ux,ux,ux,ux,ux,ur
ux,ux,ux,ux,ub,ux,ug,ux,ug,ug,ug,cb,ug,ug,ub,ub,ux,ux,ux,ux,ux,ux,ur
ux,ux,ux,ux,ub,ub,ug,ub,ug,cb,ux,ub,ub,ub,ub,ub,ux,ux,ux,ux,ux,ux,ur
ug,ug,ug,ug,ug,ub,ug,ug,ug,ub,ub,ub,ux,ux,ux,ux,ux,ux,ux,ux,ux,ux,ur
ug,ux,ux,ux,ux,ux,ug,ug,ug,ux,ux,ux,ux,ux,ux,ux,ux,ux,ux,ux,ux,ux,ur
ug,ux,ux,ux,ux,ur,ub,ug,ub,ub,ux,ux,ux,ux,ux,ux,ux,ux,ux,ux,ux,ux,ur
ug,ux,ux,ux,ux,ur,ub,ug,ug,ub,ub,ub,ub,ux,ux,ux,ux,ux,ux,ux,ux,ux,ur
ug,ux,ux,ux,ux,ur,ub,ub,ub,ub,ub,ub,ub,ux,ux,ux,ux,ux,ux,ux,ux,ux,ur
ug,ux,ux,ux,ux,ub,ub,ub,ub,ub,cb,ux,ux,ux,ux,ux,ux,ux,ux,ux,ux,ux,ur
ug,ux,ux,ub,ux,ub,ux,ub,ub,ux,ux,ux,ux,ux,ux,ux,ux,ux,ux,ux,ux,ux,ur
ug,ug,ug,ug,ug,ub,ub,ub,ug,ug,ug,ug,ug,ug,ug,ug,cr,ur,ur,ur,ur,ur,ur