ur,ur,ur,ur,ur,ur,ur,ur,ur,ur,ur,ur,ur,ur,ur,ur,ur,ur,ur,ur,ur,ug,ug
ur,ur,ur,ur,ur,ur,ur,ur,ur,ur,ur,ur,ur,ur,ug,ur,ur,ur,ux,ur,ur,ux,ug
ur,ur,ur,ur,ur,ur,ur,ur,ur,ur,cb,ur,ur,ur,ur,ur,ub,ub,ub,ub,ux,ux,ug
ur,cb,ub,cr,ur,ur,ur,ur,ug,ug,ub,cr,ub,ub,ub,ub,ub,ub,ux,ub,ub,ux,ug
cr,ub,ur,ub,ur,cr,ur,ur,cg,ur,ur,ur,ur,ug,ug,ug,ub,ub,ux,ux,ub,ub,ug
ub,ub,ux,ub,ur,ur,ur,ur,ur,ur,ur,ur,ux,ux,ug,ux,ub,ub,ux,ux,ux,ux,ug
ux,ux,ux,ub,ux,ub,ug,ug,cr,ur,ub,ub,ug,ug,ug,ux,ux,ub,ub,ub,ub,ux,ug
ux,ux,ux,ub,ub,ub,ug,ug,ug,ub,ub,ub,ux,ux,ux,ux,ux,ux,ux,ux,ub,ux,ug
cg,ux,ux,ux,ux,ug,ux,ub,ub,ub,ub,ub,ub,ub,ub,ub,ub,ux,ux,ux,ub,ux,ug
ux,ux,ux,ub,ub,ub,ug,ub,ub,ub,ub,ub,ub,ub,ub,ub,ub,ug,ug,ux,ub,ux,ug
ux,ux,ux,ub,ub,ub,ux,ub,ub,ub,ub,cb,ub,ub,ub,ub,ug,ug,ug,ug,ug,ux,ug
ux,ux,ux,ub,ub,ux,ux,ub,ub,ub,ub,cb,ub,ub,ub,ub,ug,ug,ug,ux,ug,ux,ug
ux,ux,ux,ub,ub,ub,ux,ux,ux,ux,ux,ub,ub,ub,ug,ug,ug,ug,ug,ug,ug,ux,ug
ux,ux,ux,ub,cb,ub,ux,ux,ux,ux,ub,ub,ub,ug,ux,ux,ux,ug,ug,ug,ub,ux,ug
ux,ux,ux,ux,ub,ub,ux,ux,ux,ux,ux,ub,ug,ux,ux,ux,ux,ug,ug,ug,ub,ux,ug
ux,ux,ux,ux,ub,ur,ur,ur,ur,ur,ub,ub,ug,ub,ub,ub,ug,ug,ug,ug,ub,ux,ug
ur,ur,ur,ur,ur,ur,ur,ur,ur,ur,ur,ur,ug,ug,ug,ug,ug,ug,ug,ug,ub,ur,ug
ur,ur,ur,ur,ur,ur,ub,ub,ub,ub,cg,ug,ug,ug,ub,ub,ug,ug,ug,ug,ub,ux,ug
ur,ur,ux,ux,ur,ur,ux,ug,ug,ug,ux,ux,ub,ug,ug,ug,ug,ug,ug,ux,ub,ux,ug
ur,ur,ux,cr,ur,ur,ug,ug,ux,ux,ux,ux,ux,ux,ux,ux,ux,ux,ux,ux,ub,ux,ug
ur,ur,ux,ur,ur,ur,ux,ux,ux,ux,ux,ux,ux,ux,ux,ux,ub,ub,ub,ub,ub,ux,ug
ur,ur,ur,ur,ur,ur,ux,ux,ub,ub,ub,ub,ub,ub,ub,ub,ub,ux,ux,ux,ux,ux,ug
ur,ur,ur,ur,cb,ub,ub,ub,ub,ur,ur,ur,ur,ur,ur,ur,ur,ur,ur,cg,ug,ug,ug