ur,ur,ur,ur,ur,ur,ur,ur,ur,ur,ur,ur,ur,ur,ur,ur,ur,ur,ux,ur,ur,ur,ur
ur,ur,ur,ur,ur,ur,cr,cr,ur,ur,ub,ub,ub,ur,ur,ur,ur,ur,ur,ur,ur,ur,ur
ur,ur,ur,ur,cb,ub,ub,ur,ux,ur,ur,ub,ub,ur,ur,ur,ur,ur,ur,ur,ur,ur,ur
ur,ur,ur,ur,ur,cr,ur,ur,ur,ur,ur,ub,ub,ur,ur,ur,ur,ur,ur,cr,ur,ur,cb
ur,ur,ur,ur,ur,ur,ur,ux,ur,ur,ur,ur,cb,ur,ur,ur,ur,ur,ur,ur,ur,ur,ux
ur,ur,ur,ur,ur,ur,ur,ug,ug,cg,ug,ug,ur,ur,ur,ur,ur,ur,ur,ur,ur,ur,ux
ur,ur,ur,ur,ur,ur,ur,ug,ug,ug,ug,ug,ur,ug,ug,cr,ug,ug,ur,ur,ur,ur,ux
ur,ur,ur,ur,ur,ur,ur,ug,ug,ug,ug,ur,ur,ug,ur,ur,ug,ug,ur,ur,ur,ur,ux
cg,ur,ur,ur,ur,ur,ur,ug,ug,ug,ug,ug,ug,ug,ur,ur,ug,ug,ux,ux,ux,ur,ux
ur,ur,ur,ur,ur,ur,ur,ug,ug,ug,ur,ug,ur,ur,ur,ur,ug,ug,ur,ur,ux,ur,ux
ur,ur,ur,ur,ur,ur,ur,ur,ug,ug,cg,ug,ug,ub,ux,ux,ux,ug,ux,ur,ur,ur,ux
ur,ur,ur,ur,ur,ur,ur,ur,ur,ub,ur,ub,ug,ug,ug,ug,ug,ug,ug,ux,ux,ux,ux
ur,ur,ur,ur,ur,ur,ur,ug,ub,ub,ub,ub,ub,ub,ub,ub,ub,ub,ub,ub,ub,ub,cb
ur,ur,ur,ur,ur,ur,ur,ug,ub,ub,ub,ub,ub,ub,ub,ub,ub,ub,ub,ub,ub,ub,ur
cg,ur,ur,ur,ur,ur,ur,ux,ub,ub,ub,ug,ug,ug,cb,ug,ub,ub,ub,ux,ux,ux,cr
ug,ug,ug,ug,ug,ug,ug,ug,ub,ub,ug,ug,ub,ub,ub,ug,ug,ub,ux,ux,ux,ux,ub
ug,ux,ux,ug,ug,ug,ug,ug,ub,ux,ug,ux,ub,ub,ub,ub,ug,ug,ux,ux,ux,ux,ub
ug,ux,ux,ug,ux,ug,ug,ug,cg,ug,ug,ux,ub,ub,ub,ub,cb,ug,ux,ux,ux,ux,ub
ug,ux,ux,ug,ug,ug,ug,ux,ug,ux,ux,ux,ux,ux,ub,ub,ug,ug,ux,ux,ux,ux,ub
ug,ux,ux,ug,ug,ug,ug,ux,ug,ux,ux,ux,ux,ux,ux,ub,ux,ux,ux,ux,ux,ux,ub
ub,ub,ub,ub,ub,ub,ub,ub,ug,ug,ug,ub,ub,ub,ub,ug,ub,ub,ub,ub,ub,ub,ub
ub,ux,ux,ug,ug,ug,ug,ux,ub,ux,ug,ug,ug,ug,ug,ug,ux,ux,ux,ux,ux,ux,cb
ub,ub,ub,ub,ub,ub,ub,ub,ub,cg,ux,ux,ux,ux,ux,ux,ux,ux,ux,ux,ux,ux,ux