ur,ur,ur,ur,cb,ub,ub,ub,ub,ub,ub,ub,ub,ub,ub,ub,ub,ub,ub,ub,ub,ub,ub
ur,ur,ur,ur,ur,ur,ur,ur,ur,ur,ur,ur,ur,ur,ur,ur,ur,ur,ur,ur,ur,ur,ub
ur,ur,ur,ur,ur,ur,ur,ur,ur,ur,ur,ur,ur,ur,ur,ur,ur,ur,ur,ur,ur,ur,ub
ur,ur,ur,ur,cr,ur,ur,ur,ur,ur,ur,ur,ur,ur,ur,ur,ur,ur,ub,cb,ux,ur,ub
ur,ur,ur,ur,ug,ur,ur,ur,ub,cb,ur,ur,ur,ur,ur,ur,ur,ur,cr,ur,ur,ur,ub
ur,ur,ur,ur,ug,cr,ur,ur,ub,ub,ug,ur,ur,ur,ur,ug,cr,ur,ug,ug,ur,ur,ub
ug,ux,ux,ur,ur,ug,cr,ur,ur,ur,cg,ur,ur,ur,ur,cg,ug,ug,ug,ug,ur,ur,ub
ug,ug,ug,ug,ug,ug,ub,ug,ub,ub,ub,ub,ub,ug,ug,ug,ug,ug,ub,ub,cb,ur,ub
cg,ux,ux,ux,ug,ub,ub,ug,ub,ug,ub,ub,ub,ug,ug,ug,ug,ug,ub,ux,ux,ux,ub
ux,ug,ug,ug,ug,ug,ug,ug,ub,ub,ub,cb,ub,ub,ug,ub,ub,ux,ub,ux,ux,ux,ub
ux,cg,ux,ug,ux,ug,ux,ux,ug,ub,ub,ub,ub,ub,ub,ub,ub,ux,ub,ux,ux,ux,ub
ux,ux,ug,ug,ux,ug,ux,ux,ug,ux,ux,ub,ub,ux,ux,ux,ub,ux,ub,ux,ug,ux,ub
ux,ux,ug,ux,ux,ug,ux,ux,ug,ux,ux,ux,ug,ux,ux,ux,ub,ux,ub,ux,ug,ux,ub
ux,ux,ug,ug,ux,ug,ux,ux,ug,ux,ux,ux,ug,ux,ux,ux,ub,ub,ub,ux,ug,ux,ub
cg,ub,ux,ug,ux,ug,ux,ux,ug,ux,ux,ux,ug,ux,ux,ux,ub,ub,ux,ux,ug,ux,ub
cb,ub,ub,ug,ux,ug,ux,ux,ug,ux,ux,ux,ug,ux,ux,ux,ub,ub,ux,ux,ug,ux,ub
ub,ub,ub,ug,ug,ug,ux,ux,ug,ux,ux,ux,ug,ug,ux,ux,ub,ub,ux,ux,ug,ux,ub
ub,ub,ub,ub,ub,ub,ub,ub,ub,ub,cr,ub,ub,ub,ub,ub,ub,ub,ub,ub,ub,ub,ub
ub,ub,ux,ux,ug,ug,ux,ux,ux,ug,ur,ug,ug,ug,ux,ux,ux,ug,ug,ug,ug,ux,ur
ub,ub,ux,ux,ux,ux,ux,ub,ub,ug,ur,ug,ug,ug,ug,ug,ug,ug,ux,ux,ux,ux,ur
ur,ur,ur,ur,ur,ur,ur,ur,ur,ur,ur,ur,ur,ur,ur,ur,ur,ur,ur,ur,ur,ur,ur
ur,ub,ub,ux,ux,ux,ux,ux,ur,ur,ur,ur,ur,ur,ur,ur,ur,ur,ur,ur,ur,ur,cb
ur,ur,ur,ur,ur,ur,ur,ur,ur,cg,ur,ur,ur,ur,ur,ur,ur,ur,ur,ur,ur,ur,ur