ub,cb,cb,ux,ux,ux,ur,ur,ur,ur,ur,ur,ur,ur,ur,ur,ur,ur,ur,cg,ur,ur,ur
cr,ur,ux,ux,ux,ux,ur,ur,ur,ur,ur,ur,ur,ur,ur,ur,ur,ur,ur,ur,ur,ur,ur
ux,ux,ux,ux,ux,ux,ur,ur,ur,ur,ur,ug,ur,ur,ur,cr,ub,cb,ur,ur,ur,ur,ur
ux,ux,ux,ur,ur,ur,ur,ur,ur,ur,cr,ug,ug,ur,ur,ur,ur,ur,ur,ur,ur,ur,ur
ux,cr,ux,ux,ux,ur,ur,ur,ur,ur,ur,ur,cg,ub,ur,ur,ur,ur,ur,ur,ur,ur,ur
ux,ur,ur,ur,cg,ug,ur,ur,ur,ur,ur,ur,ur,ub,ur,ur,ur,ur,ur,ur,ur,ur,ur
ur,ur,ur,ux,ux,ug,ug,ur,ur,ur,ur,ur,cr,ub,ur,ur,ur,ur,ur,ur,ur,ur,ur
ur,ur,ur,ur,ur,ur,ug,ug,ur,ur,ur,ur,ur,ub,ur,ur,ur,ur,ur,ur,ur,ur,ur
ur,ur,ur,ur,ug,ug,ur,ug,cg,ug,ug,ug,ur,ub,cb,ur,ur,ug,ur,ur,ug,ug,ux
ur,ux,ux,ur,ug,ur,ur,ug,ug,ub,ur,ur,ur,ur,ur,ur,ub,ux,ux,ux,ug,ug,ux
ur,ux,ux,ur,ug,ub,ur,ug,ug,ug,cg,ur,ur,ur,ur,cr,ub,ug,ug,ug,ug,ug,ux
ux,ux,ux,ux,ux,ub,ub,ub,cb,ug,ur,ub,ug,ub,ug,ug,ug,ug,ug,ug,ug,ug,ux
cg,ux,ux,ux,ux,ub,ub,ub,ub,ug,ur,ub,ug,ub,ux,ug,ug,ux,ug,ug,ug,ug,ux
ux,ux,ug,ug,ug,ug,ug,ub,ug,ug,ur,ug,ug,ug,ug,ug,ug,ug,ug,ug,ug,ux,ux
ux,ug,ub,ub,ug,ug,ub,ub,ug,ug,ur,ug,ug,ug,ug,ug,ug,ug,ug,ug,ug,ux,ux
ux,ug,ub,ub,ub,ub,ub,ub,ug,ug,ur,ug,ug,ug,ug,ug,ug,ug,ug,ug,ug,ux,ux
ux,ug,ub,ub,ub,ub,ub,ub,ug,ug,ur,ub,ug,ub,ug,ug,ug,ug,ug,ux,ug,ux,ux
cg,ug,ub,ub,ub,ub,ug,ub,ug,ug,ur,ug,ug,ub,ug,ux,ug,ux,ux,ux,ug,ux,ux
ux,ug,ug,ub,ug,ug,ug,cb,ug,ug,ur,ub,ub,ub,cb,ug,ug,ux,ug,ug,ug,ux,ux
ux,ux,ug,ub,ug,ug,ug,ub,ub,ug,ur,ub,ug,ug,ub,ub,ug,ux,ug,ug,ug,ux,ux
cr,ux,ug,ux,ug,ug,ug,ug,ug,ug,ur,ub,ub,ug,ug,ub,ug,ug,ug,ux,ur,ux,ux
cg,ur,ur,ur,ur,ur,ur,ur,ug,ug,ur,ub,ub,ub,ub,ub,ur,ur,ur,ur,ur,cb,cr
cr,ur,ur,ur,ur,ur,ur,ur,ur,ur,ur,ub,ub,ub,ug,ux,ux,ux,ux,ux,cb,ux,cr