cb,cb,cb,cr,ur,ur,cr,ur,ur,ur,ur,ur,ur,ur,ur,ur,ur,ur,ur,ur,ur,ur,cb
ux,ur,ur,ur,ur,ur,ub,ur,ux,ux,ur,ur,ur,ur,ur,ur,ur,ur,ur,ur,ur,cr,ur
ug,cg,ur,ur,ur,cb,ub,ug,ur,ur,ur,ur,ur,ur,ur,ur,ur,ur,ur,ur,ub,ub,ub
ug,ug,cr,ur,ur,ur,ur,ug,ur,ur,ur,ur,ur,ur,ur,ur,ur,ur,ug,ub,ux,ub,ub
ux,ug,ug,ug,ub,ur,ug,ug,ug,ub,ur,ur,ur,ur,ur,ur,ur,ur,ug,ux,ux,ub,ub
ub,ug,ub,cb,ub,ub,ug,ug,ug,ug,ug,ug,ux,ur,ur,ur,ur,ur,ug,ub,ub,ub,cb
ub,ug,ub,ug,ug,cg,ug,ug,ur,ur,cr,ug,ur,ur,ur,ur,ur,ur,ub,ux,ux,ux,ux
cb,ug,ug,ub,ub,ug,ur,ug,ur,ur,ur,ug,ux,ur,ur,ur,ur,ur,ub,ux,ux,ux,ux
ur,ug,ub,ub,ub,ug,ug,ug,ux,ux,ur,ug,ur,ur,ur,ur,ur,ur,ug,ug,ux,ux,ux
ur,ug,ub,ub,ub,ur,ur,ur,ux,ur,ur,cg,ur,ur,ur,ur,ur,ur,ux,ug,ux,ux,ux
ux,ug,ug,ur,ux,ux,ux,ur,ux,ur,ur,ur,ur,ur,ur,ur,ur,ur,ug,ug,ug,ug,ug
ur,ur,ug,ug,ug,ug,ur,ur,ur,ur,ur,ur,ur,ur,ur,ur,ur,ur,ux,ug,cg,ug,ug
cb,ur,ug,ur,ur,ug,ur,ur,ur,ur,ur,ur,ur,ur,ur,ur,ur,ur,ux,ug,ug,ug,ug
ug,ur,ug,ug,ug,ug,ug,ug,cr,ur,ur,ur,ur,ur,ur,ur,ur,ur,ug,ug,ug,ug,ug
ug,ug,ub,ub,ug,ug,ug,ur,ub,ur,ur,ur,ub,ur,ub,ug,ug,ur,ug,ug,ug,ug,ug
ug,ug,ug,cb,ub,ub,ub,ub,ub,ub,ub,ub,ub,cb,ux,ux,ux,ur,ux,ug,ug,ur,ug
ug,ub,cg,ub,ub,ux,ux,ux,ux,ux,ub,ub,ub,ux,ux,ux,ux,ur,cr,ug,ug,ur,ur
cr,ub,ub,ub,ub,ux,ux,ux,ux,ux,ux,ux,ux,ux,ux,ux,ux,ur,ur,ux,ux,ur,ur
cg,ub,ub,ub,ub,ux,ux,ux,ux,ux,ux,ux,ux,ux,ux,ux,ux,ur,ur,ux,ux,ur,ur
cb,ub,ub,ub,ub,ux,ux,ux,ux,ux,ux,ux,ux,ux,ux,ux,ux,ur,ur,ur,ur,ur,ur
ux,ux,ux,ux,ux,ux,ux,ux,ux,ux,ux,ux,ux,ux,ux,ux,ux,ur,ur,ur,ur,ur,cr
cr,ub,ub,ub,ub,ub,ux,ux,ux,ux,ux,ux,ux,ux,ux,ux,ux,cb,cg,ux,cb,ur,cr
cg,ub,cg,cb,cb,ub,ux,ux,ux,ux,ux,ux,ux,ux,ux,cg,ux,ux,ux,cg,cg,ur,cr