ur,ur,ur,ur,ur,ur,ur,ur,ur,ur,ur,ur,ur,ur,ur,ur,ux,cb,ur,ur,ur,ur,ur
ub,cr,cr,cr,ug,ur,ur,ur,ur,ur,ug,ug,ug,ug,ux,ug,ug,ug,ur,ur,ur,ur,ur
ub,ur,ur,ur,cg,ur,cr,ur,ur,ur,ug,ug,ur,ug,ur,ug,ur,ug,ur,ur,ur,ux,ur
ub,cb,ub,ub,ur,ur,ub,ur,ur,ur,ux,ug,ug,ug,ug,ug,ug,ug,ub,ur,cg,ub,ur
ub,cb,ub,ub,ur,ur,ub,ur,ur,ur,ur,ug,ug,ub,ub,ug,ug,ug,ug,ug,ug,ur,ur
ur,ur,ur,ur,ur,ur,cb,ur,ur,ug,ug,ur,ug,ub,ub,ub,ug,ub,ug,ug,ug,ux,ux
ub,ub,ub,ub,ur,ub,ur,ur,ur,ug,ug,ug,ug,ub,ub,ug,ug,ub,ug,ug,ug,ux,ux
ub,ub,ub,ub,ub,cr,ur,ug,ug,ug,ur,ug,ug,ub,ub,cr,ug,ub,ug,ug,ug,ux,ux
ug,ub,ub,ub,ur,ur,ux,ur,ux,ur,ux,ux,ug,ub,ub,ur,ug,ug,ug,ug,ug,ux,ux
ug,ub,ub,ub,ub,ux,ux,ur,ur,ur,ub,ub,ub,ub,ug,ur,ub,ug,ur,ug,ug,ux,ux
ug,ub,ub,ub,ub,ug,ug,ug,ub,ub,ug,ub,ub,ug,ug,ur,ub,ub,ur,ug,ug,ux,ux
ub,ub,ub,ub,ub,ux,ux,ux,ux,ub,ub,ub,ub,ug,ug,ur,ub,ub,ur,ug,ug,ux,ux
ub,ub,ub,ub,ub,ux,cg,ug,ug,ug,ug,ub,ub,cb,ug,ur,ub,ub,ur,ug,ug,ux,cg
ub,ub,ub,ub,ub,ux,ux,ux,ub,ub,ug,ub,ug,ug,ug,ur,ug,ux,ur,ug,ug,ux,ux
ub,ub,ub,ub,ub,ux,ux,ux,ub,ub,ug,ub,ug,ug,ug,ur,ug,ux,ur,ug,ug,ux,ux
ug,ub,ub,ub,ub,ux,ux,ux,ux,ub,ug,ub,ub,ub,ub,ur,ug,ux,ug,ug,ug,ux,ux
ug,ug,ug,ub,ub,ug,ug,ug,ug,ub,ub,ub,ub,ub,ug,ur,ug,ux,ug,ux,ug,ux,ux
cg,ur,ur,ub,ug,ug,ug,ug,ug,ub,cb,ur,ur,ur,ur,ur,ur,ur,ug,ux,ug,ux,ux
ux,ur,ux,ub,ug,ug,ug,cg,ux,ug,ug,ug,ug,ug,ug,ur,ug,ur,ug,ug,ug,ux,ux
ux,ur,ux,cb,ux,ux,ux,ux,ux,ux,ux,ux,ux,ux,ux,ur,ug,ur,ug,ug,ux,ux,ux
ux,ur,ux,ux,ux,ux,ux,ux,ux,ux,ux,ux,ux,ux,ux,ur,ug,ur,ug,ug,ux,ux,ux
cr,ur,ux,ux,ux,ux,ux,ux,ux,ux,ux,ux,ux,ux,ux,ur,ux,ur,ur,ux,ux,ub,cb
cg,ur,ur,ur,ur,ur,ur,ur,ur,ur,ur,ur,ur,ur,ur,ur,ur,ur,ur,cg,cb,ux,ur