cb,ub,ub,cr,ur,ur,ur,ur,ur,ur,ur,ur,ur,ur,ub,ub,ub,ub,ub,ub,ub,ub,ur
ur,ur,ur,cr,ur,ur,ur,ur,ur,ub,ub,ub,ur,ur,ur,ur,ur,ur,ur,ur,ur,ub,ub
cr,ub,ub,cb,ur,ur,ur,ur,ur,ub,ur,ub,ur,ur,ur,ur,ur,ur,ur,ur,ur,ur,ub
ur,ur,ur,ur,ur,ur,ur,ur,ub,ub,ub,ur,ur,ur,ur,ur,ur,ur,ur,ur,ur,ur,ub
ur,ur,ur,ur,ur,ur,ur,ur,ub,ub,ub,ur,ur,ur,ur,ur,ur,ur,ur,ux,ur,ur,ub
ur,ur,ur,ur,ur,ur,ur,ur,ub,ur,ub,ur,ur,ur,ur,ur,ur,ur,ug,ux,ux,ur,ub
ur,ur,ur,ur,ur,ur,ur,ur,ub,ub,ub,ur,ur,ur,ur,ur,ur,ux,ug,ur,ur,ur,ub
ur,ur,ur,ur,ur,ur,ur,ur,cg,ug,ub,cb,ur,ur,ug,ug,ux,ux,ug,ux,ub,ub,ub
ur,cr,ur,ur,ur,ur,ub,ub,ug,ub,ux,ug,ux,ug,ug,ug,ug,ux,ug,ux,ub,ux,ub
ur,ur,ur,cr,ur,ug,ug,ub,ug,ug,ub,ug,ux,ux,ux,ux,ug,ux,ug,ux,ux,ux,ub
cg,ug,ug,ug,ug,ug,ug,ug,ub,ub,ub,ug,ub,ug,ug,ug,ug,ux,ug,ux,ux,ux,ub
ub,ub,ub,ux,ux,ug,ux,ux,ub,ug,ub,ug,ub,ux,ux,ug,ug,ux,ug,ug,ux,ux,ub
ub,ub,ub,ux,ux,ug,ug,ug,ub,ug,ub,ub,ub,cb,ux,ug,ug,ux,ub,ug,ub,ub,ub
ug,ux,ux,ux,ux,ux,ux,ux,cb,ug,ug,ug,ub,ub,ux,ux,ux,ux,ux,ug,ux,ux,ur
ug,ux,ub,ub,ub,ub,ub,ub,ub,ug,ug,ub,ub,ub,ux,ux,ux,ux,ux,ug,ux,ux,ur
ug,ux,ux,ux,ux,ux,ub,ub,ub,ux,ux,ub,ub,ub,ux,ux,ux,ux,ux,ug,ux,ux,ur
ug,ux,ux,ux,ux,ux,ux,ub,ub,ux,ux,ub,ub,ub,ux,ux,ux,ux,ux,ug,ux,ux,ur
ur,ur,cr,ur,ur,ur,ur,ur,ur,ur,ur,ur,ur,ur,ur,ur,ur,ur,ur,ug,ur,ur,ur
ur,ux,ur,ux,ux,ux,ux,ux,ux,ux,ux,ux,ux,ux,ux,ux,ux,ux,ux,ug,ug,ug,ug
ur,ux,ur,ux,ux,ux,ux,ux,ux,ux,ux,ux,ux,ux,ux,ux,ux,ux,ux,ux,ux,ur,ug
ur,ur,ur,ur,ur,ur,ur,ur,ur,ur,ur,ur,ur,ur,ur,ur,ur,ur,ur,ur,ur,ur,ug
ur,ur,ur,ur,ur,ur,cg,ug,ug,ug,ug,ug,ug,ug,ug,ug,ug,ug,ug,ug,ug,ug,ug
ux,ux,ux,ux,ux,ux,ux,cg,ux,ux,ux,ux,ux,ux,ux,ux,ux,ux,ux,ux,ux,cb,ug