ur,ur,ur,ur,ur,ur,ur,cr,ur,ub,cb,ug,ug,cg,ur,ur,ur,cb,ur,ur,ur,ur,ur
ur,ur,ur,ur,ur,ur,cb,ur,ur,cr,ux,ur,ur,ur,ur,ur,ur,ur,ur,ur,ub,cb,ur
ur,ur,ug,ug,ug,ur,ub,cg,ug,ug,ug,ur,ur,ur,ug,ug,ur,cr,ur,ur,ub,ur,ur
ug,ux,ug,ug,ug,ub,ub,cr,ur,ur,ur,ur,ur,ur,ug,ub,ur,ug,ur,ur,ub,ur,ur
ug,ug,ug,ug,ug,ug,ug,ug,ur,ur,ur,ur,ur,ur,ug,ub,ur,ug,ur,ur,cr,ur,ur
ub,ub,ub,ug,ug,ug,ug,ur,ug,ug,ug,ub,ub,ur,ug,ug,ug,ug,ug,ur,ub,ur,ur
ug,ux,ux,ug,ug,ug,ug,ur,ug,ur,ug,ub,ub,ub,ub,ub,ub,ub,ug,ug,ub,ub,cb
ug,ug,ug,ug,ub,ub,ub,ub,ug,ur,cb,ub,ub,ub,ur,ub,ub,ur,cg,ur,ub,ub,ub
ux,ux,ux,ux,ug,ug,ux,ux,ug,cr,ur,ur,ur,ur,ur,ur,ur,ur,ur,ur,ub,ub,ub
ux,ux,ux,ux,ug,ug,ug,ug,ug,ug,ug,ub,ug,ug,ub,ub,ub,ub,ub,ub,ub,ub,ur
ux,ux,ux,ug,ug,ug,ug,ug,ug,ug,ug,ug,ug,ug,ub,ub,ub,ub,ub,ub,ub,ub,ur
ux,ux,ux,ug,ug,ux,ux,ux,ux,ux,ug,ug,ux,ug,ux,ux,ux,ub,ub,ub,ub,ub,ur
cg,ux,ux,ux,ug,ug,ug,ux,ux,ux,ux,ug,ux,ug,ux,ug,ug,ug,ux,ux,ub,ub,ur
ux,ux,ux,ux,ux,ug,ug,ux,ux,ux,ux,ug,ux,ug,ux,ug,ug,ug,ux,ux,ux,ux,ur
ux,ux,ux,ug,ug,ug,ux,ux,ux,ux,ux,ug,ug,ug,ux,ug,ug,cg,ux,ux,ux,ux,ur
ux,ux,ux,ug,ux,ux,ux,ux,ug,ug,ug,ug,ug,ub,ug,ug,ub,ub,ux,ux,ux,ux,ur
ux,ux,ux,ug,ux,ux,ux,ux,ug,ux,ux,ux,ug,ux,ug,ux,ux,ux,ux,ux,ux,ux,ur
cg,ux,ux,ug,ux,ux,ux,ux,ug,ug,ug,ug,ug,ux,ug,ux,ux,ux,ux,ux,ux,ux,ur
ux,ux,ux,ug,ux,ux,ux,ux,ug,ug,ug,ug,ug,ug,ug,ux,ux,ux,ux,ux,ux,ux,ur
ur,ur,ur,ug,ux,ux,ux,ux,ug,ug,ug,ug,ug,ug,ug,ux,ux,ux,ux,ux,ux,ux,ur
ur,ur,ur,ug,ug,ug,ug,ug,ug,ug,ug,ug,ug,ug,ug,ux,ux,ux,ux,ux,ur,ur,ur
cr,ur,ur,ur,ur,ur,ur,ur,ur,ur,ur,ur,ur,ur,ur,ur,ur,ur,ur,ur,ur,cb,cr
cg,ur,ur,ur,ur,ur,ur,ur,ur,ur,ur,ur,ur,cb,ux,ux,ux,ux,ux,cg,cb,ux,cr