ub,cr,ur,ur,ur,ur,ur,ur,ur,ub,ub,ub,ub,ub,ub,ub,ub,ub,ub,cg,ur,ur,ur
ub,ub,ub,ux,ur,ur,cr,ur,ur,ur,ug,ub,ub,ub,ub,ub,ub,ub,ub,ub,ub,ub,ur
ur,cb,ub,ur,ur,ur,ur,ur,ug,ur,ur,ub,ub,ub,ub,ub,ub,ub,ub,ub,ub,ur,ur
ur,ug,ug,cg,ur,ur,ur,ur,ug,ug,ub,ub,ub,ub,ub,ub,ub,ub,ub,ub,ub,ux,ub
ur,ug,ur,ur,ur,ur,ug,ur,ur,ug,ur,ub,ub,ub,ub,ub,cg,ug,ug,ub,ub,ux,ub
ug,ur,ur,ur,ur,ur,ur,ur,ug,ug,ub,ub,ux,ub,ub,ug,ug,ug,ug,ub,cg,ur,ub
cr,ur,ug,ur,ur,ur,ur,ug,ug,ug,ug,ug,cb,ub,ub,ub,ug,ub,ub,ub,ug,ux,ub
ug,cr,ur,cr,ur,ug,ug,ug,ux,ux,ub,ug,ug,ug,ub,cb,ug,ub,ub,ug,ug,ux,ub
ug,ug,ur,ug,ur,ur,ug,ug,ug,ug,ug,ug,ug,ug,ug,ug,ug,ug,ug,ug,ug,ug,ug
ub,ub,ux,ub,ub,ur,ur,ug,ug,ug,ug,ug,ug,ug,ug,ug,ub,ub,ub,ux,ux,ux,ug
cb,ub,ux,ub,ub,ug,ug,ug,ug,ug,ug,ug,ug,ug,ug,ug,ug,ug,ux,ux,ux,ux,ug
ub,ub,ux,ub,ub,ug,ug,ug,ug,ug,ub,cb,ug,ug,ug,ug,ug,ug,ux,ux,ux,ux,ug
cg,ub,ub,ub,ub,ub,ub,ug,ub,ub,ub,ug,ug,ug,ug,ug,ub,ur,ub,ux,ux,ux,ug
ux,ux,ux,ux,ub,ub,ub,ub,ub,ub,ug,ug,ug,ug,ub,ug,ug,ub,ub,ub,ub,ux,ug
ux,ux,ux,ux,ux,ux,ub,ux,ux,ub,ub,ub,ug,ub,ub,ub,ug,ub,ux,ux,ub,ug,ug
ux,ux,ux,ux,ux,ux,ub,ub,ux,ub,ug,ug,ug,ub,ub,ub,cb,ub,ub,ux,ug,ug,ur
ux,ux,ux,ux,ux,ux,ub,ug,ug,ug,ug,ug,ug,ug,ug,ug,ub,ug,ub,ub,ug,ug,ur
cg,ux,ux,ux,ux,ub,ub,ub,ub,ug,ub,ug,ug,ub,ux,ux,ux,ub,ub,ub,ug,ug,ur
ux,ux,ux,ux,ux,ub,ub,ub,ub,ub,ub,ub,ub,ug,ux,ub,ub,ub,ub,ub,ub,ug,ug
ux,ub,ub,ub,ub,ub,ub,ub,ub,ub,ub,ub,ub,ux,ux,ub,ux,ub,ux,ug,ug,ug,ug
cr,ux,ub,ub,ub,ub,ub,ub,ub,cg,ug,ug,ug,ug,ug,ug,ug,ug,ug,ug,ur,ur,ur
cg,cb,ub,ur,ur,ur,ur,ur,ur,ur,ur,ur,ur,ur,ub,ub,ux,ux,ux,ux,ux,cb,cr
cr,ur,ur,ur,ur,ur,ur,ur,ur,ur,ur,ur,ur,ur,ur,ur,ur,ur,ur,cr,cb,ux,cr