ur,ur,ur,ur,ur,ur,ur,ur,ur,ur,ur,ur,ur,ur,ur,ur,ur,ur,ur,ur,ur,ur,cb
ur,ur,ur,ur,ur,ur,ur,ur,ur,cr,ur,ur,ur,ur,ur,ur,ur,ug,ug,ug,ug,ug,ug
ur,ur,ur,ur,ur,ur,ur,ur,ur,ur,ur,ur,ur,ur,ur,ur,ur,ur,ur,ur,ur,ur,ug
ur,ur,ur,ur,ur,cb,ur,ur,ur,ur,ur,ur,ur,ur,ur,ux,ur,ur,ux,ux,ur,ur,ug
ur,ur,ur,ur,ur,ub,ur,ur,ur,cr,ur,ur,ur,ur,ur,ux,ur,ur,ur,ur,ur,ur,ug
ur,ur,ur,ur,ur,cr,ur,ur,ur,ur,ur,ur,ur,ur,ur,ur,ur,ur,ur,ur,ur,ur,ug
ur,ur,ur,ur,ur,ur,ur,ur,ur,ur,ur,ub,ub,ub,ur,ur,ur,ur,ur,ur,ur,ur,ug
ur,ur,ur,ur,ur,ur,ur,ur,ur,ur,ur,ub,ur,ub,ur,ur,ur,ur,ux,ux,ux,ux,ug
cg,ur,ur,ur,ur,ur,ub,ub,ug,ux,ur,ur,ug,ub,ug,ug,ug,ug,ux,ux,ux,ux,ug
ub,cr,ur,ur,ur,ur,cr,ub,ug,cb,ug,ub,ug,ub,ug,ug,ug,ug,ug,ug,ux,ux,ug
ub,ub,ux,ur,ug,ub,ub,ub,ub,ub,ug,ub,cb,ub,ug,ug,ux,ug,ug,ug,ux,ux,cg
ub,ub,ur,ug,ug,ug,ug,ug,ug,ug,ug,ub,ub,ub,ug,ug,ux,ux,ux,ug,ux,ux,ub
ub,ub,ub,ug,ug,ug,cg,ub,ub,ub,ub,ub,ub,ub,ug,ug,ug,ux,ux,ug,ux,ux,ub
ub,ub,ub,ug,ux,ug,ug,ug,ux,ub,ub,ub,ub,ub,cb,ur,ur,cr,ux,ug,ux,ux,ub
ub,ub,ub,ug,ux,ug,ug,ug,ub,ug,ub,cb,ug,ug,ug,ug,ug,ug,ug,ug,ux,ux,ub
ub,ub,ub,ug,ux,ug,ug,ub,ub,ug,ub,ub,ux,ug,ug,ug,ug,ux,ug,ug,ux,ux,ub
ub,ub,ub,ux,ux,ux,ug,ub,ub,cg,ub,ub,ux,ux,ug,ug,ug,ug,ug,ug,ux,ux,ub
ub,ub,ub,ux,ux,ux,ug,ug,ub,ux,ux,ux,ux,ux,ux,ux,ux,ux,ux,ug,ux,ux,ub
ub,ub,ub,ux,ux,ux,ux,ug,ug,ug,ug,ug,ug,ug,ug,ug,ug,ug,ug,ug,ux,ux,ub
ub,ub,ub,ux,ux,ux,ux,ux,ux,ux,ux,ux,ux,ux,ux,ux,ux,ux,ux,ux,ux,ux,ub
ub,ub,ub,ux,ux,ux,ux,ux,ux,ux,ux,ux,ux,ux,ux,ux,ux,ux,ux,ux,ux,ux,ub
ub,ub,ub,ux,ux,ux,ux,ux,ux,ux,ux,ux,ux,ux,ux,ux,ux,ux,ux,ux,ux,ux,ub
ub,ub,ub,ub,ub,ub,ub,ub,ub,ub,ub,ub,ub,ub,ub,ub,ub,ub,ub,ub,ub,ub,ub