ux,ux,ur,ur,ur,ur,ur,ur,ur,ur,ur,ur,ur,ur,ur,ur,ur,cb,ub,ub,ub,ub,ub
ux,ux,ur,ug,ug,ug,ur,cg,ur,ur,ur,ur,ur,ur,cb,ub,ur,ur,ub,ur,ur,ur,ub
ux,ux,ug,ug,ug,ug,ur,ug,ug,ug,ug,ug,cg,ur,ur,ub,ur,ur,ub,ub,ur,ux,ub
ux,ux,ug,ug,ug,ur,ug,ug,ug,ur,cr,cr,ur,ur,ur,ub,ub,ur,cr,ub,ur,ux,ub
ux,ux,ux,cg,ug,ug,ur,ug,ug,ug,ur,ur,ur,ur,ur,ub,ur,ub,ug,ug,ux,ux,ub
ux,ux,ux,ux,ux,ug,ur,ug,ug,ur,ug,ug,cr,ug,ur,cr,ub,ub,ug,ux,ux,ux,ub
ux,ux,ux,ux,ux,ug,ur,ug,ug,ug,ug,ug,ub,ug,ug,ub,ub,ub,ub,ux,ux,ux,ub
ux,ux,ur,ur,ur,ug,ug,ug,ug,ug,ug,ug,ug,ug,ug,ug,ug,ub,ub,ub,ux,ux,ub
ux,ux,ur,ux,ux,ug,ux,ux,ux,ux,ux,ux,ux,ub,cb,ub,ub,ub,ub,ub,ux,ux,ub
ux,ux,ur,ux,ux,ug,ux,ux,ux,ub,cb,ub,ux,ub,ug,ub,ub,cb,ub,ub,ux,ux,ub
ux,ur,ur,ux,ux,ug,ug,ux,cr,ub,ub,ub,ug,ug,ug,ug,ug,ub,ub,ub,ub,ub,ub
ux,ux,ux,ux,ux,ug,ug,ub,ur,ub,ub,ub,ub,ug,ug,ug,ug,ug,ux,ux,ub,ub,ub
ux,ux,ux,ux,ux,ug,ux,ub,ur,ub,ub,ub,ub,ub,ug,ub,ug,ug,ux,ux,ub,ub,ub
ux,ux,ux,ux,ux,ug,ux,ub,ur,ub,ub,ub,ub,ub,ug,ub,ux,ug,ug,ug,ug,ub,ub
cg,ux,ux,ux,ux,ug,ug,ub,ur,ub,ug,ug,ug,ug,ug,ug,ug,ug,ug,ux,ug,ug,ub
ub,ub,ub,ub,ux,ug,ux,ux,ur,ug,ug,ug,ug,ug,ug,ug,ug,ug,ug,ug,ug,ug,ub
ub,ux,ux,ux,ux,ug,ux,ux,ur,ux,ug,ug,ug,ug,ug,ug,ug,ug,ug,ug,ub,ur,ub
ub,ub,ub,ub,ub,ub,ub,ub,ur,ub,ub,ub,ub,ub,ub,ug,ug,ug,ug,ug,ub,ur,ub
ub,ub,ub,ub,ub,ub,ub,ux,ur,ux,ux,ux,ux,ux,ux,ux,ux,ux,ux,cg,ur,ur,ub
ub,cb,ux,ub,ub,ub,ub,ub,ur,ub,ub,ub,ub,ub,ub,ub,ub,ub,ub,ub,ub,ur,ub
ub,ub,ub,ub,ub,ub,ub,ub,ur,ub,ub,ub,ub,ub,ub,ub,ub,ub,ub,ur,ub,ub,ub
cr,ux,ux,ux,ux,ub,ub,ux,ur,ub,ub,ub,ub,ub,ub,ub,ub,ub,ur,ur,ub,ub,cb
cg,ux,ux,ux,ux,ub,ub,ur,ur,cg,cb,ub,ub,ub,ub,ub,ub,ub,ur,ur,ub,ub,ur