ur,ub,ub,ub,ur,ur,ur,ur,ur,ur,ur,ur,cb,ub,ub,ur,ur,cb,ur,ur,ur,ub,ub
ub,ub,cr,ub,ur,ur,ur,ur,ur,ur,ur,ur,ur,ur,ub,ur,ur,ur,ur,ur,ub,ub,ub
cb,ur,cr,ur,ur,ur,ur,ur,ur,ur,ur,ur,ur,ur,ub,ur,ur,ur,ur,ur,ub,ur,ub
ur,ur,cr,ub,ur,ur,ur,ur,ur,ur,ur,ur,ur,ur,ub,ur,ug,ub,ub,ur,ub,ub,ub
ub,ub,ur,ur,ur,ur,ur,ur,cg,ur,ur,ur,ur,ur,cr,ug,ug,ub,ub,ur,ur,ub,ur
ur,ub,ur,ur,ux,ur,ur,ur,ug,ur,ur,ur,ur,ug,ub,ub,ug,ub,ub,ur,ur,ub,ub
ur,ub,ub,ub,ub,ug,ug,ur,ug,cr,ur,ur,ub,ug,ub,ub,ux,ub,ub,ub,ub,ub,ub
ur,ub,ub,ub,ub,ug,ur,ug,cg,ub,ub,ur,ug,ug,ug,ub,ub,ub,ub,ub,ux,ux,ux
ur,ur,ur,ur,ub,ur,ub,ug,ub,ub,ub,ug,ug,ug,ug,ug,ux,ug,ux,ux,ux,ux,ux
ux,ux,ux,ub,ub,ub,ub,cb,ub,ux,ug,ub,ug,ug,ug,ug,ux,ug,ux,ux,ux,ux,ux
ux,ux,ug,ug,ug,ug,ug,ug,ub,ux,ug,ug,ub,ub,ub,ub,ub,ub,ub,ux,ux,ux,ux
ux,ux,ug,ux,ux,ux,ux,ug,ux,ux,ub,ub,ub,ub,cb,ub,ub,ug,ux,ux,ux,ux,ux
ux,ux,ug,ux,ux,ux,ux,ug,ux,ux,ux,ub,ug,ub,ub,ub,ug,ug,ux,ux,ur,ur,cg
ur,ur,ug,ug,ug,ug,ug,ug,ug,ug,ug,ub,ug,ug,ug,ug,ug,ug,ur,ur,ur,ur,ur
ur,ux,ux,ux,ux,ux,ux,ug,ub,ug,ug,ug,ub,ub,ug,ub,ux,ux,ug,ux,ux,ur,ur
ur,ux,ux,ux,ux,ux,ux,ug,ub,cg,ub,ug,ub,ub,ug,ub,ux,ub,ug,ug,ux,ur,ur
ur,ur,ur,ur,ug,ug,ug,ug,ug,ur,ur,ug,ug,ug,ug,ug,ug,ug,ug,ug,ug,cg,ur
cg,ur,ur,ur,ur,ur,ur,ur,ur,ur,ug,ug,ug,ur,ur,ur,ur,ur,ur,ur,ur,ur,ur
ux,ur,ub,ug,ug,ug,ug,ug,ug,ug,ug,ub,ug,ux,ux,ub,ug,ug,ug,ug,ur,ur,ur
ux,ur,ub,ug,ug,ug,ug,ux,ux,ug,ug,ux,ug,ux,ux,ux,ux,ux,ux,ux,ux,ur,ur
ux,cr,cb,ub,ux,ux,ug,ux,ux,ux,ux,ug,ug,ug,ug,ug,ux,ux,ux,ux,ux,ur,ur
cr,ub,ub,ub,ux,ux,ug,ux,ux,ux,ux,ug,ug,ug,ug,ug,ug,ug,ux,ux,ux,cb,cr
cg,ux,ub,ub,ux,ux,ug,ug,ug,ug,ug,ug,ug,cb,ug,ug,ug,ug,ux,cg,cb,ux,cr