ur,ur,ur,ur,ur,ur,ur,ur,ux,ux,ux,ux,ux,ux,ux,ux,ux,ux,ux,ux,ux,ux,ux
ur,ux,ux,cr,ur,ur,ur,ur,ux,ur,ur,ur,ur,ur,ur,ur,ux,ur,ur,ur,ux,ux,ux
ur,ux,ux,ux,ux,ur,ur,ur,ur,ur,ux,ur,ur,ux,ux,ur,ur,ur,ur,ur,ux,ux,ux
ur,ur,ur,ur,ur,ur,ux,ur,ur,ur,ur,ur,ur,ur,ur,ur,ur,ur,ur,ur,ux,ux,ux
ur,ur,ur,ur,ur,ur,ur,ur,ur,ur,cr,ur,ur,ur,ur,ur,ur,ug,ur,ur,ux,ux,ux
ux,ux,ur,ur,ur,ur,ur,ur,ur,ur,ur,ub,ub,ub,ub,ub,ub,cb,ur,ur,ux,ux,ux
ur,ur,ur,ux,ur,ur,ur,ur,ur,ur,ur,ur,cg,ug,ug,ug,ur,ur,ur,ur,ur,ur,ur
ur,ur,ux,ur,ur,ur,ur,ur,ur,ur,ur,ur,cr,ub,cb,ug,ur,ur,ur,ur,ur,ux,ur
cg,ur,ux,ur,ur,ur,ur,ur,ur,ur,ur,ur,ur,ur,ur,ub,ur,ur,ur,ur,ur,ur,ur
ur,ur,ux,ur,ur,ur,ub,ub,ub,ub,ur,ug,cr,ur,cb,ub,ub,ur,ur,ur,ur,ur,ur
ur,ub,ur,ur,ur,ur,ub,ub,ub,ub,ur,ug,ub,ub,ub,cb,ub,ur,ur,ur,ur,cb,ub
ur,ub,ur,ur,ur,ur,ub,ub,ub,ub,ub,ub,ub,ub,ub,ub,ub,cr,ur,ur,ur,ur,ub
ur,ur,ur,ur,ur,ub,ub,ub,ub,ub,ub,ub,ub,ux,ub,ub,ub,ub,ux,ux,ux,ur,ub
ur,ur,ur,ur,ur,ur,ux,ub,ub,ub,ug,ub,ub,ub,ub,ub,ub,ub,ub,ux,ux,cr,ub
cg,ub,ux,ux,ux,ug,ug,ug,ug,ug,ub,ub,ug,ug,ug,ub,ub,ub,ub,ux,ux,ub,ub
ub,ub,ux,ux,ux,ug,ux,ux,ub,ub,ug,ug,ug,ug,ug,ug,ug,ug,ux,ub,ux,ux,ub
ub,ub,ux,ux,ux,ug,ux,ux,ux,ux,ug,ub,ub,ub,ug,ug,ug,ug,ub,ub,ux,ux,ub
ub,ub,ub,ub,ub,ug,ug,ug,ug,ug,ug,ub,ub,ub,ug,cg,ub,ub,ub,ug,ug,ug,ub
ub,ug,ug,ug,ub,ub,ub,ub,ub,ub,ub,ux,cb,ub,ub,ub,ub,ub,ub,ux,ux,ux,ub
ub,ug,ub,ug,ub,ub,ub,ub,ub,ub,ub,ux,ur,ux,ur,ug,ux,ub,ug,ug,ux,ux,ub
ub,ug,ub,ug,ug,ug,ug,ug,ug,ug,ug,ug,ug,ug,ug,ug,ug,ub,ug,ug,ux,ux,ub
ub,ug,ug,ug,ub,ub,ub,ug,ug,ug,ug,ug,ug,ug,ur,ug,ux,ub,ux,ux,cg,ux,ub
ub,ub,ub,ug,ug,ug,ug,ug,ub,cg,ub,ub,ur,ug,ug,ug,ug,ug,ug,ug,ug,ub,ub