cb,cb,cb,cr,ur,ur,ur,ur,ur,ur,ur,ur,ur,ur,ur,ur,ur,ur,ur,ur,ur,ur,cb
ur,ur,ur,ur,ur,ur,ur,ur,ur,ur,ur,ur,ur,ur,ur,ub,ub,ub,ur,ur,ub,ur,ub
ur,ur,ur,ur,ur,ur,ur,ur,ur,ur,ug,ur,ur,ur,ur,ub,cr,ur,ur,ur,ur,ur,ub
ur,ur,ur,ur,ur,ur,ur,ur,ur,cr,ur,cr,ug,ur,ub,ub,ug,ub,ub,ub,ub,ub,ub
ur,ur,ur,ur,ug,ug,ug,ur,ug,ug,ux,ur,ur,ur,ub,ub,ux,ub,ub,ub,ub,ub,ub
ur,ur,ur,ub,cr,cr,ur,ur,ur,ug,ug,ug,ug,ug,ub,ub,ux,ug,ug,ub,ub,ub,ub
ur,ur,ur,ur,ur,ug,ur,ur,ur,ug,ug,ug,ug,ub,ub,ub,ux,ug,ug,ub,ub,ub,ub
cb,ub,cg,ug,ug,ug,ug,ug,ur,ug,ug,ux,ux,ub,ux,ub,ux,ub,ug,ub,ub,ub,ub
ux,ub,ur,ug,ug,ug,ug,ug,ub,ub,ug,ug,ug,ub,ux,ub,ug,ub,ug,ub,ux,ux,ug
ub,ub,ub,ub,ub,ux,ug,ug,ub,ub,ub,ux,ux,ub,ug,ub,ug,ub,ug,ub,ub,ub,ub
ub,ub,ub,ub,ub,ug,ug,ug,cb,ug,cg,ub,ux,ub,ug,ub,ug,ub,ug,ub,ub,ub,ub
ub,ub,ub,ug,cb,ug,cb,ub,ub,ub,ub,ug,cg,ug,ug,cb,ug,ug,ug,ug,ux,ux,ug
cb,ub,ub,ug,ux,ug,ub,ub,ub,ub,ub,ub,ug,ug,ub,ug,ub,ub,ub,ub,ub,ub,ub
ug,ug,ug,ug,ug,ug,ub,ub,ub,ug,ug,ub,ug,ub,ug,ug,ug,ub,ub,ub,ub,ub,ub
ug,ug,ug,ug,ug,cg,ub,ub,ub,ux,ug,ux,ub,ub,cb,ub,ub,ub,ug,ug,ug,ux,ug
ug,ug,ug,ug,ug,ug,ug,ug,ux,ux,ug,ug,ux,ub,ub,ub,ux,ug,ug,ux,ux,ux,ug
ug,ug,ug,ug,ug,ug,ub,ug,ux,ux,ux,ug,ug,ub,ux,ux,ux,ug,ug,ug,ux,ux,ug
cr,ur,ug,ug,ug,ug,ug,ug,ub,ur,ur,ug,ug,ub,ub,cb,ug,ug,ug,ug,ur,ur,ur
cg,ur,ug,ug,ug,ug,ug,ug,ub,ux,ux,ug,ug,ug,ug,ug,ug,ug,ug,ug,ux,ur,ur
cb,ur,ur,ur,ur,ur,ur,ur,ur,ur,ur,ur,ur,ur,ur,cg,ug,ug,ug,ug,ur,ur,ur
ux,ur,ur,ur,ur,ur,ur,cr,ug,ur,ur,ur,ur,ur,ur,ur,ur,ur,ur,ur,ur,ur,cr
cr,ur,ux,ug,ug,ug,ux,ux,ux,ux,ux,ux,ux,ux,ux,ux,ux,cb,cg,ux,cb,ur,cr
cg,ur,cg,cb,ug,ug,ux,ux,ux,ux,ux,ux,ux,ux,ux,cg,ux,ux,ux,cg,cg,ur,cr