ur,ur,ur,ur,ur,ur,cr,ub,ur,ur,ub,ub,cb,ur,ur,ur,ur,ur,ur,ur,ur,ur,ur
ur,ur,ur,ur,ur,ur,ur,ub,ur,ur,ub,ub,ub,ur,ur,ur,ur,ur,ur,ur,ur,ur,ur
ur,ur,ur,ur,ur,ur,ur,cb,ur,ur,ur,ub,ub,ur,ur,ur,ur,ur,ur,ur,ur,ur,ur
ur,ur,ur,ur,ur,ur,ur,ur,ur,ur,ur,ub,ub,ur,ur,ur,ur,ur,ur,ur,ur,ur,cb
ur,ur,cr,ur,ur,ur,ur,ur,ur,ur,ur,ur,ub,cg,ub,ux,ur,ur,ur,ur,ur,ur,ur
ur,ur,ur,ur,ur,ur,ur,ur,ur,ur,ur,ur,ur,ug,ug,ug,ub,ub,ub,ub,ur,ur,ur
ur,ur,ur,ur,ur,ur,ur,ur,ur,ur,ur,ur,ur,ug,ug,cr,ub,ub,ur,ur,ur,ur,ur
ur,ur,ur,ur,ur,ur,ur,ur,ur,ur,ur,ug,ug,ug,ug,ur,ur,ur,ur,ur,ur,ur,ur
cg,cr,ur,ur,ur,ur,ur,ur,ur,ur,ur,ur,ur,ur,ug,ur,ur,ur,ur,ur,ur,ur,ur
ub,ub,ub,ub,cr,ur,ur,ur,ur,ur,ug,ub,ub,ub,ug,ur,ur,ur,ur,ur,ur,ur,ur
ub,ux,ux,ux,ug,ug,ug,ug,ug,ug,ub,ub,ub,ub,ug,ug,ug,ux,ub,ur,ur,ur,ur
ub,ux,ux,ux,ug,ug,ug,ug,ug,ug,ug,cg,ub,ub,ub,ub,ub,ux,ux,ux,ur,ur,ur
ub,ux,ux,ux,ux,ux,ux,ux,ub,ub,ub,ub,ub,ub,ub,ub,cb,ux,ux,ux,ug,ux,ux
ub,ub,ub,ub,ub,ub,ub,ub,ub,ub,ub,ub,ub,ub,ub,ub,ub,ub,ub,ub,ub,ub,ub
cg,ux,ux,ux,ux,ux,ux,ux,ub,ub,ub,ub,cb,ux,ux,ub,ux,ux,ux,ug,ug,ux,ub
ug,ug,ug,ug,ug,ug,ug,ug,ug,ub,ub,ub,ub,ub,ug,ub,ug,ug,ug,ug,ux,ux,ub
ug,ux,ux,ux,cg,ug,ug,ug,ug,ug,ux,ux,ub,ub,ub,ub,ux,ux,ux,ux,ux,ux,ub
ug,ux,ux,ux,ux,ux,ux,ux,ug,ug,ux,ux,ub,ub,ub,ub,ux,ux,ux,ux,ux,ux,ub
ug,ux,ux,ux,ux,ux,ux,ux,ug,ug,ux,ux,ux,ux,ub,ub,ux,ux,ux,ux,ux,ux,ub
ug,ux,ux,ux,ux,ux,ux,ux,ug,ux,ux,ux,ux,ux,ux,ux,ux,ux,ux,ux,ux,ux,ub
ug,ub,ub,ub,ub,ub,ub,ub,ug,ub,ub,ub,ub,ub,ub,ub,ub,ub,ub,cr,ur,cb,ub
ug,ux,ux,ux,ux,ux,ux,ux,ug,ux,ux,ux,ux,ux,ux,ux,ux,ux,ux,ux,ux,ux,cb
ug,ug,ug,ug,ug,ug,ug,ug,ug,cg,ux,ux,ux,ux,ux,ux,ux,ux,ux,ux,ux,ux,ux