ug,ug,ug,ug,cg,ur,ur,ur,ur,ur,ur,ur,ur,ur,ur,ur,ur,ur,cb,ub,ux,ux,ux
ug,ur,ur,ur,ur,ur,ur,ur,ur,ur,ur,ur,ur,ur,ur,ur,ur,cr,ub,ub,ux,ux,ux
ug,ug,ug,cr,ur,ur,ur,ur,ur,ur,ur,ur,ur,ur,ur,ur,ur,ur,ux,ub,ux,ux,ux
ur,ur,ur,ur,ur,ur,ur,ur,ur,ur,ur,ur,ur,ur,ur,ur,ur,ur,ux,ub,ub,ux,ux
ur,ur,ur,ur,ur,ur,ur,ur,ur,ur,ur,ur,ur,ur,ur,ur,ur,ur,ux,ub,ub,ub,ub
ur,ur,ur,ur,ur,ur,ur,ur,ur,ur,ur,ur,ur,ur,ur,ur,cg,ur,ur,ur,ur,ur,ub
ur,ur,ur,ur,ug,ug,ur,ur,ur,ur,ur,ur,ug,ug,ug,ug,ug,ur,ux,ux,ur,ur,ux
ur,ur,ur,ur,ug,ug,ur,ur,ur,ur,ub,cb,cr,ug,ug,ug,ug,ur,ur,ux,ux,ux,cb
cg,ur,ur,ur,ur,ur,ur,ur,ur,ur,cr,ur,ur,ug,ug,ug,ug,ur,ur,ux,ux,ux,ux
ur,ur,ur,ur,ug,ug,ur,ur,ur,ur,ub,ub,ug,ug,ug,ug,ur,ur,ur,ux,ux,ux,ux
ur,ur,ur,ur,cg,ug,ur,ur,ur,ur,ub,ub,ub,ub,ux,ux,ux,ux,ur,ur,ux,ux,ux
ur,ur,ur,ur,ur,ug,ur,ub,cr,ur,ub,ub,ub,ub,ug,ug,ug,ug,ux,ur,ux,ux,ux
ur,ur,ur,ur,cr,ug,ux,ub,ub,ur,ug,ub,ub,ub,ug,ug,ug,ug,ux,ur,ux,ux,ux
ux,ux,ub,ux,ux,ug,ub,ub,ub,ur,ub,ub,ub,ug,ug,ug,ug,ug,ux,ux,ux,ux,ux
cg,ux,ub,ux,ux,ux,ub,ub,ub,ur,ub,ug,ug,ug,ug,ug,ug,ux,ux,ux,ur,ux,ux
ux,ux,ub,ux,ux,ux,ub,ub,ub,cb,ub,ub,ug,ug,ug,ug,ug,ux,ux,ux,ur,ur,ur
ux,ux,ub,ux,ub,ub,ub,ub,ub,ur,cb,ub,ux,ug,ug,ug,ur,ur,ur,ur,ur,ux,ur
ux,ux,ub,ux,ux,ux,ub,ub,ub,ub,ub,ub,ux,ug,ug,ug,ux,ux,ux,ux,ur,ux,ur
ux,ux,ub,ux,ux,ux,ub,ub,ux,ub,ux,ub,ub,ub,ub,ur,ux,ux,ux,ux,ur,ux,ur
ux,ux,ub,ux,ux,ux,ux,ub,ub,ur,ux,ux,ux,ux,ux,ur,ux,ux,ux,ux,ur,ux,ur
ur,ur,cb,ur,ur,ur,ur,ur,ur,ur,ur,ur,ur,ur,ur,ur,ux,ux,ux,ux,ur,ux,ur
ur,ux,ux,ux,ux,ux,ux,ux,ur,ux,ux,ux,ux,ux,ux,ur,ur,ur,ur,ur,ur,ux,ur
ur,ur,ur,ur,ur,ur,ur,ur,ur,cg,ux,ux,ux,ux,ux,ur,ur,ur,ur,ur,ur,ur,ur