ur,ur,ur,ur,ur,ur,ur,ur,ur,ur,ur,ur,ur,ur,ur,ur,ur,ur,ur,ur,cr,ub,ub
ur,ur,ur,ur,ur,ur,ur,ur,ur,ur,ur,ur,ur,ur,ur,ur,ur,ur,ur,ur,ur,ur,cb
ur,ur,ur,ur,ur,ur,ur,ur,ur,ur,ur,ur,ur,ur,ur,ur,ur,ur,ur,cb,ur,ur,ur
ur,cb,ur,ur,ur,ur,ur,ur,ur,ur,ur,ux,cr,ux,ux,ur,ur,ur,ur,ub,ur,ur,ub
ur,ub,cr,ur,ur,ur,ur,ur,ur,ur,ur,ur,ur,ux,ux,ur,ur,ur,ur,cr,ub,ub,ub
ur,ur,ur,ur,ur,ur,cg,ug,ur,ur,ur,ur,ur,ug,ug,ug,cr,ub,ub,ub,ub,ub,ub
ur,ur,ur,ug,ug,ug,ug,ug,ux,ur,ur,ur,ur,ug,ur,ur,ug,ur,ur,ur,ur,ur,ur
ur,ur,ur,ug,ur,ur,ur,ur,ux,ug,ur,ur,cg,ug,ug,ug,ug,ug,ug,ug,ug,ug,ug
ur,ub,ur,ug,ux,ug,ur,ur,ur,ug,ur,ur,ub,ub,ug,ug,ug,ug,ux,ux,ux,ux,ug
ur,ub,ur,ug,ug,ug,ug,ug,ug,ug,ur,ub,ub,ub,ug,ug,ug,ug,ux,ux,ux,ux,ug
ur,ub,ur,ug,ug,ug,ug,ub,ub,ub,ur,cb,ub,ub,ub,ub,ug,ug,ux,ux,ux,ux,ug
ur,ur,ur,ug,ug,ug,ug,ub,ub,ub,ur,ux,ug,ug,ub,ux,ug,ux,ux,ux,ux,ux,ug
ub,ub,ub,ug,ug,ub,ub,ug,cb,ub,ub,ub,ug,ug,ug,ug,ug,ux,ux,ux,ux,ux,ug
ub,ub,ub,ug,ug,ub,ub,ub,ub,ub,ub,ub,ub,ug,ug,ux,ux,ux,ux,ux,ux,ux,ug
ub,ug,ub,ux,ux,ux,ux,ug,ub,ub,ur,ug,ug,ug,ug,ug,ug,ug,ub,ux,ux,ux,ug
ub,ug,ub,ux,ux,ux,ux,ug,ux,ux,ur,ug,ug,ug,ug,ug,ug,ug,ub,ux,ux,ux,ug
ux,ug,ux,ux,ux,ux,ux,ug,ux,ux,ur,ux,ux,ub,ub,ub,ub,ub,ub,ux,ux,ux,ug
ux,ug,ux,ux,ux,ux,ux,ug,ux,ux,ur,ux,ux,ux,ux,ub,ub,ub,ux,ux,ux,ux,ug
ux,ug,ux,ux,ux,ux,ux,ug,ux,ux,ur,ur,ur,ur,ur,ur,ur,cr,ux,ux,ux,ux,ug
ux,ug,ug,ug,ug,ug,ug,ug,ug,ur,ur,ur,ur,ur,ur,ur,ur,ur,ur,ux,ux,ux,ug
ux,ur,ux,ux,ux,ux,ux,ug,ux,ur,ur,ug,ux,ux,ux,ux,ux,ux,ur,ux,ux,ux,ug
ux,ur,ur,ur,ur,ur,ur,ug,ur,ur,ur,ug,cg,ug,ug,ug,ug,ug,ug,ug,ug,ug,ug
ux,ux,ux,ux,ux,ux,ux,cg,ur,ur,ur,ug,ug,ug,ug,ux,ux,ux,ux,ux,ux,cb,ug