ur,ur,ur,ux,ur,ur,ur,ur,ur,ur,ur,ur,ur,ur,ur,ur,ur,cb,ur,ur,ur,ur,ur
ur,ux,ux,ux,ur,ur,ur,ur,ur,ur,ur,ur,ur,ur,ur,ur,ur,ur,ur,ur,ur,ur,ur
ur,ux,ux,ux,ux,ur,ur,ur,ur,ux,ur,ur,ur,ur,ur,ur,ur,ur,ur,ur,ur,ur,ur
ur,ur,ur,ur,ur,ur,ur,ur,ur,ur,ur,ur,ur,ur,ur,ur,ur,ur,cg,ur,ur,ur,ur
cb,ur,ur,ur,ur,ur,ur,ur,ur,ur,ur,ur,ur,ur,ur,ur,cr,ug,ug,ur,ur,ux,ux
ur,ur,ur,ur,ur,ur,ur,ur,ur,ur,ur,ur,ur,ur,ur,ur,cg,ur,ur,cr,ux,ux,ux
ur,ur,ur,ug,ur,ur,ur,ur,ur,ur,ur,ur,cr,ur,ur,ur,ug,ur,ur,ux,ux,ux,ux
ur,ur,ur,ur,ur,ur,ur,ur,ur,ur,ur,ur,ur,ug,ug,ug,ug,ug,ug,ux,ux,ux,ux
ur,ur,ur,ur,ur,ur,ug,ur,ur,ug,ur,ur,ur,ur,ux,ux,ug,ug,ux,ux,ux,ux,ux
ur,ur,ur,cr,ug,ug,ug,ug,ug,ub,ub,ub,ub,ub,ub,cb,ux,ux,ux,ux,ux,ux,ux
ur,ur,ur,cr,ur,ug,ug,ug,ub,ub,ub,ub,ub,ug,ug,ug,ux,ub,ub,ux,ux,ux,ux
ub,ub,ur,ur,ur,ug,ur,ug,ub,ub,ub,ub,ub,ug,ub,ug,ug,ug,ug,ug,ug,ux,ux
ub,ub,ur,ub,ub,ur,ug,ug,ug,ug,ub,ub,ub,ug,ub,ub,ub,ub,ub,ub,ug,ux,cg
ub,ub,ub,ub,ub,ub,ub,ub,ug,ug,ug,ug,ug,ug,ub,ub,ub,ug,ub,ub,ub,ug,ux
ub,ub,ub,ub,ub,ub,ub,ub,ug,ug,ub,ub,ub,ug,ub,ux,ub,ub,cb,ub,ub,ug,ux
ub,ub,ub,ub,ub,ub,ub,ub,cg,ug,ug,ub,ub,ug,ug,ug,ug,ug,ub,ug,ug,ug,ug
ub,ub,ub,ub,cb,ub,ub,ub,ub,ug,ug,ub,ub,ub,ub,ub,ux,ug,ug,ug,ux,ug,ug
cg,ub,ub,ub,ub,ub,ub,ub,ub,ub,ub,ux,ux,ux,ux,ub,ub,ub,ub,ub,ug,ug,ug
ub,ub,ub,ub,ug,ug,ub,ub,ub,ub,ub,ub,ub,ub,ub,ub,ub,ub,ub,ug,ug,ub,ug
ub,ub,ub,ub,ub,ub,ub,ub,ub,ub,ub,ub,ub,ug,ug,ug,ug,ug,ug,ug,ub,ug,ug
ub,ub,ur,ur,ur,ur,ur,ur,ur,ur,ur,ur,ur,ur,ur,ur,ur,cg,ug,ug,ug,ug,ur
cr,cb,cr,ub,ub,ub,ub,ub,ug,ug,ug,ug,ug,ub,ub,ub,ub,ub,ux,ux,ux,cb,cr
cg,ux,ug,ug,ug,ug,ug,ug,ug,ux,ux,ux,ux,cb,ux,ux,ub,ub,ux,cg,cb,ux,cr