ur,ur,ur,ur,ur,ur,ur,ur,ur,ur,ur,ur,ur,ur,ur,ur,ur,ur,ug,cb,ub,ur,ur
ub,ub,ub,cb,ur,ur,cr,ur,ux,ur,ur,cg,ur,cr,ur,ur,ur,ur,ug,ur,ub,ub,ur
ub,ub,ub,ub,cr,ur,ur,ur,ur,ub,ur,ug,ug,ur,ug,ug,ug,ug,ug,ub,ur,ub,ur
ub,ub,ug,ug,ub,ux,ub,ub,ur,ur,cr,ur,ur,ur,ur,ub,ur,ur,ur,ub,ur,ub,ur
ub,ub,ur,ug,ub,ub,ub,ub,ub,ub,ur,ur,ux,ub,ur,ur,ur,cb,ur,ub,ub,ub,ur
ux,ur,ub,ub,ub,ug,ug,ub,ub,ub,ub,ug,ur,ur,ur,ur,ur,ub,ug,ur,ur,ur,ur
ux,ur,ub,ub,ub,ug,ur,ub,ub,ub,cb,ub,ur,cr,ur,ur,ug,ub,ur,ur,ug,ur,ur
ux,ur,ux,ub,ub,ug,ug,cg,ub,ub,ub,ub,ur,ur,ug,ug,ub,ub,ur,ur,ur,ur,ur
cg,ur,ur,ur,ur,ur,ur,ug,ub,ub,ub,ur,ur,ub,ub,ub,ub,ug,ub,ux,ub,ub,ur
ux,ux,ux,ux,ux,ub,ub,ug,ug,ug,ub,ur,ur,ub,ub,ub,ug,ub,ub,ub,cb,ub,ur
ux,ux,ux,ux,ux,ub,ub,ub,ub,ug,ug,ug,ub,ub,ux,ub,ug,ub,ub,ub,ub,ub,ur
ux,ux,ux,ub,ub,ub,ub,ug,ub,ub,ug,ug,ub,ub,ub,ux,ug,ub,ub,ub,ub,ub,ur
ux,ux,ux,ub,ub,ub,ub,ug,ug,ug,ug,ub,ub,ub,ub,ub,ug,ub,ub,ub,ub,ub,ur
ux,ux,ux,ux,ub,ub,ug,ug,cb,ub,ug,ug,ub,ub,ub,ug,ug,ug,ub,ub,ub,ub,ur
ux,ux,ux,ux,ux,ub,ug,ug,ub,ub,ub,ug,ug,ug,ug,ug,ug,ug,ub,ub,ub,ub,ur
ux,ux,ux,ux,ux,ub,ub,ux,ub,ub,ug,ug,ug,ug,ug,ug,ug,ug,ub,ub,ub,ub,ur
ux,ux,ux,ux,ux,ub,ub,ub,ub,ux,ug,ug,ug,ug,ug,ug,ug,ug,ub,ub,ub,ub,ur
ux,ux,ux,ux,ux,ub,ub,ub,ub,ux,ug,ug,ug,ug,ug,ug,ug,ug,ub,ub,ub,ub,ur
ux,ux,ux,ux,ux,ub,ug,ub,ug,ug,ug,ug,ug,ux,ug,ug,cg,ub,ub,ub,ub,ub,ur
ux,ux,ux,ux,ux,ub,ux,ux,ux,ux,ux,ux,ux,ux,ub,ub,ub,ub,ub,ub,ux,ux,ur
ux,ux,ux,ux,ux,ub,ux,ux,ux,ux,ux,ux,ux,ux,ux,ux,ux,ux,ux,ub,ub,ub,ur
ux,ux,ux,ub,ux,ub,ub,ub,ub,ub,ub,ub,ub,ub,ub,ub,ub,ub,ub,ub,ub,ub,ur
ux,ux,ux,ub,cr,ur,ur,ur,ur,ur,ur,ur,ur,ur,ur,ur,ur,ur,ur,ur,ur,ur,ur