ur,ur,ur,ur,ur,ub,ub,cr,ur,ur,ur,ur,ur,ur,ur,ur,ur,cb,ur,ur,ur,ur,ur
ur,ur,ur,ur,ur,cb,ur,ur,ur,ur,cr,ur,ur,ur,ur,ur,ur,ur,ur,ur,ur,ur,ur
ur,ur,ur,ur,ur,ur,ux,ur,ur,cg,ug,ur,ur,ur,ur,ur,ur,ur,ur,ur,ur,ur,ur
ur,cr,ur,ur,ur,ur,ub,ub,ur,ur,ub,ub,ur,ur,ur,ur,ur,ur,ur,ur,ur,ur,ur
ub,ub,ur,ur,ur,ur,ur,ur,ub,ub,ub,ub,ub,ux,ux,ur,cb,ub,ur,ur,ur,ur,ur
ub,cb,ur,ur,ur,ur,ug,ug,ug,ub,ug,ug,ub,ub,ub,ur,ur,cr,ur,ur,ur,ur,ur
ur,ur,ur,ur,ur,ur,ug,ux,ub,ub,ub,ub,ub,ug,ug,ug,ug,ug,ug,ug,ux,cr,ur
ub,ub,ur,ur,ug,ug,ug,ub,ub,ub,ux,ub,ub,cb,ux,ur,ux,ug,ug,ug,ux,ux,ug
ur,ur,ur,ub,ug,ug,ug,ug,ug,ug,ug,cg,ug,ux,ux,ur,ux,ug,ug,ug,ux,ux,ug
ur,ur,ur,ub,ug,ug,ug,ug,ug,ug,ug,ug,ug,ux,ux,ur,ux,ug,ug,ug,ux,ux,ug
ux,ux,ux,ux,ug,ux,ub,ug,ug,ug,ug,ug,ug,ux,ux,ur,ux,ug,ug,ug,ux,ux,ug
ur,ur,ur,ur,ug,ug,ug,ug,ug,ug,ur,ub,ur,ug,ug,ug,ug,ur,ur,ug,ur,ug,ug
ur,ug,ug,ub,ub,ug,ug,ub,ub,ug,ug,ug,ug,ug,ux,ug,ug,ug,ug,ug,ux,ug,cg
ur,ux,ux,ug,ub,ug,ug,ub,ub,ub,ux,ub,ux,ux,ug,ug,ug,ug,ug,ug,ux,ug,ur
ur,ux,ux,ug,ux,ux,ug,ub,ug,cg,ux,ub,ux,ux,ug,ug,ub,ug,ug,ug,ur,ug,ur
ur,ux,ux,ug,ux,ux,ug,ug,ug,ub,ux,ub,ux,ux,ug,ug,ub,ug,ug,ug,ux,ug,ur
ur,ur,ur,ur,ur,cb,ub,ub,ub,ur,ur,ur,ur,ur,ur,cr,ub,ug,ug,ug,ux,ug,ur
cg,ux,ux,ug,ux,ux,ub,ub,ub,ub,ug,ub,ug,ug,ug,ug,ub,ug,ug,ug,ux,ug,ur
ux,ux,ux,ug,ux,ux,ux,ux,ug,ub,ug,ub,ub,ub,ux,ur,ub,ux,ux,ug,ux,ug,ux
ux,ux,ux,ug,ux,ux,ux,ux,ux,ub,ug,ub,ub,ub,ub,ub,ub,ux,ux,ug,ug,ug,ux
ux,ux,ux,ug,ux,ux,ux,ux,ux,ub,ug,ub,ub,ub,ub,ux,ux,cg,ug,ug,ug,ux,ux
cr,ux,ux,ug,ug,ug,ug,ug,ug,ub,ub,ub,ub,ub,ug,ug,ug,ug,ug,ug,ux,cb,cr
cg,ux,ux,ux,ux,ux,ux,ux,ux,ux,ux,ub,ub,cb,ux,ux,ux,ux,ux,cg,cb,ux,cr