ur,ur,ur,ur,ur,ur,ur,ur,ur,ur,ur,ur,ux,ux,ux,ux,ux,ux,ux,ux,ux,ux,ux
ur,ur,ur,ur,ur,ur,ur,ur,ux,ux,ux,ur,ur,ur,ux,ux,ux,ux,ux,ux,ux,ux,ux
ur,ur,ur,ur,ur,ur,ur,ur,ur,ur,ur,ur,ur,ur,ur,ur,ur,ur,ur,ur,ur,ur,ur
ur,ur,ur,ur,ur,ur,ur,ur,ur,ur,ur,ur,ur,ur,ux,ux,ux,ux,ux,ur,ur,ur,cb
ur,ur,ur,ur,ur,ur,ur,ur,ur,ur,ur,ur,ub,ur,ub,ur,ux,ux,ur,ur,ur,ur,ur
ur,ur,ur,ur,ug,cg,ug,cr,cb,ug,ug,ug,ug,ug,ug,ur,ur,ur,ur,ur,ur,ur,ur
ur,ur,ur,ur,ur,ug,ug,ug,ub,ug,ug,ug,ug,ug,ug,ub,ur,ub,ur,ur,ur,ur,ur
ur,cr,ur,ur,ur,ur,ur,ur,ub,cg,ur,ug,ug,ug,ug,ur,ur,ub,ur,ur,ur,ur,ur
cg,cr,ur,ux,ux,ux,ur,ur,ur,ub,ur,ub,ub,ub,ub,ub,ub,ur,ur,ur,ur,ur,ur
ux,ux,ux,ux,ux,ur,ur,ur,ur,ub,ub,ub,ub,ub,ub,ub,ub,ur,ur,ur,ur,ur,ur
ux,ux,ux,ur,ub,ub,ur,ur,ur,ur,ur,ub,ub,ub,ub,ux,ub,ub,cb,ur,ur,ur,ur
ur,ur,ur,ub,ub,ur,ub,ur,ur,ur,ub,ux,ub,ub,ub,ux,ug,ug,ur,ur,ur,ur,ur
ur,ur,ur,ur,ub,ub,ub,cb,ub,ub,ub,ux,ub,ub,ub,ux,ug,ux,ur,ur,ur,ur,ur
ux,ux,ux,ux,ux,ub,ux,ub,cb,ub,ub,ub,ub,ub,ub,ub,ug,ux,ur,ur,ur,ur,ur
cg,ux,ux,ux,ux,ux,ux,ux,ub,ux,ub,ub,ub,ub,ub,ub,ug,ux,ur,ur,ur,ur,ur
ux,ux,ux,ux,ux,ux,ux,ux,ub,ux,ub,ub,ub,ub,ub,ub,ug,ux,ur,ur,ur,ur,ur
ux,ux,ux,ux,ux,ux,ux,ux,ub,ub,ub,ub,ub,ub,ux,ub,ug,ux,ur,cr,ur,ur,cr
ux,ux,ux,ux,ux,ux,ux,ux,ub,ub,ub,ub,ub,ux,ux,ub,ug,ux,ur,ug,ub,ux,ug
ux,ux,ux,ux,ux,ux,ux,ux,ub,ub,ux,ux,ux,ux,ux,ub,ug,ux,ur,ug,ub,ux,ug
ub,cb,ug,ug,ug,ug,ug,ug,ug,ub,ug,ug,ug,ug,ug,ub,ug,ub,ur,ug,ub,ug,ug
ub,ub,ub,ub,ub,ub,ub,ub,ub,ub,ub,ub,ub,ub,ub,ub,ug,ub,ur,ug,ub,ux,ux
ub,ub,ub,ub,ub,ub,ub,ub,ub,ub,ub,ub,ub,ub,ug,ug,ug,ub,cr,ug,ub,ux,cb
ur,ub,ub,ub,ub,ub,ub,ub,ub,cg,ub,ub,ub,ub,ub,ub,ub,ub,cg,ug,ub,ux,ux