ur,ur,ur,ur,ur,ur,ur,ur,ur,ur,ur,ur,ur,ur,ur,ur,ur,cb,ur,ur,ub,ub,ub
ub,cr,cr,cb,ur,ur,ur,ur,ur,ur,ur,ur,ur,ur,ur,ur,ur,ur,cb,ub,ub,ux,ub
ub,ub,ub,ub,ur,ur,ur,ur,ur,ur,ur,ur,ur,ur,ur,ur,ur,ur,ur,ur,ur,ur,ub
ur,ur,ur,ur,ur,ur,ur,ur,ur,ur,ur,ur,ur,ur,ur,ur,ur,ur,ur,ur,ur,ur,ub
cb,ur,ur,ur,ur,ur,ur,ur,ur,ur,ur,ur,ur,ur,cr,ug,ug,ug,ur,ur,ur,ur,ub
ur,ur,cr,ub,ub,ub,cb,ur,ur,ur,ur,ub,ub,ub,ux,ub,cg,ug,ur,ur,ur,ur,ub
ur,ur,ub,ub,ug,cg,ug,ub,ur,ur,ug,ub,ub,ub,ub,ub,cr,ur,ur,ur,ur,ur,ub
ur,ur,ub,ub,ub,ub,ug,ug,ug,ug,ub,ub,ub,ux,ug,ub,cr,ur,ur,ur,ur,ur,ub
ug,ug,ug,ug,ug,ub,ub,ub,ug,ub,cb,ug,ub,ug,ug,ub,ug,ur,ur,ur,ur,ur,ub
ug,ug,ug,ug,ug,ub,ub,ub,ug,ub,ug,ur,ub,ug,ug,ub,ub,ub,ub,ub,ub,ub,ub
ug,ug,ug,ug,ug,ub,ub,ub,ub,ug,ug,ug,ub,ux,ux,ux,ux,ux,ux,ux,ux,ur,ur
ug,ux,ux,ug,ug,ug,ug,ug,ug,ug,ug,ug,ug,ug,ug,ug,cg,ux,ux,ux,ux,ur,ur
ug,ux,ux,ux,ug,ub,ub,ug,ub,ub,ub,ub,ug,ug,ug,ug,ug,ug,ux,ux,ux,ur,cg
ug,ug,ug,ug,ug,ub,ub,ux,ug,ug,ug,ug,ug,ug,ug,ug,ug,ug,ux,ur,ur,ur,ub
ur,ur,ur,ur,ur,ub,ub,ub,ug,ug,ug,cg,ug,ug,ug,ug,ug,ug,ux,ur,ur,ur,ur
ux,ux,ux,ux,ub,ub,ux,ub,ub,ug,ug,ug,ug,ug,ug,ug,ug,ug,ux,ur,ur,ur,ur
ux,ux,ux,ux,ub,ub,ub,ub,ub,ug,ug,ug,ug,ug,ug,ug,ug,ug,ux,ur,ur,ur,ur
cg,ux,ux,ux,ux,ux,ub,ub,ux,ug,ug,ug,ug,ug,ug,ug,ug,ug,ux,ur,ur,ur,ur
ux,ux,ux,ux,ux,ux,ub,ub,ux,ug,ug,ux,ux,ux,ux,ux,ux,ux,ux,ur,ur,ur,ur
ux,ux,ux,ux,ux,ux,ux,ux,ux,ux,ux,ux,ux,ux,ux,ux,ux,ux,ux,ur,ur,ur,ur
ux,ux,ux,ux,ux,ux,ux,ux,ux,ux,ub,ub,ub,ub,ub,ub,ub,ub,ub,ur,ur,ur,ur
cr,ux,ux,ux,ux,ux,ux,ux,ux,ux,ub,ub,ux,ux,ux,ux,ux,ux,ux,ur,ur,cb,cr
cg,ux,ux,ux,ux,ux,ux,ux,ux,ux,ub,ub,ux,cb,ux,ux,ux,ux,ux,cg,cb,ux,cr