ur,ur,ub,cb,ur,ur,ur,ur,ur,ur,ur,ur,ur,ur,ur,ur,ur,cb,ur,ur,ur,ur,ur
ur,ur,cr,ur,ur,ur,ur,cg,ur,ur,ur,ur,ur,ur,ur,ur,ur,ur,ur,ur,ur,ur,ur
ur,ur,ur,ur,ur,ur,ur,ug,ur,ur,ux,ux,ur,ur,ur,cb,ur,ur,ur,ur,cg,cr,ug
ur,ur,ur,ur,ur,ur,ur,cr,ur,ur,ur,ux,ux,ur,ur,ub,ub,ub,ub,cr,ug,ug,ur
ur,ur,ur,ur,ur,ur,ur,ur,ur,ur,ur,ur,ur,ur,ur,ur,ux,ub,cb,ug,ub,ub,ug
ur,ur,ur,ur,ur,ur,ur,ur,ux,ur,ur,ur,cr,ug,ur,ur,ur,ub,ub,ub,ub,ub,ur
ur,ur,ur,ur,ur,ur,ur,ur,ur,ur,ur,ur,ur,cg,ur,ur,ur,ub,ub,ub,ur,ub,ur
ur,ur,ur,ur,ur,ur,ur,ur,ur,ur,ur,ur,ur,ur,ur,ur,ur,ur,ug,ux,ug,ub,ur
ur,ur,ug,ur,ub,ub,ub,cb,ux,ub,ux,ux,ux,ux,ug,ug,ug,ug,ug,ux,ux,ub,ur
ux,ur,ug,ur,ub,ub,ug,ug,ug,ug,ux,ux,ux,ug,ug,ug,ux,ux,ug,ux,ux,ub,ur
ur,ur,ug,ur,ur,ub,ub,ub,ug,ug,ub,ub,ub,ub,ux,ug,ug,ug,ug,ux,ux,ub,ur
ur,ur,ug,ur,ur,ub,ub,ub,ug,ub,ub,ub,cb,ub,ug,ug,ug,cg,ux,ux,ux,ub,ur
ur,ur,ug,ug,ur,ub,ux,ub,ub,ub,cb,ub,ub,ub,ug,ug,ug,ub,ux,ux,ux,ub,ur
ur,ur,ug,ug,ur,ux,ux,ux,ug,ub,ub,ub,ub,ub,ug,ug,ug,ub,ub,ux,ux,ub,ur
cg,ur,ur,ur,ur,ux,ux,ux,ug,ub,ub,ub,ub,ub,ug,ug,ug,ux,ux,ux,ux,ub,ur
ub,ug,ub,ub,ub,ub,ub,ub,ug,ug,ub,ub,ub,ug,ug,ug,ug,ub,ub,ub,ub,ub,ur
ub,ug,ux,ux,ux,ux,ux,ux,ug,ug,ug,ub,ub,ug,ug,ug,ug,ug,ug,ux,ub,ub,ur
ub,ug,ux,ux,ux,ux,ux,ux,ug,ux,ub,ub,ub,ug,ug,ug,ug,ug,ug,ub,ub,ub,ur
ux,ug,ux,ux,ux,ux,ux,ux,ug,ux,ux,ub,ub,ub,ub,ub,ub,ug,ug,ux,ux,ub,ur
ux,ug,ux,ux,ux,ux,ux,ux,ug,ux,ux,ux,ur,ux,ux,ux,ux,ug,ug,ux,ux,ub,ur
ux,ug,ux,ux,ux,ux,ux,ux,ug,ux,ux,ux,ur,ub,ub,ub,ub,ub,ux,ux,ub,ub,cr
cr,ug,ux,ux,ux,ux,ux,ux,ug,ux,ux,ux,ux,ub,ux,ux,ux,ux,ux,ux,ub,ux,cb
cg,ug,ug,ug,ug,ug,ug,ug,ug,cg,ux,ux,ux,ub,ub,ub,ub,ub,ub,ub,ub,ur,ur