ur,ur,cb,ur,ur,ur,ur,ur,ur,ur,ur,ur,ur,ur,ur,ur,ur,ur,ur,ur,ur,ur,cg
ur,ur,ur,ug,ug,ug,ug,ug,ug,ug,ug,ur,ur,ur,ur,ur,ur,ur,ur,cr,ur,ur,ug
ur,ur,ur,ur,ur,ur,ur,ur,ur,ur,ug,ug,ur,ur,ur,ur,ur,ur,ur,ur,ub,ur,ug
ur,ur,ur,ur,ur,ur,ur,ur,ur,ur,ur,ur,ur,ur,ur,ug,ur,ub,ur,cr,ub,cb,ug
ur,ur,ur,cr,ur,ur,ur,cg,ug,ug,cr,ur,ur,ur,ux,ux,ur,ur,cr,ub,ub,ug,ug
ur,ur,ur,ux,ur,ub,ux,ug,ux,ux,ux,ux,ur,ur,ug,ug,ug,ug,ug,ug,ug,ur,ug
ur,ur,ur,ur,ur,ub,ux,ug,ux,ux,ux,ux,ux,ug,ug,ug,ug,ug,ux,ux,ug,ur,ug
ux,ux,ur,ur,ub,ub,ug,ug,ux,ux,ux,ug,ug,ug,ug,ug,ug,ug,ux,ux,ux,ur,ug
ux,ux,ur,ub,ub,ub,ub,ug,ug,ux,ux,ug,ux,ug,ug,ug,ug,ug,ug,ug,ug,ur,ug
ux,ux,ur,ub,ub,ub,ub,ug,ug,ug,ug,ug,ug,ug,ug,ug,ug,ug,ux,ug,ug,ur,ux
ux,ux,ur,ub,ub,ub,ub,ug,ug,ub,ug,ug,ug,ug,ug,ux,ug,ug,ux,ug,ug,ur,cb
ux,ux,ur,ub,ub,ub,ug,ug,ub,ub,ub,ug,ug,ug,ug,ug,ug,ug,ux,ug,ug,ur,ur
ux,ux,ur,ub,ub,ug,ug,ug,ug,ub,ub,ub,ug,ug,ug,ug,ug,ug,ux,ug,ug,ug,ur
ux,ux,ur,ug,ug,ug,ub,ug,ug,ub,ub,cb,ub,ub,ub,ub,ug,ug,ux,ug,ug,ug,ur
ux,ux,ub,ug,ub,ug,ub,ug,ug,cg,ub,ub,ub,ub,ub,ub,ug,ug,ub,ug,ug,ug,ur
cg,ux,ub,ug,ub,ug,ux,ux,ux,ug,ub,ub,ub,ub,ub,ug,ug,ug,ub,ug,ug,ug,ur
ux,ug,ub,ug,ug,ug,ub,ub,ub,ug,ug,ug,ug,ub,ub,ug,ub,ug,ug,ug,ug,ug,ur
ux,ug,ub,ug,ub,ug,ub,ur,ur,ur,ur,ur,ur,ur,ur,ur,ur,ur,ur,ur,ur,ur,ur
ug,ug,ub,ub,ub,cg,ub,ub,ub,ub,ub,ub,ub,ug,ug,ug,cr,ur,ur,ur,ur,ur,ur
ug,ug,ug,ug,ub,ub,ub,ug,ux,ub,ub,ub,ub,ug,ug,ug,ug,ug,ug,ur,ug,ug,ur
cr,ug,ug,cg,ub,ub,ub,ug,ux,ux,ux,ub,ux,ug,ux,ux,ux,ux,ur,ur,ur,ur,ur
cg,ug,ug,ug,ub,cb,ub,ug,ux,ux,ub,ub,ux,ug,ux,ux,ux,ux,ur,ur,ur,cb,cr
cr,ux,ur,cb,ub,ub,ub,ug,ug,ug,ug,cb,ub,ug,ur,ur,ur,ur,ur,cg,cb,ux,cr