ur,cb,ur,ur,ur,ur,ur,ur,ur,ur,ub,ub,ub,ub,ur,ur,ur,ur,ur,ur,ur,ur,ur
ur,ub,ub,ur,ur,ur,ur,ur,ur,ur,ub,ub,cr,ub,ub,ub,ur,ur,ur,ur,ur,ur,ur
ur,ur,cr,ur,ur,ur,ur,ur,ur,ur,ur,ub,ur,ub,ub,ub,ur,ur,ur,ur,ur,ur,ur
ur,ur,ur,ur,ur,ur,ur,ur,ur,ur,ur,ub,ur,ur,ur,cb,ur,ur,ur,ur,ur,ur,cb
ur,ur,ur,ur,ur,ur,ur,ur,ur,ur,ur,ur,ur,ur,ur,ur,ur,ur,ur,ur,ur,ur,ur
ur,ur,ur,ur,ur,ur,ur,ur,ur,ur,ur,ur,ug,ug,ug,ur,ub,ub,ub,ub,ur,ur,ur
ur,ur,ur,ur,ur,ur,ur,ur,ur,ug,ug,ug,ug,ug,ug,ur,ub,ub,ur,ur,ur,ur,ur
ur,ur,ur,ur,ur,ur,ur,ur,ur,ug,cg,ug,ug,ug,ug,ur,ur,ur,ur,ur,ur,ur,ur
cg,ur,ur,ur,ur,ur,ur,ur,ur,ur,ur,ur,ur,ur,ug,ur,ur,ur,ur,ur,ur,ur,ur
ur,ur,ur,ur,ur,ur,ur,ur,ur,ur,ug,ub,ub,ub,ug,ur,ur,ur,ur,ur,ur,ur,ur
ur,ur,ur,ur,cr,ug,ug,ug,ug,ug,ub,ub,ub,ub,ug,ug,ug,ux,ux,ur,ur,ur,ur
ur,ur,ur,ur,cr,ug,ug,ug,ug,ug,ug,ug,ug,ub,ub,ub,ub,ub,ub,ux,ur,ur,ur
ur,ur,cr,ux,ux,ux,ux,ux,cg,ug,ug,ug,ug,ub,ub,ub,cb,ub,ub,ux,ug,ux,ux
ub,ub,ub,ub,ub,ub,ub,ub,ub,cb,ub,ub,ub,ub,ub,ub,ub,ub,ub,ub,ub,ub,ub
cg,ux,ux,ux,ux,ux,ux,ux,ub,ub,ub,ub,ub,ub,ux,ub,ux,ux,ux,ug,ug,ux,ub
ug,ug,ug,ug,ug,ug,ug,ug,ug,ub,ub,ub,ub,ub,ug,ub,ug,ug,ug,ug,ux,ux,ub
ug,ux,ux,ug,ug,ug,ug,ug,ug,ug,ux,ux,ub,ub,ub,ub,ux,ux,ux,ux,ux,ux,ub
ug,ux,ux,ug,ux,ux,ux,ux,ug,ux,ux,ux,ub,ub,ub,ub,ux,ux,ux,ux,ux,ux,ub
ug,ux,ux,ug,ux,ux,ux,ux,ug,ux,ux,ux,ux,ux,ub,ub,ux,ux,ux,ux,ux,ux,ub
ug,ux,ux,ug,ux,ux,ux,ux,ug,ux,ux,ux,ux,ux,ux,ux,ux,ux,ux,ux,ux,ux,ub
ug,ub,ub,ug,ub,ub,ub,ub,ug,ub,ub,cr,ur,cb,ub,ub,ub,ub,ub,ub,ub,ub,ub
ug,ux,ux,ug,ug,cg,ux,ux,ug,ux,ux,ux,ux,ux,ux,ux,ux,ux,ux,ux,ux,ux,cb
ug,ug,ug,ug,ug,ug,ug,ug,ug,cg,ux,ux,ux,ux,ux,ux,ux,ux,ux,ux,ux,ux,ux