ux,ur,ux,ur,ur,ur,ur,ur,ur,ur,ur,ur,ur,ur,ur,ur,ur,ur,ur,ur,ur,ur,ur
ur,ur,ur,ur,ur,ur,ur,ur,ur,ur,ur,ur,ur,ur,ur,ur,ur,ur,ur,ur,ur,cr,ur
ur,ur,ur,ur,ur,ur,ur,ur,ur,ur,ur,ur,ur,ur,ur,ur,ur,ur,ur,ur,ur,ur,ur
ur,ur,ur,ur,ur,ur,ur,ur,ur,ur,ur,ur,ur,ur,ur,ur,ur,ur,cr,ur,ur,ur,ur
ur,ur,ur,ur,ur,ur,ur,ur,ur,ur,ur,ur,ur,ur,ur,ur,ur,ux,ur,ub,cr,ur,cg
ur,ur,ur,ur,cg,ug,ur,ur,ur,ur,ur,ur,ur,ur,ur,ux,cr,ur,ur,ub,ub,cr,ug
ur,ur,ur,ur,ur,ur,ur,ur,ur,ur,ur,ur,ux,ux,ux,ux,ux,ux,ub,ub,ub,ub,ug
ur,ur,ur,ur,cr,ug,ub,ub,ub,ub,cb,ub,ux,ux,ux,ug,ug,ug,ub,ux,ux,ux,ug
cg,ux,ur,ur,ux,ug,ub,cb,ub,ub,ub,ub,ug,ug,ug,ug,ug,ug,ub,ux,ub,ub,ug
ub,ub,ub,ub,ur,ug,ub,ub,ub,ug,ux,ub,cb,ux,ux,ux,ug,ug,ub,ux,ux,ux,ug
ub,ux,ux,ub,ux,ug,ub,ub,ub,ub,ub,ub,ub,ub,ux,ug,ug,ug,ug,ug,ug,ug,ug
ub,ux,ux,ub,ub,ug,ub,ug,ug,ug,ub,ub,ug,ub,ub,ug,ug,ug,ug,ug,ug,ug,ur
ub,ux,ux,ub,ub,ug,ub,ug,ug,ug,ug,ub,ub,ub,ub,ub,ug,ug,ub,ux,ux,ux,ur
ub,ux,ux,ub,ub,ug,ub,ux,ub,ub,ug,ub,ub,ub,ub,ub,ux,ux,ub,ux,ux,ux,ur
ub,ux,ux,ub,ux,ug,ug,ux,ux,ub,ug,ub,ub,ub,ub,ub,ub,ux,ub,ux,ux,ux,ur
ub,ux,ux,ub,ux,ug,ug,ug,ux,ub,ug,ug,ub,ub,ub,ub,ub,ux,ub,ux,ux,ux,cb
ub,ux,ux,ub,ux,ug,ub,ug,ug,ub,cg,ub,ub,ub,ub,ub,ub,ux,ub,ux,ux,ux,ub
ub,ux,ux,ub,ux,ug,ux,ux,ug,ug,ug,ub,ux,ug,ub,ub,ub,ux,ub,ux,ux,ux,ub
ub,ux,ux,ub,ux,ug,ug,ug,ug,ug,ug,ug,ug,ug,ub,ub,ub,ux,ub,ux,ux,ux,ub
ub,ux,ux,ub,ux,ux,ux,ux,ux,ux,ux,ux,ux,ub,ub,ub,ub,cb,ub,ub,ux,ux,ub
ub,ux,ux,ub,ux,ux,ux,ux,ux,ux,ux,ux,ub,ub,ub,ub,ux,ux,ux,ub,ub,ub,ub
ub,ux,ux,ub,ux,ux,ux,ux,ux,ux,ux,ux,ux,ux,ux,ux,ux,ux,ux,cb,ub,ub,ub
ub,ub,ub,ub,ub,ub,ub,ub,ub,ub,ub,ub,ub,ub,ub,ub,ub,ub,ub,ub,ub,ub,ub