cb,cb,cb,cr,ur,ur,ur,cr,ug,ug,ug,ub,ub,ur,ux,ur,ur,ur,ub,ux,ux,ux,cb
ur,ur,ur,ur,ub,cb,cr,cr,cg,ub,cb,ug,ug,ug,ug,ug,ug,ug,ug,ug,ug,ug,ug
ur,ur,ur,ur,ub,ur,ur,ur,ub,ub,ub,ur,ur,ub,ux,ux,ur,ur,ux,ux,ux,ux,ug
ur,ur,ur,ur,ub,ub,ug,ur,ub,ub,ur,ub,ur,ub,ur,ur,ur,ux,ux,ux,ux,ux,ug
ur,ur,ur,ur,ub,ur,cr,ur,ub,ub,ur,ur,ur,ub,ux,cg,ux,ug,ug,ug,ux,ux,ug
ur,ur,ur,ur,ur,ur,ur,ug,cg,ug,ug,ug,ug,ug,ug,ug,ux,ug,cb,ug,ur,ur,ug
ur,ur,ur,ur,ur,ur,ub,cb,ug,ug,ug,ug,ug,ug,ug,ug,ux,ug,ub,ub,ub,ub,ub
cb,ur,ur,ur,ur,ur,ub,cr,ug,ug,ug,ub,ux,ux,ux,ug,ux,ub,ub,ub,ub,ub,ub
ur,ur,ur,ur,ur,ur,ur,ur,ub,ub,ug,ug,ug,ug,ux,ug,ug,ub,ub,ub,ug,ug,ug
ur,ur,ur,ur,ur,ux,ux,ub,ub,ub,ub,ug,ux,ug,ux,ux,ux,ub,ux,ub,ub,ub,ub
ux,ux,ux,ux,ux,ux,ux,ub,ub,cb,ub,ug,ux,ug,ux,ux,ux,ub,ub,ub,ub,ub,ub
ux,ux,ux,ux,ux,ux,ux,ub,ub,ub,ub,ug,ux,ug,ux,ug,ug,ug,ux,ug,ug,ug,ug
cb,ux,ux,ux,ux,ux,ub,ub,ub,ub,ub,ug,ug,ug,ug,ug,ux,cg,ux,ug,ug,ug,ug
ux,ux,ux,ub,ub,ub,ub,ub,ub,ub,ub,ug,ub,ug,ug,ug,ux,ux,ux,ug,ug,ug,ug
ux,ux,ub,ub,cb,ux,ub,ub,ub,ub,ub,ug,ug,ug,ub,ug,ug,ur,ur,ug,ug,ug,ug
ux,ux,ub,ub,ub,ub,ub,ub,ub,ub,ub,ub,ur,ub,ug,ug,ur,ux,ux,ug,ur,ug,ug
ug,ub,ub,ub,ub,ub,ub,ub,ub,ub,ub,ub,ub,ug,ug,ug,ur,ug,ug,ug,ur,ur,ug
cr,ur,ur,ug,ug,ub,ub,ub,ub,ur,ur,ur,ur,ur,ur,ur,ur,ur,ur,ur,ur,ur,ug
cg,ur,ub,ug,ug,ug,ug,ug,ub,ub,ub,ub,ug,ug,ug,ug,ug,ug,ug,ug,ug,ug,ug
cb,ur,ub,ug,ug,ug,ug,ug,ug,ub,ub,ub,ug,ux,ux,ug,ug,ug,ug,ug,ug,ug,ug
ux,ur,ur,ur,ur,ur,ur,cg,ug,ur,ur,ur,cr,ux,ux,ug,ux,ux,ux,ux,ux,ux,cr
cr,ur,ux,ug,ug,ug,ug,ug,ug,ug,ug,ug,ug,ug,ug,ug,ux,cb,cg,ux,cb,ux,cr
cg,ur,cg,cb,ug,ug,ux,ux,ux,ux,ux,ux,ux,ux,ux,cg,ux,ux,ux,cg,cg,ux,cr