ur,ur,ur,ur,ur,ur,ur,ur,ur,ur,ur,ur,ur,ur,ur,ur,ur,ur,ur,cr,ub,ub,ub
ur,ur,ur,ur,ur,ur,ur,ur,ur,ur,ur,ur,ur,ur,ur,ur,ur,cr,ug,ur,ur,ur,ub
ur,ub,cr,ur,ur,ur,ur,ur,ur,ur,ur,ur,ur,ur,ur,ur,ur,ug,ub,ub,ub,ub,ub
ur,ur,ur,ub,ur,ur,ur,ur,ur,ur,ur,ur,ur,ux,cr,ux,ux,ub,ub,ur,ur,ug,ux
ur,ur,ug,ur,ur,ur,ug,ug,ug,ug,cg,ur,ur,ux,ux,ux,ux,ub,ux,ub,ub,ug,ux
ur,ur,ug,ur,ur,ur,ur,ug,ug,ug,ur,ur,ur,ux,ux,ux,ux,ub,ux,ub,ub,ug,ux
ur,ur,ug,ur,ur,ur,ur,ur,ur,ur,ux,ux,ub,ux,ux,ux,ux,ub,ux,ub,ub,ug,ux
ur,ur,ug,ug,ur,ur,ug,ug,ur,ur,ux,ub,ub,ux,ux,ux,ux,ub,ux,ub,ub,ug,ux
ur,ur,ur,ug,ub,cr,ug,ug,ug,ug,cg,cb,ux,ux,ux,ux,ux,cb,ux,ub,ub,ug,ux
ur,ur,ur,ug,ur,ug,ug,ug,ug,ug,ub,ub,ub,ub,ub,ux,ux,ux,ux,ub,ub,ug,ux
ur,ur,ur,ug,ur,ug,ur,ug,ub,ub,ug,ub,ub,ub,ub,ug,ug,ug,ug,ub,ub,ug,cr
ur,ur,ur,ug,ub,ug,ux,ug,ug,ub,ub,ub,ub,ub,ub,ux,ux,ux,ug,ub,ub,ug,ur
ur,ub,ub,ub,ub,ug,ux,ug,ub,ub,cb,ub,ub,ub,ux,ux,ux,ux,ug,ub,ub,ug,ur
ur,ub,ub,ub,ub,ug,ub,ug,ub,ub,ub,ub,ub,ub,ub,ux,ux,ux,ug,ub,ub,ug,cb
ub,ub,ub,ub,ub,ug,ux,ub,ub,ub,ug,ub,ub,ub,ub,ug,ug,ux,ug,ub,ub,ug,ub
ub,ux,ub,ub,ub,ub,ub,ub,ub,ug,ug,ux,ug,ub,ug,ug,ug,ug,ug,ub,ub,ug,ub
ub,ux,ub,ug,ux,ub,ub,ux,ux,ux,ug,ug,ug,ub,ux,ub,ug,ux,ub,ub,ub,ug,ub
ub,ux,ub,ug,ub,ub,ub,ux,ux,ux,ub,ug,ug,ub,ux,ub,ug,ux,ux,ug,ub,ux,ub
ub,ux,ux,ug,ub,ug,ub,ux,ux,ux,ub,ub,ux,ub,ub,ub,ug,ux,ux,ug,ub,ux,ub
ub,ub,ub,ug,ub,ug,ub,ub,ug,ug,ug,ug,ug,ug,ug,ug,ug,ug,ug,ug,ub,ux,ub
ub,ub,ub,ug,ub,ux,ux,cb,ux,ux,ub,ux,ux,ub,ux,ux,ux,ux,ux,ub,ub,ub,ub
ub,ux,ux,ug,ub,ux,ux,ux,ux,ux,ub,ux,ux,ux,ux,ux,ux,ux,ux,ub,ub,ux,ub
cb,ur,ur,ug,ug,ug,ug,ug,ug,cg,ub,ub,ub,ub,ub,ub,ub,ub,ub,ub,ub,ub,ub