ur,ux,ux,ux,cr,ur,ur,ur,ur,ur,ur,ub,ub,ub,ub,ub,ub,ub,cr,ur,ur,ur,ur
ur,ur,ub,ub,ub,ub,ur,ur,ur,ux,ur,ur,ur,ur,ur,ur,ub,cb,ur,ur,ur,ur,ur
ur,ur,ux,ux,ux,ur,ur,ur,ur,ur,ur,ur,ur,ur,ur,ur,ub,ub,ur,ur,ur,ur,ur
ur,ur,ux,ug,cg,ur,ur,ur,ur,ur,ur,cb,ub,ub,ub,ub,ub,ub,ur,ur,ur,ur,ur
ur,ur,ux,ug,ug,ur,ur,ur,ur,ur,ur,ur,ur,ur,ur,ur,ur,ur,ur,ur,ur,ub,ub
ur,ur,ur,ur,cr,ur,ur,ur,ur,ur,ur,ug,ug,ur,ur,ur,ur,ur,ur,ur,ub,ub,ub
ur,ur,ur,ur,ur,ur,ur,ur,ur,ur,ur,ur,ug,ug,ug,ug,ug,ur,ur,ub,ub,ub,ub
ur,ur,ur,ur,ur,ur,ur,ur,ur,ur,ur,ur,ur,cg,ug,ug,ug,ub,ub,ub,ug,ux,ub
cg,ur,ur,ur,ur,cr,cr,cb,ub,ur,ur,ur,ub,ub,ub,ub,ux,ux,ux,ux,ug,ux,ub
ux,ub,ub,ub,ub,ub,ub,ub,ub,ub,ub,ub,ub,ug,ub,ug,ux,ux,ux,ug,ug,ux,ub
ur,ur,ur,ur,ug,ub,ub,ub,ub,ub,ub,ug,ub,ug,ug,ug,ug,ug,ug,ug,ub,ux,ub
ur,ur,ur,ur,ug,ug,ug,ug,ub,ub,ub,ub,ux,ub,ub,ub,ug,ug,ub,ux,ub,ux,ub
ux,ux,ux,ux,ux,ux,ux,ux,ub,ub,ub,ub,ub,cb,ug,ug,ug,ug,ub,ux,ub,ux,ub
ux,ux,ux,ux,ux,ux,ub,cb,ub,ub,ub,ub,ug,ub,ub,ub,ug,ug,ug,ug,ug,ug,ug
cg,ux,ux,ux,ux,ux,ub,ub,ub,ub,ub,ux,ug,ug,ug,ug,ug,ub,ub,ux,ub,ux,ug
ug,ug,ug,ug,ug,ug,ug,ub,ug,ug,ug,ug,ug,ug,ug,ug,ug,ug,ug,cg,ub,ub,ub
ug,ux,ux,ux,ub,ub,ub,ub,ub,ux,ug,ug,ug,ux,ug,ug,ug,ux,ux,ux,ux,ux,ub
ug,ux,ux,ux,ub,ub,ub,ub,ub,ub,ug,ub,ug,ub,ug,ub,ub,ux,ux,ux,ux,ux,ub
ug,ux,ux,ux,ux,ub,ub,ub,ug,ug,ug,ux,ug,ug,ug,ux,ux,ux,ux,ux,ux,ux,ub
ug,ux,ux,ux,ux,ux,ux,ux,ux,ux,ux,ux,ux,ux,ux,ux,ux,ux,ux,ux,ux,ux,ub
ug,ug,ug,ug,ug,ug,ug,ug,ug,ug,ug,cr,ur,cb,ub,ub,ub,ub,ub,ub,ub,ub,ub
cr,ux,ux,ux,ux,ux,ux,ux,ux,ux,ux,ux,ux,ux,ux,ux,ux,ux,ux,ux,ux,ux,cb
cg,ux,ux,ux,ux,ux,ux,ux,ux,cg,ux,ux,ux,ux,ux,ux,ux,ux,ux,ux,ux,ux,ux