ur,ur,ur,ur,ux,ux,ux,ux,cr,ur,ur,ux,ux,cr,ux,ux,ux,cb,ux,ux,ux,ux,ux
ur,ur,ur,ur,ux,ux,ux,ux,ux,ux,ur,ux,ux,ur,ux,ux,ux,ux,ux,ux,ux,ux,ux
ur,ur,ur,ur,ur,ur,ur,ur,ur,ur,ur,ux,ux,ur,ux,ux,ux,ux,ux,ux,ux,ux,ux
ur,ur,ur,ur,ur,ur,ur,ur,ur,ur,ur,ux,ux,ur,ug,ug,ug,ug,ug,ux,ux,ur,ur
cb,ur,ur,ur,ur,ur,ur,ur,ur,ur,ur,ur,ur,ur,ur,ur,ur,ux,ug,ur,ur,ur,ur
ur,ur,ur,ur,ur,ur,ur,ur,ur,ur,ur,ur,ug,ug,ug,ug,ug,ug,ug,ur,ur,ur,ur
ur,ur,ur,ur,ur,ug,cr,ug,ur,ur,ur,ur,ug,ug,ug,ug,ug,ug,ug,ur,ur,ur,ur
ur,ur,ur,ur,ur,ug,ur,ug,ur,ur,ur,ur,ug,ug,ug,ug,ug,ug,ug,ur,ur,ur,ur
ur,ur,ur,ur,ur,ug,ug,ug,ug,ur,ur,ug,ur,ur,ur,ur,ug,ug,ur,ur,ur,ur,ur
ur,ur,ur,ur,ur,ur,ur,ug,ug,ur,ug,ug,ug,ur,ub,ug,ug,ug,ur,ur,ux,ux,ux
ur,ur,ur,ur,ur,ur,ur,cg,cg,ux,ur,ub,ug,ub,ub,ur,ur,ub,ub,ux,ux,ux,ux
ur,ur,ur,ur,ur,ur,ur,ug,ug,ux,ur,ub,ub,ub,ub,cb,ub,ub,ub,ub,ug,ux,ux
ur,ur,ur,ur,ur,cg,ug,ux,ug,ux,ub,ub,ub,ux,ub,ub,ub,ub,ub,ub,ug,ux,cg
ur,ur,ur,cr,ug,ux,ug,ug,ug,ug,ug,ug,ug,ub,ub,ub,ub,ug,ug,ux,ug,ug,ug
ur,ur,ur,cr,ug,ux,ux,ug,ug,ug,ug,ug,ug,ub,cb,ub,ub,ub,ug,ub,ug,ug,ug
ub,ux,ux,ux,ug,ux,ux,ux,ub,ux,ux,ux,ux,ub,ub,ug,ug,ub,ub,ub,ux,ug,ug
ub,ub,ub,ub,ug,ug,ug,ug,ug,ub,ug,ug,ug,ug,ug,ug,ub,ub,ub,ub,ub,ub,ub
cg,ux,ux,ux,ux,ux,ux,ux,ub,ug,ug,ux,ub,ub,ub,ug,ug,ug,ug,ug,ug,ug,ub
ur,ur,ug,ug,ug,ug,ug,ug,ug,ug,ub,ub,ub,ub,ub,ub,ub,ub,ub,ub,ub,ub,ub
ur,ux,ug,ux,ug,ug,ug,cr,ur,ur,cb,ub,ub,ub,ub,ub,ub,ub,ub,ub,ub,ub,ub
ur,ur,ug,ub,ub,ub,ub,ub,ub,ub,ub,ub,ub,ub,ub,ug,ug,ub,ub,ub,cb,ur,ur
cr,ux,ug,ub,ub,ub,ub,ub,ug,cg,ub,ub,ub,ub,ub,ub,ub,ub,ux,ux,ux,cb,cr
cg,ux,ug,ug,ug,ug,ug,ug,ug,ux,ub,ub,ux,cb,ub,ub,ub,ub,ux,cg,cb,ux,cr