ur,ur,ur,ur,ur,ur,ur,ur,ur,ur,ur,ur,ux,ux,ux,ux,ux,ux,ux,ux,ux,ux,ux
ur,ur,ur,ur,ur,ur,ur,ur,ur,ur,ur,ur,ur,ur,ux,ux,ux,ux,ux,ux,ux,ux,ux
ur,ur,ur,ur,ur,ur,ur,ur,ur,ur,ur,ur,ur,ur,ur,ur,ur,ur,ur,ur,ur,ur,ur
ur,ur,ur,ur,ur,ur,ur,ur,ur,ur,ur,ur,ur,ur,ux,ux,ux,ux,ux,ur,ur,ur,cb
ur,ur,ur,ur,ur,ur,ur,ur,ur,ur,ur,ur,ub,ur,ub,ur,ux,ux,ur,ur,ur,ur,ur
ux,cr,ur,ur,ug,ug,ug,cg,ur,ur,ur,ur,ur,ug,ug,ur,ur,ur,ur,ur,ur,ur,ur
ux,ux,ux,cr,ur,ur,ur,ur,ur,ug,ug,ug,cg,ug,ug,ub,ur,ub,ur,ur,ur,ur,ur
ux,ux,ux,ur,ur,ur,ur,ur,ur,ug,ur,ug,ug,ug,ug,ur,ur,ub,ur,ur,ur,ur,ur
cg,ux,ux,ux,ux,ux,ur,ur,ur,ug,cr,ub,ub,ub,cb,ur,ur,ur,ur,ur,ur,ur,ur
ux,ux,ur,ur,ur,ur,ur,ur,ur,ur,cb,ub,ub,ub,ub,ub,ur,ur,ur,ur,ur,ur,ur
ur,ur,ur,ur,ub,ub,ur,ur,ur,ur,ur,ub,ub,ub,ub,ux,ur,ur,ur,ur,ur,ur,ur
ur,ur,ur,ub,ub,ur,ur,ur,ur,ur,ub,ux,ub,ub,ub,ux,ug,ug,ur,ur,ur,ur,ur
ur,ur,ur,ur,ub,cb,ub,cb,ub,ub,ub,ug,ub,ub,ub,ux,ug,ux,ur,ur,ur,ur,ur
ux,ux,ux,ux,ux,ub,ux,ux,ub,ux,ub,ub,ub,ub,ub,ub,ug,ux,ur,ur,cr,cr,ur
cg,ux,ux,ux,ux,ux,ux,ux,ub,ux,ub,ub,ub,ub,ub,ub,ug,ux,ur,ug,ub,ux,ug
ux,ux,ux,ux,ux,ux,ux,ux,ub,ux,ub,ub,ub,ub,ub,ub,ug,ux,cr,ug,ub,ux,ug
ux,ux,ux,ux,ux,ux,ux,ux,ub,ub,ub,ub,ub,ub,ux,ub,ug,ux,ux,ug,ub,ux,ug
ux,ux,ux,ux,ux,ux,ux,ux,ub,ub,ub,ub,ub,ux,ux,ub,ug,ux,ux,cg,ub,ux,ug
ux,ux,ux,ub,ub,ux,ux,ux,ub,ub,ux,ux,ux,ux,ux,ub,ug,ux,ux,ux,ub,ux,ug
ug,ug,ug,ug,ug,ug,ug,ug,ug,ub,ug,ug,ug,ug,ug,ub,ug,ub,ub,ub,ub,ug,ug
ug,ub,ub,ub,ub,ub,ub,ub,ub,ub,ub,ub,ub,ub,ub,ub,ug,ub,ur,ub,ub,ux,ux
ug,ug,ug,cb,ub,ub,ub,ub,ub,ub,ub,ub,ub,ub,ug,ug,ug,ub,ux,ub,ub,ux,cb
ur,ub,ub,ub,ub,ub,ub,ub,ub,cg,ub,ub,ub,ub,ub,ub,ub,ub,ux,ub,ub,ux,ux