ub,ub,ub,ub,ub,cr,ur,ur,ur,ur,ur,ur,ur,ur,ur,ur,ur,cb,ub,ub,ub,ub,ub
ub,ub,cb,ur,ur,ur,ur,ur,ur,ur,ur,ur,ur,ur,ur,ur,ur,ur,ug,ur,ur,ux,ub
ux,ux,ug,cr,ur,ur,ur,ur,ub,ur,ur,ur,ur,ur,ur,ur,cr,ug,ur,cr,ur,ux,ub
ux,ux,ug,ug,ug,ug,ur,ur,ur,ur,cg,ur,ur,ur,ur,ur,ur,ug,ur,ub,ur,ux,ub
ux,ux,cg,ug,ug,ug,ug,ug,ug,ug,ug,ug,ug,ug,ug,ur,ug,ug,ub,ub,ub,ux,ub
ux,ux,ux,ux,ug,ug,ug,ug,ug,ur,ur,ur,ur,ur,ur,ur,ub,ug,ug,ug,ug,ux,ub
ux,ux,ux,ux,ug,ug,ug,ug,ug,ug,ur,ur,cr,ub,ub,ub,ub,ub,ub,ux,ug,ux,ub
ux,ux,ux,ux,ux,ug,ug,ug,ug,ug,ug,ug,ur,ur,ur,ub,ug,ub,ub,ux,ug,ux,ub
ux,ux,ux,ux,ux,ux,ux,ur,ub,ub,ux,ux,ux,ux,ub,ub,ub,ub,ub,ux,ug,ux,ub
ux,ux,ux,ux,ux,ux,ub,ub,ub,ub,ub,ub,ux,ux,ub,ub,ub,ub,ux,ux,ug,ug,ub
ux,ux,ux,ux,ux,ux,ub,ub,ub,ub,ub,ub,ux,ux,ub,ub,ub,cb,ux,ux,ux,ug,ub
ux,ux,ux,ux,ux,ux,ub,ub,ur,ub,ub,ub,ub,ux,ub,ub,ub,ux,ux,ux,ux,ug,ub
ux,ux,ux,ux,ux,ux,ux,ug,ur,ur,ub,cb,ur,ur,ur,ur,ur,ur,ur,ur,ur,ur,cr
ux,ux,ux,ux,ux,ux,ux,ub,ub,ub,ub,ub,ub,ub,ux,ux,ub,ug,ug,ug,ug,ug,ub
cg,ux,ux,ux,ux,ux,ux,ub,ub,ub,ub,ub,ub,ub,cb,ug,ub,ug,ug,ux,ug,ug,ub
ux,ux,ux,ux,ux,ux,ux,ub,ug,ub,ub,ub,ub,cb,ub,ub,ub,ug,ug,ug,ug,ug,ub
ux,ux,ux,ux,ux,ux,ux,cg,ug,ub,ub,ub,ub,ub,ub,ug,ug,ug,ug,ug,ux,ug,ub
ub,ub,ub,ub,ub,ub,ub,ug,ug,ub,ub,ub,ub,ub,ub,ug,ug,ug,ug,ug,ux,ug,ub
ub,ub,ub,ub,ub,ub,ub,ug,ug,ug,ug,ug,ug,ug,ux,ux,ux,ux,ux,ug,ux,ug,ub
ub,ub,ub,ux,ux,ux,ub,ur,ur,ux,ux,ux,ux,ug,ug,ug,ug,ug,ug,ug,ux,ug,ub
ub,ub,ub,ub,ub,ub,ub,ur,ur,ux,ux,ux,ux,ux,cg,ug,ug,ug,ug,ug,ug,ug,ub
cr,ub,ub,ub,ub,ub,ub,ur,ur,ux,ux,ux,ux,ux,ux,ux,ux,ux,ux,ux,ux,ub,cb
cg,ub,ub,ub,ub,ub,ub,ur,ur,cg,ub,ub,ub,ub,ub,ub,ub,ub,ub,ub,ub,ub,cb