ur,ur,cb,ur,ur,ur,ur,ur,ur,ur,ur,ur,ur,cr,ub,ub,ub,ub,ux,cg,ub,cg,ug
ur,ur,ur,ur,ur,ur,ur,ur,ur,ur,ur,ur,ub,ux,ur,ur,ur,ub,ub,ub,ub,ug,ug
ur,ur,ur,ur,ur,ur,ur,ur,ur,ur,cb,ub,ub,ur,ur,ur,ur,ug,ug,ur,ur,ug,ug
ur,ur,ur,ur,ur,ur,ur,ur,ur,ur,ur,ur,cr,ub,ur,ub,ub,ug,ub,ub,ur,ug,ug
ur,ur,ur,ur,ur,ur,ur,ur,ur,ur,ur,ug,ur,ur,cr,ur,ur,ug,ug,ug,ug,ub,ug
ur,ur,ur,ur,ur,cr,ur,ur,ur,ur,ug,ug,ur,ur,ug,ug,ug,ug,ug,ur,ug,ur,ug
ur,ur,ur,ur,ur,cr,ug,ur,ur,ug,ug,ug,ur,ur,ur,ur,ur,ur,ur,ur,ug,ug,ug
ur,ur,ur,ur,ug,ug,ug,ug,ug,ug,ug,ug,ux,ur,ur,ur,ur,ur,ur,ur,ub,ug,ub
ur,ur,ur,ur,ur,ur,ur,ur,ur,ur,ur,ur,ur,ur,ug,ug,ug,ug,ub,ug,ug,ug,ux
ur,ur,ur,ur,ur,ur,ur,ux,ug,cg,ug,ur,ub,ub,ub,ug,ug,ug,ug,ug,ug,ux,ux
ur,ur,ur,ur,ub,ub,ux,ux,ux,ur,ug,ur,ub,cb,ub,ug,ug,ug,ug,ug,ug,ux,ux
ur,ur,cg,ur,ub,ub,ux,ux,ux,ub,ug,ug,ub,ub,ub,ub,ub,ux,ug,ug,ug,ux,ux
cg,ux,ug,ug,ub,ub,ux,ux,ux,ub,ug,ug,ug,ub,ug,ub,ub,ug,ug,ug,ux,ux,ux
ux,ux,ug,ug,ux,ub,ux,ux,ub,ub,ub,ub,ug,ug,ug,ub,ug,ug,ug,ug,ux,ux,ux
ux,ux,ug,ug,ug,ub,cg,ux,ub,ub,ub,ub,cb,ub,ub,ub,ug,ug,ub,ux,ux,ux,ux
ux,ux,ug,ug,ug,ub,ug,ug,ug,ug,ub,ub,ub,ub,ub,ug,ug,ug,ug,ug,ug,ug,ux
ux,ux,ux,ur,ub,ub,ug,ux,ux,ux,ug,ug,ug,ub,ub,ub,ub,ub,ub,ub,ux,ug,ux
cg,ub,ub,ub,ug,ug,ug,ub,ub,ug,ug,ug,ug,ub,ub,ub,ux,ux,ux,ub,ug,ug,ux
ub,ub,ub,ug,ug,ub,ub,ub,ub,ub,ug,ug,ug,ub,ub,ub,ux,ug,ug,ug,ug,ux,ux
ub,ub,ub,ug,ub,ub,ub,cb,ub,ub,ux,ug,ug,ug,ux,ug,ug,ug,ux,ub,ux,ux,ux
cr,ux,ux,ug,ub,ur,ub,ub,ux,cb,ux,ux,ub,ug,ux,ug,ux,ux,ux,ub,ux,ux,ux
cg,cb,ux,ug,ub,ub,ub,ub,ug,ug,ug,ux,ub,ug,ux,ug,ux,ux,ux,ub,ux,cb,cr
cr,ug,ug,ug,ug,ub,ub,ub,ur,ur,ur,ur,ur,ur,ur,ur,ur,ur,ur,cr,cb,ux,cr