cb,cb,cb,cr,ur,ur,ur,ur,ur,ur,ur,ur,ur,ur,ur,cr,ur,cb,ur,ur,ur,ur,cb
ur,ur,cr,ug,ug,ug,ur,ux,ur,ur,ur,ur,ur,ur,ur,ug,ur,ub,cr,ur,ur,ur,ur
ur,ur,ur,ug,cg,ub,ur,ur,ur,ur,ur,ur,ur,ur,ur,cg,ur,cr,ur,ur,ur,ur,ur
ur,ug,ur,ug,ub,ub,ub,ux,ur,ur,ur,ur,ur,ur,ur,ub,ub,ub,ug,ur,ur,ub,ub
ur,ur,ur,ug,cb,ur,ub,ur,cg,ug,ug,ug,ug,ug,cb,ub,ug,ug,ug,ug,ug,ug,ub
ur,ur,ur,ug,ub,ug,ux,ur,ur,ub,ur,ur,ur,ur,ur,ur,ug,ug,ug,ug,ug,ug,ub
ur,ur,ub,ub,ub,ug,ug,ug,ur,ur,ur,ur,ur,ur,ur,ug,ug,ub,ug,ug,ug,ug,ub
cb,ux,ux,ug,ug,ug,ug,ug,cr,ur,ur,ur,ub,ub,ug,ug,ug,ug,ug,ug,ug,ug,ux
ug,ug,ug,ug,ug,ug,ug,ug,ug,ub,ub,cb,ub,cg,ug,ug,ug,ug,ug,ug,ug,ug,ux
ug,ug,ug,ug,ux,ux,ux,ux,ug,ub,ub,ux,ug,ug,ug,ur,ub,ug,ug,ug,ub,ub,ub
ug,ug,ug,ug,ux,ux,ux,ux,ug,ub,ug,ux,ug,ug,ug,ug,ug,ub,ub,ub,ub,ub,ub
ug,ug,ug,ug,ux,ux,ux,ux,ug,ug,ug,ug,ug,ug,ug,ur,ug,ub,ub,ub,ub,ub,ux
cb,ux,ux,ug,ux,ux,ug,ug,ux,ux,ug,ug,ub,ub,ub,ub,ug,ug,ux,ux,ux,ub,ub
ug,ug,ug,ug,ux,ux,ug,ux,ug,ub,ug,ug,cb,ub,ug,ub,ub,ub,ub,ub,ub,ub,ub
ug,ug,ur,ur,ug,ug,ug,ug,ug,ub,ug,ug,ug,ug,ug,ug,ug,ug,ug,ug,ug,ug,ux
ur,ug,ux,ux,ug,ux,ug,ug,ug,ux,ub,ug,ug,ug,ub,ub,ug,ub,ux,ux,ux,ux,ux
ur,ug,ug,ug,ug,ur,ur,ur,ur,ur,ur,ur,ur,ug,ur,ur,ur,ur,ur,ur,ur,ur,ur
cr,ux,ug,ug,ux,ux,ug,ug,ug,ug,ug,ug,ug,cg,ux,ux,ux,ux,ug,ux,ux,ug,ur
cg,ux,ug,ug,ux,ux,ux,ux,ux,ux,ug,ug,ug,ux,ux,ux,ux,ux,ug,ug,ug,ug,ur
cb,ur,ur,ur,ur,ur,ur,ur,ur,ur,ur,ur,ur,ur,ur,ur,ur,ur,ur,ur,ur,ur,ur
ux,ur,ux,ux,ux,ux,ux,ux,ux,ux,ux,ux,ux,ux,ux,ux,ux,ux,ux,ux,ux,ux,cr
cr,ur,ur,ur,ur,ur,ur,ur,ur,ur,ur,ur,ur,ur,ur,ur,ur,cb,cg,ux,cb,ux,cr
cg,cb,cg,cb,ux,ux,ux,ux,ux,ux,ux,ux,ux,ux,ux,cg,ur,cr,ur,cg,cg,ux,cr