ur,cb,cb,cr,ur,ur,ur,ur,ur,ur,ur,ur,ur,ur,ur,ur,ur,ur,cr,ur,ux,ux,cb
ur,ur,cb,ur,ur,ur,ub,ub,ub,ub,ur,ur,ur,ur,ur,ur,ur,ur,ur,cb,ur,ur,ur
ur,ur,ur,ur,cr,ur,cb,ug,cg,ub,ur,ux,ur,ur,ur,ur,ur,cr,ur,ub,ur,ub,ur
ur,ur,ur,ur,ur,ur,ur,ug,ub,ub,ur,ur,ur,ur,ux,ur,ux,ur,ur,ub,ur,ub,ur
ug,cg,ur,ur,ur,ug,cg,ug,ur,ur,ur,ur,ur,ur,ux,ug,cg,ur,ug,ug,ur,ux,ur
ug,ur,ur,ur,ur,ug,ur,ug,ur,ur,ur,ur,ur,ur,ug,ug,ug,ug,ux,ug,ur,ux,ur
ug,cr,ur,ur,ur,ug,ug,ug,ur,ur,cr,ug,ug,ur,ur,ug,ur,ur,ur,ug,ur,ux,ur
cb,ug,ug,ur,ug,ug,ug,ur,ur,ur,ub,ub,ug,ug,ug,ug,ur,ur,ug,cb,ub,ub,ub
ug,ug,ug,ur,ug,ug,ug,ur,ub,ub,ub,ub,ug,ug,ug,ug,ub,ub,ub,ub,ur,ub,ub
ug,ug,ur,ug,ug,ug,ug,ur,ug,ug,ub,ub,ub,ub,ug,ux,ub,ub,ub,ub,ur,ub,ub
ug,ug,ur,ur,ur,ug,ug,ug,ug,ug,ub,ub,ub,ug,ug,ug,ub,ub,ub,ub,ur,ub,ub
ur,ur,ur,ur,ur,ug,ub,ub,ug,ub,ub,ug,ug,ug,ug,ub,ur,ux,ug,ug,cr,ux,ub
cb,ug,ux,ub,ux,ug,ug,ug,ug,ub,ug,ux,ug,cg,ug,ub,ur,ux,ug,ux,ug,ux,ux
ug,ug,ux,ub,ub,ub,ub,ub,ux,ub,ug,ux,ug,ug,ug,ub,ur,ux,ug,ux,ug,ux,ux
ub,ug,ug,ug,ub,ub,ug,ub,ub,ub,cb,ub,ug,ug,cb,ug,ur,ug,ug,ug,ug,ux,ux
ub,ug,ug,ug,ug,ug,ug,ug,ux,ux,ug,ug,ub,ub,ub,ub,ub,ug,ug,ux,ux,ub,ux
ux,ug,ug,ug,ug,ug,ux,ux,ux,ux,ux,ux,ug,ux,ux,ux,ub,ub,ub,ub,ux,ub,ux
ux,ug,ug,ug,ub,ug,ux,ux,ux,ux,ux,ux,ug,ux,ux,ux,ub,ub,ub,ub,ux,ub,ux
ux,ug,ug,ug,ug,ug,ug,ug,ug,ug,ug,ug,ug,ux,ux,ux,ub,ub,ub,ub,ub,ub,ux
cr,ug,ug,ug,ug,ug,ug,ug,ug,ug,ug,ur,ur,ub,ub,ub,ub,ub,ub,ub,ur,ub,ur
cg,ug,ug,ug,ug,ux,ux,ub,ub,ub,ub,ub,ub,ub,ub,ub,ub,ub,ub,ub,ub,ub,cr
cr,ug,ug,ug,cg,ub,ub,ub,ub,ub,ub,ub,ub,ub,ub,ub,ub,ub,ub,cb,cb,ub,cr
cg,ur,cg,cb,ux,ux,ux,ux,ux,ux,ux,ux,ux,ux,ux,cg,ub,ub,ub,cg,cg,cb,cr