ur,ur,ur,ur,ur,ur,ur,ur,ur,ur,cr,ub,ub,ub,ub,ub,ub,ur,ur,cb,ub,ur,ur
ur,ur,ur,ur,ur,ur,ur,ur,ur,ur,ub,ur,ur,ur,ux,ux,cb,cr,ub,ub,ub,ur,ur
cb,ur,cr,ug,ug,cg,ur,ur,ur,ur,ub,ur,ur,ur,ur,ur,ur,ur,ur,ur,ur,ur,ur
ub,ur,ur,ur,ur,ur,ug,ug,ug,ug,ug,ur,ur,ur,ur,ur,ur,ur,cr,ur,ur,ur,ur
ub,ur,ur,ux,ur,ug,ug,ur,ur,ur,ug,cg,ur,ur,ux,ur,ur,ur,ur,ur,ur,ur,ur
ub,ur,ur,ux,ur,ug,ug,ug,ur,ur,ub,ur,ur,ur,ur,ur,ur,ur,ur,ur,ur,ur,ur
ub,ur,ur,ur,ur,ur,ur,ug,ur,ur,ub,ur,ur,ur,ur,ub,ub,ur,ur,ur,ur,ur,ux
ub,ur,ur,ur,ur,ur,ur,ur,ur,ub,ub,ub,ur,ur,ug,ug,ux,ur,ur,ur,ub,ub,ux
ub,ur,ur,ur,ur,ur,ur,ur,ug,ub,ug,ub,ug,ug,ug,ug,ug,ur,ur,ur,ub,ur,ur
cr,ur,ur,ur,ur,ug,ug,ub,ub,ub,cb,ub,ug,ug,ux,ux,ug,ug,ux,ux,ug,ux,ur
cg,ug,ug,ug,ug,ug,ug,ug,ug,ug,ug,ub,ug,ug,ug,ug,ug,ug,ux,ux,ug,ux,ur
ub,ub,ub,ur,ur,ug,ub,ub,ug,ug,ub,ub,ub,ub,ub,ug,ug,ug,ux,ux,ug,ux,ur
ub,ub,ub,ur,ur,ug,ug,ug,ug,ub,cb,ub,ub,ub,ub,ug,ug,ug,ux,ux,ug,ux,ur
ug,ux,ub,ub,ug,ug,ur,ug,ub,ub,ub,ub,ub,ub,ug,ug,ug,ug,ux,ux,ug,ux,ur
ug,ux,ux,ux,ug,ug,ur,ux,ub,ub,ux,ub,ub,ub,ux,ux,ux,ux,ux,ux,ug,ux,ur
ug,ux,ux,ux,ug,ug,ug,ug,ub,ub,ug,ub,ub,ub,ux,ux,ux,ux,ux,ux,ug,ux,ur
ug,ux,ux,ux,ux,ux,ug,ux,ux,ux,ug,ub,ub,ub,ux,ux,ux,ux,ux,ux,ug,ux,ur
ur,ur,ur,ur,ur,ur,ur,ur,ur,ur,ur,ur,ur,ur,ur,ur,ur,ur,ur,ur,ur,ur,ur
ur,ux,ux,ux,ux,ux,ur,ux,ux,ux,ux,ux,ux,ug,ux,ux,ux,ux,ux,ux,ug,ux,ux
ur,ux,ux,ux,ux,ux,ur,ux,ux,ux,ux,ux,ux,ug,ux,ux,ux,ux,ux,ux,ug,ux,ux
ur,ux,ux,ux,ux,ux,ur,ux,ux,ux,ux,ux,ux,ug,ux,ux,ux,ux,ux,ux,ug,ux,ux
ur,ur,ur,ur,cr,ug,ug,ug,ug,ug,ug,ug,ug,ug,ur,ux,ux,ux,ux,ux,ug,ux,ux
ur,ur,ur,ur,ur,ur,ur,cg,ux,ux,ux,ux,ux,ux,ux,ux,ux,ux,ux,ux,ux,cb,ux