ur,ur,cb,ux,ug,ug,ug,ur,ur,ur,ur,ur,ur,ur,ur,ug,ur,ur,ur,cg,ug,ug,ug
ur,ur,ur,ub,ub,ur,ug,ur,ur,ur,ur,ur,ug,ur,ur,ur,ur,ur,ur,ub,ug,ug,ug
ur,ur,cg,ug,cb,ur,ug,ug,ug,ur,ug,cr,ur,ur,ur,ur,ux,ug,ug,ug,ug,ug,ug
ur,ur,ur,ur,cr,ur,ur,ur,ug,ug,ug,ur,cr,ur,ur,ur,ub,ug,ub,ub,ur,ug,ug
ur,ur,ur,ur,ur,ur,ur,ur,ur,ur,ur,ur,ur,ur,ur,ux,ux,ug,ug,ug,ug,ub,ug
ur,ur,ur,ur,ug,ug,ug,ug,ug,ug,ug,ug,ur,ur,ug,ug,ug,ug,ug,ux,ug,ur,ug
cr,ur,ur,ur,ur,ur,ur,ur,ux,ur,ur,ug,ur,ur,ux,ux,ux,ux,ux,ur,ug,ug,ug
ur,ur,cr,ur,ub,ub,ur,ur,ur,ur,ur,ug,ur,ur,ur,ur,ur,ub,ub,ur,ux,ux,ux
ub,ub,ub,ub,ub,ub,ux,ug,ug,ug,ug,ug,ub,ub,ub,ub,ub,ub,ub,ur,ur,ur,ur
ub,ub,ub,ur,ug,ub,ub,ub,ub,ub,ug,ub,ug,ub,ub,ug,ug,ug,cg,ur,ur,ur,ur
ub,cb,ub,ur,ug,ub,ug,ug,ug,ug,ug,ux,ug,ub,cb,ug,ug,ug,ug,ug,ur,ur,ur
ub,ub,ub,ur,ug,ub,ug,ux,ub,ug,ub,ub,ub,ub,ub,ug,ug,ug,ug,ug,ur,ur,ur
cg,ux,ug,ug,ug,ug,ug,ux,ux,cg,ub,ug,ug,ug,ub,ug,ug,ug,ug,ug,ur,ur,ur
ux,ux,ug,ug,ux,ug,ug,ux,ux,ub,ub,ub,ub,ub,ub,ub,ug,ug,ug,ug,ur,cr,ur
ux,ux,ug,ug,ug,ug,ug,ux,ux,ub,ug,ub,ub,ub,ub,ub,ug,ug,ug,ug,ur,ux,ur
ux,ux,ug,ug,ug,ug,ug,ux,ux,cb,ub,ub,ub,ub,ub,ug,ug,ug,ug,ur,ur,ux,ur
ux,ux,ug,ug,ug,ug,ug,ux,ux,ub,ub,ub,ub,ub,cg,ux,ux,ux,ux,ur,ur,ux,ur
cg,ub,ug,ub,ug,ug,ug,ub,ug,ug,ug,ug,ug,ug,ug,ug,ug,ug,ux,ur,ur,ux,ur
ub,ub,ug,ug,ug,ub,ux,ug,ug,ub,ux,ub,ug,ub,ug,ug,ug,ug,ux,ur,ur,ux,ur
ub,ub,ug,ug,ug,ug,ug,ug,ub,ub,ux,ub,ug,ug,ux,ux,ux,ux,ux,ur,ur,ux,ur
cr,ux,ux,ug,ub,ur,ux,ub,ub,ub,ux,ub,ux,ug,ux,ux,ux,ux,ux,ur,ur,ur,ur
cg,cb,ux,ug,ub,ub,ux,ub,ub,ub,ub,ub,ux,ug,ux,ux,ux,ux,ux,ur,ur,cb,cr
cr,ug,ug,ug,ug,ub,ub,ub,cb,ub,ub,ur,ur,ur,ur,ur,ur,ur,ur,ur,cb,ux,cr