ur,ur,ur,cr,ur,cg,ur,ur,ur,ub,ub,ub,ub,ub,ub,ub,ub,ub,ub,cg,ur,ur,ur
ur,ur,cr,ur,ur,ug,ug,ur,ur,ur,ug,ub,ub,ub,ub,ub,ub,ub,ub,ub,ub,ub,ur
ur,ur,ur,ur,ug,ug,ur,cb,ur,ur,ur,ub,ub,ug,ug,ug,ug,ug,cg,ub,ub,ur,ur
ub,ur,ur,ug,ur,ug,ur,ub,ug,ur,ux,ub,ug,ug,ug,ug,ug,ug,ug,ug,ug,ux,ub
ur,cr,ur,ub,ub,ub,ub,ub,ur,cr,ur,ub,ug,ug,ug,ug,ug,ug,ug,ub,ug,ux,ub
ur,ur,ur,ur,ur,ur,ur,ur,ug,ug,ub,ub,ux,ub,ug,ug,ug,ug,ug,ub,ug,ur,ub
ur,ur,ur,ur,ur,ur,ur,ub,ub,ub,ub,ub,ub,ub,ug,ub,ug,ub,ub,ub,ug,ux,ub
ur,ur,ur,ur,ur,ub,ub,ub,ux,ux,ub,ub,ub,ub,cg,ub,ug,ub,ub,ug,ug,ux,ub
ur,ug,cr,ug,ur,ub,ub,ub,cb,ug,ug,ug,cb,ug,ug,ub,ug,ug,ug,ug,ug,ug,ug
ub,cb,ur,ub,ub,ur,ur,ug,ug,ug,ug,ug,ug,ug,ug,ug,ub,ub,ub,ux,ux,ux,ug
ub,ub,ux,ub,ub,ug,ub,ub,ub,ub,ub,ub,ug,ug,ug,ug,ug,ug,ux,ux,ux,ux,ug
ub,ub,ux,ub,ub,ug,ub,ug,ug,ug,ub,ub,ug,ug,ug,ug,ug,ug,ux,cr,ux,ux,ug
cg,ub,ub,ub,ub,ub,ub,ux,ub,ub,ub,ug,ug,ug,ug,ug,ub,ux,ub,ur,ux,ux,ug
ux,ux,ux,ux,ub,cb,ub,ub,ub,ub,ug,ug,ug,ug,ub,ug,ug,ub,ub,ur,ub,ux,ug
ux,ux,ux,ux,ux,ux,ub,ux,ux,ub,ub,ub,ug,ub,ub,ub,ug,ub,ux,ur,ub,ug,ug
ux,ux,ux,ug,ug,ug,ug,ub,ux,ub,ug,ug,ug,ub,ub,ub,cb,ub,ub,ur,ug,ug,ur
ux,ux,ux,cg,ux,ux,ug,ug,ug,ug,ug,ug,ug,ug,ug,ug,ub,ug,ub,ur,ug,ux,ur
cg,ux,ux,ux,ux,ub,ug,ub,ub,ug,ub,ug,ug,ub,ux,ux,ux,ub,ub,ur,ug,ug,ur
ux,ux,ux,ux,ux,ub,ug,ub,ub,ub,ub,ub,ub,ug,ux,ux,ux,ub,ux,ur,ux,ug,ug
ux,ub,ub,ub,ub,ub,ug,ub,ub,ub,ub,ub,ub,ux,ux,ux,ux,ub,ux,ur,ug,ug,ug
cr,ux,ub,ub,ub,ub,ug,ug,ug,ug,ug,ug,ug,ug,ug,ug,ug,ug,ug,ur,ur,ur,ur
cg,cb,ub,ur,ur,ur,ur,ur,ur,ur,ur,ur,ur,ur,ux,ux,ux,ux,ux,ur,ux,cb,cr
cr,ur,ur,ur,ur,ur,ur,ur,ur,ur,ur,ur,ur,ur,ur,ur,ur,ur,ur,ur,cb,ux,cr