cb,cb,cb,cr,ur,ur,ur,ur,ur,ur,ur,ur,ur,ur,ur,ur,ur,ur,ur,ur,ur,ur,cb
ur,ur,cr,ub,ur,ur,ur,ur,ur,ur,ur,ur,ur,ur,ur,ur,ur,ur,ur,ur,ur,ur,ur
ur,ur,ur,ub,ux,ur,ur,ur,ur,ur,ur,ur,ur,ur,ur,ur,ur,ur,ur,ur,ur,ur,ur
ur,cr,ug,cb,ux,ur,ur,ur,ur,ur,ub,ub,ub,ub,ub,ub,ub,ub,cr,ur,ur,ur,ur
ur,ux,ug,ur,cg,ur,ur,cr,ug,ug,ug,ug,ur,ur,ur,ur,ug,ug,ur,ur,ur,ur,ur
ur,ur,ug,ur,ug,ur,ur,ur,ur,ur,ub,cg,ur,ur,ur,ur,ur,ur,ug,ur,ur,ur,ur
ur,ur,ug,ug,ug,ur,ur,ur,ur,ur,ub,ur,ur,ur,ur,ur,ur,ur,ug,ur,ux,ux,ub
cb,ub,cb,ur,ug,ug,cb,ub,ub,ub,ub,ur,ur,ur,ur,ur,ur,ug,ug,ux,ux,ub,ub
ur,ub,ub,ub,cg,ug,ux,ux,ux,ug,ub,ux,ub,ub,cr,ur,ug,ug,ub,ub,ub,ub,ux
ur,ur,ur,ub,ub,ub,ub,ug,ug,ug,ub,ub,ub,ub,ux,ug,ug,ug,ux,ux,ux,ux,ux
ub,ub,ub,ug,ug,ug,ub,ug,ug,ug,ub,ub,ub,ub,ub,cb,ug,ug,ux,ux,ux,ux,ux
ub,ub,ub,ug,ug,ug,ub,ug,ug,ug,ub,ub,ub,ub,ub,ug,ug,ug,ug,ux,ux,ux,ux
cb,ub,cb,ug,ug,ug,ub,ug,ux,ug,ub,ug,ug,ug,ug,ug,cg,ug,ug,ux,ux,ux,ux
ux,ub,ub,ug,ub,ub,ub,ug,ug,ug,ub,ug,ug,ug,ug,ug,ug,ug,ug,ux,ux,ux,ux
ub,ub,ub,ub,ub,ub,ub,ub,ub,ub,ub,ux,ug,ug,ug,ug,ub,ux,ux,ux,ux,ux,ux
ub,ub,ub,ub,ub,ub,ug,ux,ug,ux,ug,ux,ug,ug,ug,ub,ux,ux,ux,ux,ux,ux,ux
ux,ux,ux,ux,ug,ug,ug,ux,ux,ux,ug,ug,ug,ug,ub,ub,ux,ux,ux,ux,ux,ux,ux
cr,ug,ug,ug,ug,ug,ug,ux,ux,ux,ur,ux,ug,ub,ug,ux,ux,ux,ux,ux,ux,ux,ux
cg,ug,ug,ux,ug,ug,ug,cg,ux,ux,ur,ux,ug,ug,ug,ux,ux,ux,ux,ux,ux,ux,ux
cb,ux,ug,ug,ug,ug,ug,ug,ux,ux,ur,ux,ux,ub,ub,ux,ux,ux,ux,ux,ux,ux,ux
ug,ug,ug,ug,ug,ug,ug,ug,ug,ug,ur,ux,ub,ub,ub,ux,ux,ux,ux,ux,ux,ux,cr
cr,ug,ug,ug,ug,ug,ug,ug,ug,ug,ur,ur,ur,ur,ur,ur,ur,cb,cg,ux,cb,ux,cr
cg,cb,cg,cb,ux,ux,ux,ux,ux,ux,ux,ux,ux,ux,ux,cg,ur,ur,cr,cg,cg,ux,cr