ux,ux,ux,ux,ux,ur,ur,ur,ur,ux,ux,ux,ur,ur,ur,ur,ub,ub,ur,cb,ub,ur,ur
ux,ux,ur,ur,ur,ur,ur,ur,ur,ur,ur,ur,ur,ur,ur,cb,ub,ub,cr,ur,ub,ur,ur
ur,ux,ur,ug,cg,ur,ur,ur,ur,ur,ur,ux,ux,ur,ur,ur,ux,ur,ub,ub,ub,ur,ur
ur,ur,ur,ug,ur,ur,ur,ur,ur,ur,ur,ur,ur,ur,ur,ur,ur,ub,ub,ub,ub,ur,ur
ur,ur,cg,ug,ug,ur,ur,ur,ur,ur,ur,ur,ur,ur,ur,ur,ur,ub,ub,ur,ur,ur,ur
ux,cb,ur,ug,ug,ug,ur,ur,ur,ur,ur,ur,ur,ur,ur,ur,ur,ub,ub,ur,ur,ur,ur
ur,ub,ur,ug,ur,ug,ur,ur,ux,ur,ur,ur,ur,cr,ur,cg,ur,cr,ub,ux,ux,ux,ux
ur,ub,cr,ug,ur,ug,ur,ur,ur,ur,ur,ub,cb,ur,ur,ug,ub,ub,ub,ux,ux,ux,ux
ur,ub,ur,ur,ux,ug,ur,ur,ur,ur,ub,ub,ub,ug,cr,ug,ub,ug,ub,ux,ux,ux,ux
ur,ub,ur,ur,ur,ug,ur,ur,ur,ub,ub,ub,ub,ug,ug,ug,ug,ug,ux,ux,ux,ux,ux
ur,ub,ur,ur,ur,ug,ug,ug,ub,ub,ub,ub,ub,ug,ug,ug,ug,ug,ux,ux,ux,ux,ux
ur,ur,ur,ur,ur,ug,ug,ug,ug,ug,ug,ub,ub,ub,ux,ux,ug,ub,ux,ux,ux,ux,ux
ub,ub,ub,ur,ur,ug,ug,ug,ug,ug,ug,ug,ug,ub,ub,ug,ug,ub,ub,ux,ux,ux,ux
ub,ub,ub,ug,ux,ug,ug,ug,ub,ub,ub,cb,ub,ub,ub,ub,ux,ux,ux,ux,ux,ux,ux
ub,ug,ub,ug,ux,ug,ug,ug,ux,ux,ub,ub,ub,ub,ub,ub,ub,ub,ub,ux,ux,ux,ux
ub,ug,ub,ug,ug,ug,ug,ug,ux,ux,ub,ux,ux,ub,ub,ub,ub,ub,ub,ux,ux,ux,ux
ux,ug,ug,ux,ug,ug,ug,ug,ux,ux,ub,ux,ux,ub,ub,ub,ub,ub,ub,ux,ux,ux,ux
ux,ug,ug,ux,ug,ug,ug,ug,ux,ux,ux,ux,ub,ub,ub,ub,ub,ub,ur,ur,ux,ux,ux
ur,ug,ur,ur,ur,ur,ur,ug,ur,ur,ug,ug,ur,ug,ug,ub,ug,ug,ur,ur,ux,ux,ux
ur,ug,ug,ug,ug,ug,ug,ug,ug,ur,ur,ur,ur,ur,ur,ur,ur,ur,ur,ur,ux,ux,ux
ur,ur,ug,ux,ux,ux,ug,ug,ux,ur,ur,ug,ub,ug,ug,ug,ux,ur,ur,ug,ux,ux,ux
ur,ur,ur,ur,ur,ur,ur,ug,ur,ur,ur,ug,ug,ug,ug,ug,ug,ug,ur,ur,ur,cr,ux
ur,ur,ur,ur,ur,ur,ur,cg,ur,ur,ur,ug,ug,ug,ug,ux,ur,ur,ur,ur,ur,cb,ux