ux,cb,cb,cr,cb,ur,ur,ur,ur,ur,ur,ur,ur,ur,ur,ur,ur,ur,ur,ur,ur,ur,cb
ux,ux,cb,ux,ux,ur,ur,ur,ur,ur,ur,ur,ur,ur,ur,ur,ur,ur,ur,ur,ur,ur,ur
ux,ux,ux,ux,ux,ur,ux,ux,ux,ur,ur,ur,ur,ux,ur,ur,ur,ur,ur,ur,ur,ur,ur
ur,ur,ur,ur,ur,ur,ur,ur,ux,ur,ur,ur,ur,ur,ur,ur,ur,ur,ur,ur,ur,ur,ur
ur,ur,ur,ur,ur,ur,ur,ur,ur,ur,ur,ur,ur,cr,ug,ug,ug,cg,ur,ur,ur,ur,ur
ur,ur,ur,ur,ur,ur,ur,ur,ur,ur,ur,ur,ur,cr,ug,ug,cr,ug,ur,cb,cg,ur,ur
ur,ur,ur,ur,ur,ur,cb,ub,ur,ur,ur,ur,ur,ur,ur,ur,ur,ug,ub,ub,ug,ur,ur
cb,ur,ur,ur,ur,ur,ur,ub,ur,ug,ug,ug,ur,ur,ur,ur,ur,cg,ug,ug,cr,ur,ur
ur,ur,ux,ur,ur,ur,ur,ub,ur,ug,ur,ur,ur,ur,ur,ug,ug,ug,ug,ug,ug,ux,ux
ur,ur,ux,ur,ur,ur,ur,ub,ub,cr,ur,ur,ur,ub,ub,ug,ux,ug,ug,ug,ug,ux,ux
ur,ur,ub,ub,ur,ux,ux,ux,ug,ug,ux,ux,ug,ug,ub,ug,ux,ug,ug,ug,ug,ux,ux
ur,ug,ub,ub,ug,ug,ug,ug,ug,ug,ux,ux,ug,ug,ub,ug,ug,ug,ug,ug,ug,ub,cb
cb,ub,ub,ub,ub,ux,ux,ux,ux,ug,ux,ux,ug,ug,ub,ub,ub,ub,ub,ug,ug,ux,cg
ub,cb,ub,ub,ub,ub,ug,ux,cg,ug,ux,ux,ug,ug,ux,ux,ub,ub,ug,ug,ug,ub,ub
ub,ub,ub,ug,ug,ug,ug,ug,ug,ug,ux,ux,ug,ug,ux,ug,ub,ub,ux,ux,ub,ub,ub
ug,ub,ug,ug,ug,ug,ux,ug,ug,ug,ux,ux,ug,ug,ux,ug,ux,ux,ux,ux,ub,ug,cg
ug,ug,ug,ug,ug,ug,ug,ug,ug,ug,ug,ux,ux,ug,ub,ub,ug,ug,ug,ug,ug,ug,ub
ug,ug,ug,ug,ug,ug,ug,ug,ug,ug,ug,ug,ub,ub,ub,ur,ug,ur,ur,ur,ur,ur,ur
ux,ug,ug,ug,ug,ug,ug,ug,ux,ug,cr,ur,ur,ur,ur,ur,ur,ur,ur,ur,ur,ur,ur
cr,ug,ug,ug,ug,ug,ug,ug,ug,ug,ur,ur,ur,ug,ur,ur,ug,ur,ur,ur,ur,ur,ur
cg,ug,ug,ug,ug,ug,ug,ug,ug,ug,ux,ux,ux,ug,ug,ug,ug,ur,ur,ur,ur,ur,cr
cr,ug,ug,ug,ug,ug,ug,ug,ug,ug,ux,ux,ux,ur,ug,ug,ug,ug,ux,cb,cb,ur,cr
cg,ur,cg,cb,ug,ug,ug,ug,ug,ug,ur,ur,ur,ur,ux,cg,ug,ug,ux,cg,cg,cb,cr