ur,ur,ur,ur,ur,ur,ur,ur,ur,ur,ur,ur,ur,ur,ur,ur,ur,ur,ur,ur,ur,ub,ub
ur,ur,ur,ur,ur,ur,ur,ur,ur,ur,ur,ur,ur,ur,ur,ur,ur,ur,ur,ur,ub,ub,ub
ur,ur,ur,ur,ur,ur,ur,ur,ur,ur,ub,cr,ur,ur,ur,ur,ub,ub,ub,ub,ub,ub,ub
ux,ur,ur,ur,ur,ur,ur,ur,ur,ux,ur,ur,ux,ur,ur,ur,ux,ub,ub,ub,ub,ub,ub
ux,ur,ur,ur,ur,ur,ur,ur,ur,ur,ur,ur,ur,ur,ur,ur,ur,ub,ur,ur,ub,ub,ub
ux,ur,ur,ur,ur,cg,ur,ur,ur,cr,ur,ux,ux,ur,ur,ur,cb,cb,ur,ur,ub,ub,ub
ux,ur,ur,ur,ur,ur,ur,ur,ur,ur,ur,ur,ur,ur,ur,cr,ub,ub,ub,ub,ub,ub,ub
ux,ur,ur,ur,ur,ur,ur,ur,ur,ur,ur,ur,ur,ur,ur,ur,ub,ub,ub,ub,ub,ub,ub
cg,ub,ux,ur,ur,ur,ur,ur,ur,ur,cr,ur,ur,ur,ub,ur,ux,ur,ux,ux,ux,ux,ub
ux,ub,ux,ur,ur,ur,ur,ur,ur,ur,ug,ur,ub,ub,cb,ur,ux,ux,ux,ux,ux,ux,cb
ub,ub,ux,ur,ur,ur,ur,ur,ur,ur,ug,cg,cb,ur,ub,ub,ub,ux,ux,ux,ux,ux,ux
ub,ux,cr,ur,ur,ur,ur,ur,ur,ur,ug,ug,ub,ub,ub,ub,ub,ux,ux,ux,ux,ux,ux
ub,ux,cg,ur,ur,ur,ur,ur,ub,ub,ug,ug,ub,ub,ub,ub,ux,ux,ux,ux,ux,ux,ux
ub,ub,ug,ub,ug,ug,ur,ur,ub,ug,ug,ub,ub,ug,ub,ub,ub,ub,ub,ux,ux,ux,ux
cg,ub,ug,ub,ug,ug,ug,ug,ug,ug,ug,ub,ub,ug,ub,ux,ug,ug,ux,ux,ux,ux,ux
ux,ug,ug,ub,ug,ug,ub,ub,ug,ux,ux,ux,ub,ug,ub,ub,ub,ub,ub,ug,ux,ux,ux
ub,ug,ux,ub,ux,ub,ub,ux,ug,ux,ux,ux,ub,ub,ub,ub,ub,ub,ub,ux,ux,ux,ux
ub,ug,ur,ur,ur,ub,ub,ur,ug,ub,ub,ub,ub,ub,ug,ug,ug,ug,ur,ur,ur,ur,ur
ur,ug,ux,ub,ux,ub,ub,ux,ug,ur,ur,ur,ub,ur,ur,ur,ur,ur,ur,ur,ur,ur,ur
ur,ug,ug,ug,ug,ug,ug,ug,ug,ub,ub,ux,ub,ub,ur,ur,ur,ur,ur,ur,ur,ur,ur
ur,ux,ub,ub,ux,ux,ub,ub,ub,ux,ux,ux,ux,ur,ur,ux,ux,cr,ur,ur,ur,ur,ur
ur,ub,ub,ux,ux,ux,ub,ub,ub,ux,ux,ux,ux,ur,ur,ur,ur,ur,ur,ur,ur,ur,ur
ur,ur,ur,ur,ur,ur,ub,ub,cb,cg,ux,ux,ux,ur,ur,ur,ur,ur,ur,ur,ur,ur,ur