ur,ur,ur,ur,ur,ur,ur,ur,ur,ur,ur,ur,ur,ur,ur,ur,ur,cb,ur,ur,ur,ur,ur
ur,ur,ur,ur,ur,ur,ur,ur,ur,ur,ur,ur,ur,ur,ur,ur,ur,ur,ur,ur,ur,ur,ur
ur,ur,ur,ur,ur,ur,ur,ur,ur,ur,ur,ur,ur,ur,ur,ur,ur,ur,ur,ur,ur,ur,ur
ur,ur,ur,ur,ur,ur,ur,ur,ur,ur,ur,ur,ur,ur,ur,ur,ur,ur,ur,ur,ur,ur,ur
cb,ux,ur,ub,ub,ug,ug,ug,ur,ur,ur,ur,ur,ur,ur,ur,ur,ur,ur,ur,ur,ur,cr
ux,ux,ur,ub,ub,ug,ug,ur,ur,ur,ur,ur,ur,ur,ur,ur,ur,ur,ur,ur,ur,ur,cr
ux,ux,ur,ur,ug,ug,ug,cg,ug,ug,ug,ur,ur,ug,ux,ur,ur,ur,ur,ur,ur,ur,ub
ux,ux,ur,ur,ur,ub,ug,ug,cg,ur,cr,ub,ur,ug,ur,ur,ur,ur,ur,ur,ub,ub,ub
ux,ux,ux,ux,ur,ur,ur,ur,ur,ur,ur,ur,ur,cr,cr,ur,ur,ur,ur,ug,ug,ub,ub
ux,ux,ux,ux,ux,ux,ub,ug,ug,ug,ub,ub,ub,ub,ux,ub,ub,ug,ux,ug,ug,ux,ub
ux,ux,ux,ux,ux,ux,ub,ux,ug,ug,ug,ug,ub,ug,ug,ub,ub,ug,ux,ug,ux,ux,ub
ub,ub,ub,ub,ub,ub,ub,ub,ub,ub,ub,ub,ub,ub,ub,ub,ub,cb,ug,ug,ug,ub,ub
ub,ux,ux,ux,ux,ux,ub,ub,ub,ub,ug,ug,ub,ug,ug,ux,ub,ux,ux,ug,ug,ux,cg
ub,ux,ux,ux,ux,ub,ub,ub,ub,ub,ub,ub,ug,ug,cb,ub,ug,ug,ub,ub,ug,ug,ug
ub,ux,ux,ux,ux,ub,ub,ub,ub,ug,ug,ub,ug,ux,ub,ub,ug,ug,ug,ug,ug,ug,ug
ub,ux,ux,ux,ux,ub,ub,ub,ub,ub,ub,ub,ug,ub,ub,ub,ug,ug,ug,ug,ug,ug,ug
ub,ub,cb,ur,ur,ur,ur,ur,ur,ur,ur,cr,ug,ub,ub,ub,ub,ub,ug,ug,ug,ug,ug
cg,ux,ux,ux,ux,ux,ub,ux,ub,ux,ub,ub,ug,ug,ub,ug,ub,ub,ug,ug,ug,cg,ug
ux,ux,ux,ux,ux,ux,ub,ub,ub,ub,ub,ub,ur,ux,ub,ub,ub,ub,ug,ug,ug,cg,ug
ux,ux,ux,ux,ux,ux,ub,ub,ub,ub,ux,ux,ur,ux,ub,ub,ub,ub,ux,ux,ux,ux,ux
ux,ux,ux,ux,ux,ux,ub,ub,ub,ub,ux,ux,ur,ux,ux,ux,ux,ub,ux,ux,ux,ux,ux
cr,ux,ux,ux,ux,ux,ub,ub,cb,ub,ux,ux,ur,ux,ux,ux,ux,ub,ux,ux,ux,cb,cr
cg,ux,ux,ux,ux,ux,ub,ub,ub,ub,ur,ur,ur,cb,ux,ux,ux,ux,ux,cg,cb,ux,cr