ub,ub,ur,ur,ur,ur,ur,ur,ur,ur,ur,ur,ur,ur,ur,ur,ur,ur,ur,ur,cb,ur,ur
cb,ub,ub,cr,ur,ur,ur,ur,ur,ur,ur,ur,ur,ur,ur,ur,ur,ur,ur,ur,ub,ur,ur
ur,ur,ur,ur,ur,ur,ur,ur,ur,ur,ur,ur,ur,ur,ur,ur,ur,ur,ur,ub,ub,cr,ur
ux,ur,ur,ug,ug,ug,ur,ur,ur,ur,ur,ug,ug,ub,ug,ur,ug,ug,ux,ub,ub,cr,ur
ux,ur,ur,ug,ug,ug,ur,ur,ur,ur,ug,ug,ur,ub,ub,ub,ub,ux,ux,ub,ug,ug,ur
ur,ur,ur,ug,ur,ug,ug,ug,ug,ug,ug,ug,ug,ug,ug,ug,ub,ur,ur,ub,ug,ur,ur
ur,ur,ur,ug,ug,ug,ug,ug,ug,ug,ub,ub,ub,ug,ur,ug,ug,ur,ur,ug,ug,ur,ur
ux,ux,ux,ug,ux,ux,ug,ug,ur,ug,ug,ug,ug,ug,ur,ur,ug,ug,ug,ug,ur,ur,ur
cg,ux,cr,ug,ux,ux,ur,ug,ur,ug,ub,ub,ug,ug,ur,ur,ur,ur,ur,ur,ur,ur,ur
ub,ub,ur,cg,ub,ub,ub,ug,cg,ug,ub,ub,ub,ur,ur,ur,ur,ur,ur,ur,ux,ux,ux
ub,cb,ur,ub,ub,ub,ub,ug,ur,ub,cb,cb,ub,ur,ur,ur,ur,ur,cr,ux,ux,ux,ux
ux,ux,ub,ub,ub,ub,ub,ug,ur,ub,ub,ub,ub,ur,ur,ur,ur,ur,ug,ug,ug,ux,ux
ux,ub,ub,ub,ub,ux,cg,ug,ur,ub,ub,ub,ub,ub,ub,ug,ug,ug,ug,ug,ug,ux,ux
ux,ux,cb,ub,ux,ux,ug,ug,ur,ux,ux,ub,ug,ux,ub,ug,ug,ug,ug,ug,ux,ux,ux
cg,ux,ux,ux,ux,ux,ug,ug,ur,ux,ux,ux,ug,ux,ug,ug,ug,ux,ux,ug,ux,ux,ux
ux,ux,ux,ux,ux,ux,ug,ug,ur,ux,ux,ux,ug,ug,ug,ug,ug,ug,ug,ug,ux,ux,ux
ux,ux,ux,ux,ux,ux,ug,ug,ur,ux,ux,ux,ux,ux,ux,ux,ux,ux,ux,ux,ux,ux,ux
ux,ux,ux,ux,ux,ux,ug,ug,ur,ux,ux,ux,ux,ux,ux,ux,ux,ux,ux,ux,ux,ux,ux
ux,ux,ux,ux,ux,ux,ux,ux,ur,ux,ux,ux,ux,ux,ux,ux,ux,ux,ux,ux,ux,ux,ux
ux,ux,ux,ux,ux,ux,ux,ux,ur,ux,ux,ux,ux,ux,ux,ux,ux,ux,ux,ux,ux,ux,ux
ux,ux,ux,ux,ux,ux,ux,ux,ur,ux,ux,ux,ux,ux,ux,ux,ux,ux,ux,ux,ux,ux,ux
ux,ux,ux,ux,ux,ux,ux,ux,ur,ux,ux,ux,ux,ux,ux,ux,ux,ux,ux,ux,ux,ux,cb
ux,ux,ux,ug,ug,ug,ug,cr,ur,cg,ux,ux,ux,ux,ux,ux,ux,ux,ux,ux,ux,ux,ux