ur,ur,ur,ur,ur,ur,ur,ur,cr,cr,ug,ug,ug,ug,ug,ug,ur,cb,ur,ur,ur,ur,ur
ur,ur,ur,ur,ur,ur,ur,cr,ur,ub,ux,ux,ux,ux,ug,ug,cg,ur,ur,ur,ur,ur,ur
ur,ur,ur,ur,ur,ur,ur,ur,ur,ub,cb,ur,ur,ur,ur,ur,ur,ur,ur,ur,ur,ur,ub
ur,ur,ur,ur,ur,ur,ur,ug,ug,ur,ur,ur,ur,ur,ur,ur,ur,ur,ur,ur,ur,ur,ub
cb,ur,ur,ub,ub,ug,ug,ug,ur,ur,ur,ur,ur,ur,ur,ur,ur,ur,ur,ur,ur,ur,ub
ux,ur,ur,ub,ub,ug,cg,ur,ur,ur,ur,ur,ur,ur,ur,ur,ur,ur,ur,ur,ur,ur,cr
ur,ur,ur,ur,ug,ug,ur,ur,ur,ug,ug,ub,ur,ur,ur,ur,ur,ur,ur,ur,ur,ub,ub
ur,ur,ur,ur,ur,ub,ur,ug,ug,ug,ug,cr,ur,ur,ur,ur,ub,ub,ub,ub,ub,ub,ub
ux,ux,ug,ug,ur,ur,ur,ug,ug,ug,ug,ug,ub,ug,ux,ug,ub,ub,ug,ug,ug,ub,cb
ux,ux,ux,ug,ux,ub,ub,ug,ug,ug,ug,ug,ub,ux,ux,ug,ub,ug,ub,ug,ug,ub,ur
ux,ux,ux,ug,ux,ub,ub,ub,ug,ug,ug,ug,ub,ux,ug,ug,ub,ug,ux,ug,ux,ux,ur
ux,ux,ux,ug,ug,ug,ub,ub,ug,ug,ug,ug,ub,ug,ug,ug,cr,ur,ur,ur,ur,ur,ur
ux,ux,ux,ux,ux,ux,ub,ub,ug,ug,ug,ug,ub,ug,ug,ux,ub,ux,ux,ug,ux,ux,cg
ux,ux,ux,ux,ux,ub,ub,ub,ug,ug,cg,ux,ub,ux,ux,ux,ug,ug,ug,ug,ux,ux,ux
ux,ux,ux,ux,ux,ub,ub,ub,ug,ug,ug,ub,ub,ug,ug,ug,ug,ux,ub,cb,ux,ux,ux
ux,ux,ux,ux,ux,ub,ub,ub,ug,ub,ub,ub,ub,ub,ux,ug,ug,ux,ub,ub,ub,ub,ub
ux,ux,ux,ux,ux,ux,ub,ux,ug,ub,ub,ub,ub,cb,ux,ug,ug,ux,ug,ug,ux,ub,ub
cg,ux,ux,ux,ux,ux,ub,ux,ux,ug,ub,ub,ur,ug,ug,ug,ug,ub,ug,ug,ux,ub,ub
ux,ux,ux,ux,ux,ux,ub,ux,ux,ub,ub,ub,ur,ux,ux,ux,ug,ug,cg,ub,ub,ub,ub
ux,ux,ux,ux,ux,ux,ub,ux,ux,ub,ux,ux,ur,ux,ux,ux,ux,ux,ux,ux,ux,ux,ux
ux,ux,ux,ux,ux,ux,ub,ux,ux,ub,ux,ux,ur,ux,ux,ux,ux,ux,ux,ux,ux,ux,ux
cr,ux,ux,ux,ux,ux,ub,ux,ux,ub,ux,ux,ur,ux,ux,ux,ux,ux,ux,ux,ux,cb,cr
cg,ux,ux,ux,ux,ux,ub,ub,ub,ub,ur,ur,ur,cb,ux,ux,ux,ux,ux,cg,cb,ux,cr