ur,ur,ur,ur,ub,ub,ur,ur,ur,ur,ur,ur,ur,ur,ur,ur,ur,ur,ur,cr,ug,ub,ub
ur,ur,ur,ur,ur,ub,ub,ur,ur,ub,ub,ub,ub,ur,ur,ur,ur,ux,ux,ux,ub,ub,ub
ur,ur,ur,ur,ur,ub,ur,ur,ur,ur,ur,ur,ub,ub,ub,ub,ub,ub,ub,ub,ub,ux,ub
ur,ur,ur,ur,ur,ub,ub,ur,ur,ur,ur,ur,ur,ur,ur,ur,ux,ux,ux,ux,ux,ub,ub
ur,ur,ur,ur,ur,ur,ub,ur,ur,ug,cg,ur,ur,ur,ug,ug,ur,ux,ux,ub,ub,ub,ug
ur,ur,ur,ur,ur,ur,ub,ub,cb,cb,ur,ur,ur,ur,cr,ug,ug,ux,ux,ub,ux,ux,cr
ur,ur,ur,ur,ur,ur,ur,ur,ur,ub,ub,ub,ub,cb,ur,ug,ug,ur,ur,ub,ub,ub,ur
ur,cr,ug,ug,ur,ur,ur,ur,ub,ub,ub,ug,ub,ub,ub,ub,ub,ur,ur,ur,ux,ub,ur
cg,ur,ur,ug,ur,ur,ur,ur,ub,ub,ub,ur,ur,ub,ur,ur,ug,ur,ur,ug,ub,ub,ur
ur,ur,ur,ug,ur,ur,ur,ur,ub,ug,ub,ub,ub,ub,ur,ug,ug,cb,ub,ug,ub,ub,ur
ur,ur,ur,ug,cr,cg,ur,ub,ub,ug,ub,ux,ub,ug,ug,ug,ug,ux,ub,ug,ub,ub,ur
ur,ur,ur,ug,ur,ug,ub,ub,ub,ub,ub,ub,ur,ur,ur,ur,ur,ur,ub,ub,ub,ur,ur
ur,ur,ur,cg,ur,ug,ub,ub,ub,ug,ub,ub,cb,ub,ub,ub,ub,ub,ub,ub,ub,ub,cb
ux,ux,ub,cr,ub,ux,ub,ub,ub,ub,ub,ub,ub,ug,ux,ux,ux,ug,ux,ug,ux,ug,ub
cg,ux,ux,ux,ur,ux,ub,ub,ub,ub,ub,ub,ub,ub,ub,ub,ux,ug,ux,ug,ux,ug,ub
ux,ux,ux,ux,ur,ux,ux,ux,ur,ub,ub,ux,ux,ug,ux,ub,ux,ug,ug,ug,ux,ug,ub
ux,ux,ux,ux,ur,ux,ux,ux,ur,ux,ub,ux,ux,ug,ux,ux,ux,ux,ux,ux,ux,ug,ub
ux,ux,ux,ux,ur,ux,ux,ux,ur,ux,ux,ux,ux,ug,ux,ux,ux,ux,ux,ux,ux,ug,ub
ux,ux,ux,ux,ur,ux,ux,ux,ur,ux,ux,ux,ux,ug,ux,ux,ux,ub,ub,ux,ux,ug,ub
ux,ux,ux,ux,ur,ux,ux,ux,ur,ux,ux,ux,ux,ug,ux,ux,ux,ug,ug,ug,ug,ug,ub
ux,ux,ux,ux,ur,ux,ux,ux,ur,ux,ux,ux,ux,ug,ug,ug,ug,ug,ux,ub,ub,ux,ub
ux,ux,ux,ux,ur,ux,ux,ux,ur,ux,ux,ux,ux,ux,ux,ux,ux,ux,ux,ux,ub,ub,ub
ux,ux,ux,ux,ur,ur,ur,ur,ur,cg,ux,ux,ux,ux,ux,ux,ux,ux,ux,ux,ux,ub,ub