cb,cb,cb,cr,ur,ur,ur,ur,ur,ur,ur,ur,ux,ur,ur,ur,ur,ux,ux,ux,ux,ux,cb
ur,ur,ur,ur,ur,ur,ur,ur,ur,ur,ur,ur,ur,ur,ur,ur,ur,ux,ux,ux,ux,ux,ux
ur,ur,ur,ur,ur,ur,ur,ur,ur,ur,ur,ur,ur,ur,ur,ur,ur,ur,ur,ur,ux,ux,ux
ur,ur,ur,ur,ur,ur,ur,ur,ur,ur,ur,ur,ur,ur,ur,ur,ur,ur,ur,ur,ur,ur,ur
ur,ur,cr,ub,cb,ur,ug,ur,ur,ur,ur,ur,ur,ur,ur,ur,ur,ur,ug,ur,ux,ux,ur
ur,ur,ur,ub,ub,ur,ur,ur,ur,ur,ur,ur,ur,ur,cr,ur,ur,cg,ug,ur,cb,ur,ur
ur,ur,ur,cb,ub,ur,ur,cr,ur,ur,ur,ur,ur,ur,ur,ug,ug,ug,ur,ur,ub,ur,ur
cb,cr,ur,ur,cr,ur,cg,ug,ur,ur,ur,ur,ur,ug,ug,ug,ug,ug,ug,ux,ub,ux,ug
ur,ug,ug,ub,ub,ur,ur,ur,ur,ur,ur,ur,ur,ur,ug,ug,cr,ux,ux,ux,ub,ux,ug
ur,ug,cb,ub,ub,ug,ug,cg,ur,ur,ur,ub,ub,ub,ub,ub,ur,ux,ux,ub,ub,ug,ug
ub,ug,ub,ub,ub,ug,ub,ug,ub,ux,ub,ub,ub,ub,ub,ub,ur,ug,ux,ub,ux,ug,ux
ub,ug,ub,ug,ug,ug,ub,ub,ub,ux,ub,ub,ub,ub,ub,ub,ur,ug,ug,ub,ux,ug,ux
cb,ug,ug,ug,ug,ug,ug,ug,ux,ux,ub,ux,ub,ub,ub,ub,ur,ub,ug,ub,ux,ug,ux
ux,ug,ug,ug,ug,ug,ug,ug,ux,ux,ub,ux,cb,ug,ub,ub,ur,ug,ug,ub,ux,ug,ux
ub,ug,ug,ug,ug,ug,ug,ug,ub,ub,ub,ux,ux,ux,ug,ug,ur,ux,ux,ub,ug,ug,ux
ug,ug,ug,ug,ug,ug,ug,ug,ux,ux,ux,ux,ux,ux,ug,ux,ur,ux,ub,ub,ux,ux,ux
ug,ug,ug,ug,ug,ug,ux,ub,ux,ux,ux,ux,ux,ux,ux,ux,ur,ux,ub,ug,ux,ux,ux
cr,ug,ug,ug,ug,ug,ux,ub,ux,ux,ux,ux,ux,ux,ux,ux,ur,ux,ub,ug,ub,ub,ub
cg,ug,ug,ux,ug,ug,cg,ub,ub,ub,ub,ub,ub,ub,ub,ub,ur,ub,ub,ug,ub,ub,ub
cb,ux,ug,ug,ug,ug,ug,ug,ux,ux,ux,ux,ux,ux,ux,ux,ur,ux,ux,ug,ux,ux,ux
ug,ug,ug,ug,ug,ug,ug,ug,ug,ug,cg,ug,ug,ug,ug,ug,ug,ug,ug,ug,ux,ux,cr
cr,ug,ug,ug,ug,ug,ug,ug,ug,ug,ux,ux,ux,ux,ux,ux,ur,cb,cg,ux,cb,ux,cr
cg,cb,cg,cb,ux,ux,ux,ux,ux,ux,ux,ux,ux,ux,ux,cg,ur,ur,ur,cg,cg,ux,cr