cb,ur,ur,ur,ur,ur,ur,ur,ur,ur,ur,ur,ur,ur,ur,ur,ur,ur,ur,ur,ur,ur,ur
ur,ur,cr,ub,ur,ur,ur,ug,ur,ur,ux,ur,ur,ur,ur,ur,ur,ur,ur,ur,ur,ur,ur
ur,ur,cr,ub,ur,ur,ur,ug,ur,ur,ur,ur,ux,ux,ux,ur,ur,ur,ur,ux,ur,ur,ur
ur,ur,ub,ub,ub,ub,ub,cb,ug,ur,ur,ur,ur,ur,ur,ur,ur,ur,ux,ux,ur,ur,ur
ur,ur,ur,ur,ur,ur,ur,ur,ug,ug,ur,ur,ur,ur,ur,ur,ur,ur,ur,ur,ur,ur,ur
ur,ur,ur,ur,ur,ur,ur,ur,ur,ug,ur,ur,ur,ur,ur,ur,ur,ur,ur,ur,ur,ur,ur
ur,ur,ur,ur,ur,ur,ur,ur,ur,ug,ur,ur,ur,ur,ur,ur,cg,ug,ur,ur,ur,ub,ub
ur,ur,ur,ug,ug,cr,ur,ur,ur,ug,ur,ur,ur,ur,ur,ur,ur,ug,ux,ux,ub,ub,ub
cg,ur,ur,ug,ur,ur,ur,ur,ux,ug,ub,ub,ub,ub,ug,cr,ur,ug,ug,ux,ub,ub,ub
ur,ur,ur,ug,ur,ur,ur,ur,ub,ug,ub,ub,ub,ub,ug,ub,ug,ug,ug,ux,ub,ub,ub
ur,ur,ur,ug,ug,ur,ur,ur,ug,ug,ug,ub,ub,ub,ug,ug,ug,ug,ug,ug,ub,ub,ub
ur,ur,ur,ur,cg,ug,ub,ux,ug,ub,ug,ub,ub,ug,ug,ug,ug,ug,ug,ug,ub,ub,ub
ur,cr,ug,ux,ux,ug,ub,ub,ug,ug,ug,ub,ub,cb,ug,ug,ug,ug,ug,ug,ub,ux,ub
ux,ux,ug,ux,ux,ug,ub,cb,ub,ub,ux,ux,ub,ub,ug,ub,ub,ub,ub,ux,ub,ux,ub
cg,ux,ug,ux,ux,ug,ub,ub,ub,ub,ub,ub,ub,ub,ub,ub,ub,ub,ub,ux,ub,ub,ub
ug,ug,ug,ug,ug,ug,ug,ug,ug,ug,ug,ug,ug,ug,ub,ub,ub,ub,ub,ub,ug,ug,ug
ug,ux,ug,ux,ux,ug,ux,ux,ux,ux,ux,ux,ux,ux,ub,ub,ub,ub,ub,ub,cb,ux,ur
ug,ux,ug,ux,ux,ug,ux,ux,ux,ux,ux,ux,ux,ux,ub,ub,ub,ub,ub,ub,ux,ux,ur
ug,ux,ug,ux,ux,ug,ux,ux,ux,ux,ux,ux,ux,ux,ux,ub,ub,ub,ux,ux,ux,ux,ur
ug,ux,ug,ux,ux,ug,ux,ux,ux,ux,ux,ux,ux,ux,ux,ux,ux,ub,ux,ux,ux,ux,ur
ub,ub,ug,ug,ug,ug,ug,ug,ug,ug,ug,ug,ug,cg,ur,ur,ur,ub,ur,ur,ur,ur,ur
ub,ux,ux,ux,ux,ux,ux,ux,ub,ub,ub,ub,ub,ub,ub,ub,ub,ub,ub,cb,ur,ur,ur
ub,ub,ub,ub,ub,ub,ub,ub,ub,cg,ub,ub,ub,ub,ub,ub,ub,ub,ub,ub,cr,ur,ur