ur,ur,ur,ur,ur,ur,ur,ur,ur,ur,ur,ur,ur,ux,ux,ux,ur,ur,ur,ur,ur,ur,ur
ur,ur,ur,ur,ur,ur,ur,ur,ur,ur,ur,ur,ur,ur,ur,ur,ur,ur,ur,ur,ur,ur,ur
ur,ur,ur,ur,ur,ur,ur,ur,ur,ur,ur,ur,ur,ur,ur,ur,ur,ur,ur,ur,ur,ur,ur
ux,cb,ur,cr,ur,ur,ur,ur,ur,ur,ur,ur,ur,ur,ur,ur,ur,ur,ur,ur,ur,ur,ur
ur,ub,ur,ug,ur,ur,ur,ur,ur,ur,ur,ur,ur,ur,cb,ur,ur,ur,ur,ur,ur,ur,ur
ur,ub,ur,ug,ur,ur,ur,ur,ur,ur,ur,ur,ur,ur,ub,ub,ub,ur,ur,ur,ur,ur,ur
ur,ub,ur,ug,ur,ur,ug,cr,ur,ur,ur,ur,cr,cr,ug,ug,ub,ur,ur,ur,ur,cr,ur
ur,ub,ur,ug,ug,ug,ug,ur,ur,ur,ug,ug,ug,cb,ub,ug,ub,ub,ub,ub,ub,ub,cb
cg,ub,ur,ur,ur,ug,cg,ur,ur,ug,ug,ug,ug,ur,ub,ub,ub,ur,ur,ur,ur,ur,ur
ur,ub,ur,ub,ux,cg,ux,ux,ur,ug,ug,ug,ug,ur,ub,ub,ux,ur,ur,ur,ur,ur,ur
ub,ub,ur,ub,ux,ux,ux,ur,ur,ux,ug,ug,ux,ub,ub,ub,ub,ux,ux,ux,ur,ub,ub
ub,ur,ur,ub,ur,ur,ur,ur,ub,ub,ug,ug,ub,ub,ub,ub,ub,ux,ux,ux,ur,ux,ub
ub,ur,ur,ub,ur,ur,ur,ur,ub,ub,ug,ug,ug,ug,ub,ub,ux,ux,ux,ux,ur,ux,ub
ub,ub,ur,ub,ur,ur,ur,ur,ub,ux,ug,ug,ug,cb,ub,ub,ub,ub,ub,ux,ur,ux,ub
cg,ub,ur,ub,ur,ur,ux,ux,ux,ux,ug,ug,ub,ub,ub,ug,ug,ug,ug,ug,ur,ub,ub
ux,ub,ux,ub,ux,ux,ux,ux,ux,ux,ub,ub,ub,ub,ub,ub,ub,ug,ug,ug,ur,ux,ur
ub,ub,ux,ub,ux,ux,ux,ux,ux,ux,ub,ub,ub,ug,ug,ug,ub,ug,ug,ux,ur,ur,ur
ub,ub,ur,ur,ur,ur,ur,ur,ur,ub,ub,ub,ub,ub,ug,ug,cg,ug,ur,ur,ur,ur,ur
ur,ub,ux,ub,ux,ux,cb,ux,ur,ur,cr,ux,ub,ub,ub,ub,ub,ub,ug,ub,ub,ux,ur
ur,ux,ux,ub,ux,ux,ub,ub,ur,ub,ub,ux,ub,ub,ub,ub,ub,ux,ux,ux,ux,ux,ur
ur,ux,ub,ub,ux,ux,ub,ub,ur,ux,ux,ux,ux,ur,ux,ux,ub,ub,ub,ux,ux,ux,ur
ur,ub,ub,ux,ux,ux,ux,ux,ur,ux,ux,ux,ux,ur,ux,ux,ux,ux,ux,ux,ux,ux,ur
ur,ur,ur,ur,ur,ur,ur,ur,ur,cg,ux,ux,ux,ur,ur,ur,ur,ur,ur,ur,ur,ur,ur