ux,ux,ur,ur,ur,ur,ur,ur,ur,ur,ur,ur,ur,ur,ur,ur,ur,ur,ur,ur,ur,ur,ur
ux,ux,ux,ur,ur,ur,ur,ur,ur,ur,ur,ur,ur,ur,ur,ur,cg,ur,ur,ur,ur,ur,ur
ux,ux,ur,ur,ur,ug,ug,ug,ur,ur,ux,ur,ub,ub,cr,ur,ug,ur,ur,ur,ur,ur,ur
ur,ur,ur,ur,ur,ur,ur,ug,ur,ur,cr,ur,cb,ur,ur,ur,cr,ur,ur,cr,ur,ur,ur
ur,ur,ur,ur,ug,ur,ux,ug,ur,ur,ur,ur,ur,ur,ur,ur,ur,ur,ur,ur,ur,ur,ur
ur,ur,ur,ur,ur,ug,cg,ug,ug,ug,ug,ug,ug,ug,ur,ur,ux,ur,ur,ur,ur,ur,ur
ur,ur,ur,ur,ur,ur,ur,ur,ur,ur,ur,ur,ur,ur,ux,ux,ux,ur,ur,ur,ur,ur,ur
ur,ur,ur,ur,ur,ur,ur,ur,ur,ur,ur,ur,ur,ur,ur,ur,ur,ur,ur,ur,ur,ur,cb
cg,ux,ux,cr,ur,ur,ur,ur,ug,ug,cg,ur,ur,ug,ug,ur,ur,ur,ur,ur,ur,ur,ur
ux,ux,ux,ur,ur,ur,ur,ur,ug,ug,ug,ug,ug,ug,ug,ur,ur,ur,ur,ur,ux,ur,ur
ux,ux,ux,ur,ur,ur,ur,ux,ug,ub,ug,ug,ug,ug,ug,ux,ux,ux,ux,ub,ub,ur,ur
ux,ux,ux,ux,ux,ug,ug,ux,ub,ub,ub,ub,ub,ug,ug,ux,ux,ux,ux,ub,ub,ur,cr
ux,ux,ux,ux,ux,ug,ug,ux,ub,ub,ub,ub,ub,ug,ug,ub,ux,ux,ux,ub,ub,ur,ug
ur,ur,ur,ur,ux,ur,ur,ur,ur,ux,ub,ub,ub,ub,ub,ub,ux,ub,ub,ub,ux,ur,ug
cg,ur,ur,ur,ur,ur,ux,ux,ug,ug,ug,ub,cb,ug,ub,ub,ub,ub,ux,ux,ux,ur,ug
ux,ux,ux,ux,ux,ux,ux,ux,ug,ub,ub,ub,ub,ub,ub,ub,ub,ub,ux,ux,ux,ur,ug
ux,ux,ux,ux,ux,ux,ux,ux,ug,ub,ub,ub,ub,ub,ub,ub,ub,ub,ub,ub,ub,ub,ub
ux,ux,ux,ux,ux,ux,ux,ux,ux,ux,ub,ub,ub,cb,ub,ub,ub,ub,cb,ub,ub,ur,ub
ux,ux,ux,ux,ux,ux,ux,ux,ux,ux,ub,ub,ub,ug,ub,ub,ub,ub,ub,ub,ub,ur,ub
ux,ux,ux,ux,ux,ux,ux,ux,ub,ub,ub,ub,ux,ub,cb,ub,ub,ub,ub,ub,ub,ub,ub
ux,ux,ux,ux,ux,ux,ux,ux,ux,ub,ub,ub,ub,ub,ub,ub,ub,ub,ub,ub,ub,ub,ub
ux,ux,ux,ux,ux,ux,ux,ux,ub,ub,ub,ub,ur,ub,ub,ur,ub,ub,ub,ub,ur,ub,ub
ux,ux,ux,ux,ux,ux,ux,ux,ux,cg,ux,ux,ur,ub,ub,ub,ub,ub,ub,ub,ub,ub,ub