ur,ur,cb,cr,ur,ur,ur,ur,ur,ur,ur,ur,ur,ur,ur,cr,ur,ur,ur,cg,ux,ur,ur
ur,ub,ub,ur,ur,ur,ur,ur,ur,ur,ur,ur,ux,ux,ux,ux,ur,ur,ur,ux,ux,ur,ur
ur,ub,ub,ub,cb,ur,cr,ur,ur,ur,ur,ur,ur,ur,ur,ur,ur,ur,ur,ur,ux,ur,ur
ur,ub,ub,ub,ug,ur,cr,ug,ug,ug,cg,ux,ur,ur,ur,ur,ur,ur,ur,ur,ur,ur,cr
ur,ur,ub,ub,ug,ur,ur,ur,ug,ur,ur,ug,ur,ur,ur,ur,ur,ur,ur,ur,ur,ur,ug
ur,ur,ur,ug,ur,ur,ur,ur,ur,ur,ug,ur,ur,ur,ur,ur,ur,ur,ur,ur,ur,ur,ug
ur,ur,ur,ug,ug,ur,ur,ur,ur,ug,ug,ur,ur,ur,cr,ur,ur,ug,ur,ur,ur,ux,ug
ur,ur,ur,ur,ur,ur,ux,ur,ur,ug,ug,ug,ur,ur,ur,ur,ur,ug,ub,ub,ub,ub,ug
ur,ur,ur,ur,ur,ur,ur,ur,ur,ug,ug,ug,ub,ub,cg,ug,ug,ug,ub,ux,ur,ub,ug
ur,ur,ur,ur,ur,ur,ur,ur,ur,ug,ug,ug,ub,ub,ub,ug,ug,ug,ub,ux,ur,ub,ub
ux,ub,ux,ux,ux,ug,ug,ug,ug,ug,ug,ub,ub,ub,ux,ux,ug,ug,ub,cb,ub,ux,ub
ux,ub,ux,cg,cb,ub,ub,ub,ug,ug,ub,ub,ub,ub,ux,ux,ub,ug,ug,ub,ub,ub,ub
cg,ub,ub,ug,ug,ug,ug,ub,ug,ug,ub,ug,ub,ub,ub,ub,ug,ug,ub,ub,ur,ub,ug
ux,ux,ux,ug,ug,ug,ug,ub,ug,ux,ub,ub,cb,ug,ux,ux,ug,ux,ub,ub,ur,ux,ug
ub,ub,ub,ug,ub,ub,ub,ub,ug,ux,ug,ug,ub,ug,ux,ux,ug,ug,ux,ux,ur,ux,ug
ub,ub,ub,ug,ug,ug,ug,ug,ug,ub,ub,ub,ub,ug,ub,cb,ug,ug,ux,ux,ur,ux,ug
ux,ux,ux,ux,ug,ug,ug,ux,ug,ug,ux,ug,ub,ub,ub,ux,ux,ux,ux,ux,ur,ux,ug
cg,ux,cg,ug,ug,ug,ug,ug,ug,ug,ug,ug,ux,ux,ub,ux,ux,ux,ux,ux,ur,ux,ug
ux,ux,ux,ux,ug,ub,ub,ub,ub,ub,ub,ub,ub,ub,ub,ux,ux,ux,ux,ux,ur,ux,ug
ux,ux,ux,ug,ug,ug,ug,ub,ub,ug,ug,ug,ug,ug,ub,ux,ux,ux,ub,ub,ur,ux,ug
cr,ux,ux,ug,ux,ug,ug,ub,ub,ub,ug,ug,ug,ug,ug,ug,ug,ug,ug,ug,ug,ug,ug
cg,cb,ux,ug,ub,ug,ug,ub,ux,ub,ux,ux,ub,ux,ug,ux,ux,ux,ub,ur,ux,cb,cr
cr,ux,ux,ug,ug,ug,ug,ug,ug,ug,ug,ug,ug,ug,ug,ub,ub,ub,ub,ux,cb,ux,cr