ur,ur,cb,ub,ub,cb,ur,ur,ur,ur,ur,ur,ur,ur,ur,ur,ur,cb,ux,cg,ug,ug,ug
ur,ur,ur,cr,cr,ur,ur,ur,ur,ur,ur,ur,ur,ur,ub,cb,ur,ur,ur,ug,ux,ux,ug
ur,ur,ur,ur,ur,ur,ur,ur,ur,ur,ux,ur,ur,ur,ur,ub,ur,ur,ur,ug,ux,ux,ug
ur,ur,ur,ur,ur,ur,ur,ur,ur,ur,ur,ur,ur,ur,ur,ub,ux,ur,ux,ug,ux,ux,ug
ur,ur,ur,ur,ur,ur,ur,ur,ur,ur,ur,ur,ur,ur,ub,ub,ub,ub,ug,ug,ug,ug,ug
ur,ur,ur,ux,ur,ur,ur,ur,ur,ur,ur,ur,ur,ur,ub,ug,ub,ub,ug,ug,ug,ug,ug
ur,ur,cr,cr,ur,ug,ug,ug,cg,ur,ur,cr,ug,ur,ub,ub,ub,ub,ub,ug,ug,ug,ug
ur,ur,ur,ux,ur,ur,ur,ur,ub,ub,cg,ug,ug,ur,ur,ug,ub,ub,ux,ug,ug,ug,ug
ur,ur,ux,ur,ur,ur,ug,ur,ub,ur,ug,ug,ub,ub,ub,ub,ub,ug,ug,ug,ug,ug,ug
ur,ur,ur,ur,ur,ur,ug,ug,ub,ur,ug,ug,ub,ub,ub,ub,ux,ug,ug,ug,ug,ug,ug
ur,ur,ur,ur,ur,ur,ur,ub,ub,ur,cb,ug,ux,ux,ux,ug,ug,ug,ug,cg,ux,ug,ug
ur,ur,ur,ur,ur,ur,ur,ub,ub,ub,ub,ug,ub,ub,ub,ug,ub,ug,ug,ug,ug,ug,ug
cg,ux,ux,ux,ux,ug,ug,ux,ux,ux,ub,ug,ub,ub,ub,ug,ub,ug,ug,ux,ug,ug,ug
ub,ub,ub,ub,ub,ub,ub,ub,cb,ug,ug,ug,ub,ub,ub,ug,ug,ug,ux,ux,ug,ug,ug
ub,ub,ur,ur,ur,ur,ur,ur,ur,ug,ug,ug,ug,ug,ug,ug,ug,ur,ur,ur,ug,ug,ug
ub,ub,ux,ux,ux,ug,ug,ux,ux,ug,ug,ug,ug,ug,ub,ux,ug,ug,ug,ug,ug,ug,ug
ub,ub,ub,ub,ub,ub,ub,ur,ur,ug,ug,ug,ug,ug,ur,ur,ur,ur,ur,ur,ur,ur,ur
cg,ux,ux,ux,ux,ug,ub,ub,ub,ub,ug,ux,ug,cg,ux,ug,ux,ug,ux,ux,ux,ug,ur
ux,ux,ux,ux,ux,ug,ub,ub,ub,ub,ug,ux,ug,ug,ug,ug,ug,ug,ug,ug,ug,ug,ur
ux,ux,ux,ub,ub,ub,ub,ub,ub,ub,ux,ux,ux,ux,ux,ux,ux,ux,ux,ux,ux,ug,ur
ur,ux,ux,ub,ub,ub,ub,ub,ub,ub,ug,ug,cr,ur,ur,ur,ur,ur,ur,ur,ur,ur,ur
cr,ux,ux,ub,ub,ub,ub,ub,ub,ub,ux,ux,ux,ux,ux,ux,ux,ux,ux,ux,ux,cb,cr
cg,ux,ux,ub,ub,ug,ub,ub,ub,ub,ux,ux,ux,cb,ux,ux,ux,ux,ux,ux,cb,ux,cr