ur,ur,ur,ur,ur,ur,ur,ur,ur,ux,ux,ux,ux,ux,ux,ux,ux,ux,ux,ux,ux,ur,ur
ur,ur,ur,ur,ur,ur,ug,ug,ur,ur,ur,ur,ur,ur,ur,ur,ur,ur,ur,ur,ur,ur,ur
ur,ur,cr,ur,ur,ur,ur,ur,ur,ur,ur,ur,ur,ur,ur,ur,ur,ur,ur,ur,ur,ux,ur
ur,ub,ub,cr,ub,ug,ug,ug,ug,ug,ug,ug,cg,ur,ur,ur,ur,ur,ur,ur,ur,ux,ur
ur,cb,ug,ug,ub,ur,ur,ur,ur,ur,ur,ur,ur,ur,ur,ur,ur,ur,ur,ur,ur,ux,ur
ur,ur,ug,ur,ub,ug,ug,ug,ur,ur,ur,ur,ur,ur,ur,ur,ur,ur,ur,ur,ur,ur,ur
ur,ur,ug,ug,ub,ug,ur,ur,ur,ur,ur,ur,ur,ur,ur,ur,ur,ur,ur,ur,ux,ub,ux
ur,ur,cg,ug,ub,ug,ug,ug,ur,ur,ur,ur,ur,ur,ur,ur,ur,ur,ur,ur,ux,ub,ub
ur,ur,ur,ur,ur,ug,ug,ug,ur,ur,ur,ur,ur,ur,ur,ur,ur,ur,ur,ur,cr,ux,ub
ur,ug,ug,ug,ug,ux,ux,ug,ub,ub,ub,cr,ur,ur,ur,ur,cr,ug,ux,ux,ux,ux,ub
cb,ux,ux,ux,ug,ug,ux,ug,ub,ub,ub,ub,cb,ub,ug,ub,ub,ug,ux,ux,ux,ux,ub
ub,ux,ux,ux,ux,ug,ug,ug,ub,ub,ub,ub,ug,ub,ub,ub,ub,ub,ub,ub,ub,ur,ub
ub,ux,ux,ux,ur,ur,ub,ug,ug,ug,ub,ub,ub,ub,ub,ur,ur,ur,cr,ub,ur,ur,ub
ub,ur,ur,ur,ur,ug,ug,ug,ug,ug,ug,ug,ug,ug,ub,ub,ub,ub,ub,ur,ur,ur,ub
ub,ub,ub,ub,ub,ub,ub,ug,ug,ug,ug,ug,cg,ug,ub,ub,ub,ub,ub,ur,ur,ur,ub
ur,ur,ur,ur,ur,ug,ub,ub,ub,ub,ub,ub,ub,ug,cb,ub,ub,ub,ub,ur,ur,ur,ub
ur,ur,ur,ur,ur,ug,ug,ug,ug,ug,ug,ug,ug,ug,ur,ub,ub,ub,ub,ub,ub,ub,ub
ur,ux,ux,ux,ux,ux,ux,ug,ug,ug,cg,ug,ug,ug,ur,ug,ux,ub,ux,ux,ur,ur,ur
ur,ux,ux,ux,ux,ux,ub,ub,ug,ug,ub,ub,ug,ug,ur,ub,ub,ub,ux,ux,ur,ur,ur
ur,ux,ux,ux,ux,ux,ub,ub,ug,ug,ub,ub,ug,ub,ur,ub,ub,ub,ux,ux,ur,ur,ur
ur,ux,ux,ux,ub,ux,ux,ub,ug,ug,ux,ux,ux,ux,ur,ub,ub,ux,cb,ub,ur,ur,ur
ur,ux,ux,ux,ub,ub,ux,ub,ux,ux,ux,ux,ux,ux,ur,ur,ub,ub,ub,ub,ub,ur,ux
ur,ur,ur,ur,ur,ur,ur,ur,ur,ur,ur,ur,ur,ur,ur,ur,ub,ub,ub,ub,ub,cb,ux