ur,ur,ur,ur,ur,ur,ur,ur,ur,ur,ur,ur,ur,ur,ur,ur,ur,ur,ur,ur,ur,ur,ur
ur,ur,ur,ur,ur,ur,ur,ur,ug,ur,ur,ur,ur,ur,ur,ur,ur,ur,ur,ur,ur,ur,ur
ur,ur,cb,ub,ur,ur,cr,ur,ur,ur,ur,ur,ur,ux,ur,ur,ur,ur,ur,ur,cr,ub,ug
ur,ur,ur,ub,ub,ub,ur,ur,ur,ur,ur,ur,ur,ur,ur,ur,ur,ub,ub,ux,ux,ux,ug
ur,ur,cg,ur,ub,ub,ur,ur,cg,ug,ub,ub,ub,ux,ux,ux,ub,ub,ub,ux,ux,ux,ug
ur,cr,ug,ug,ug,ur,ug,ug,ug,ug,ug,ub,ub,ub,ub,ub,ub,ub,ub,ux,ux,ux,ug
ur,ur,ur,cr,ug,ur,ug,ug,ur,ur,ug,ug,ug,ub,ug,ug,ux,ux,ub,ux,ux,ux,ug
cr,ug,ug,ur,ug,ur,ur,ug,ug,ug,ug,ug,ub,ub,ub,ug,ug,cg,ub,ub,ub,ux,ug
cg,ur,ur,ur,ub,ur,ur,ug,ub,ug,ug,ug,ug,ug,ug,ug,ub,ub,ub,ub,ub,ub,ub
ux,ux,ux,ur,ur,ur,ub,ug,ub,ug,ug,ux,ux,ub,ub,ub,ub,ub,ub,ux,ux,ux,ub
ux,ux,ux,ux,ub,ub,ub,ug,ug,ug,ub,ub,ub,ub,ub,ub,ub,ux,ub,ub,ub,ub,ub
ux,ux,ux,ux,ux,ub,ub,ug,ug,ug,ub,ub,ub,ub,ub,ub,ux,ux,ux,ux,ux,ux,ub
ux,ux,ux,ux,ux,ux,ug,ug,ub,ub,cb,ub,ub,cb,ub,ub,ux,ux,ux,ux,ux,ux,ub
ux,ux,ux,ux,ub,ux,ug,ux,ug,ug,ub,ub,ub,cb,ub,ub,ux,ux,ux,ux,ux,ux,ub
ux,ux,ux,ux,ub,ub,ug,ub,ug,ub,ub,ub,ub,ub,ub,ub,ux,ux,ux,ux,ux,ux,ub
ug,ux,ux,ux,ux,ub,ug,ux,ug,ub,ub,ub,ux,ux,ub,ub,ux,ux,ux,ux,ux,ux,ub
ug,ux,ux,ux,ux,ux,ug,ug,ug,ux,ux,ux,ux,ux,cb,ub,ub,ux,ux,ux,ux,ux,ub
ug,ux,ux,ux,ux,ux,ub,ug,ub,ub,ux,ux,ux,ux,ux,ub,ub,ux,ux,ux,ux,ux,ub
ug,ux,ux,ux,ux,ux,ub,ug,ug,ub,ub,ub,ub,ux,ux,ub,ux,ux,ux,ux,ux,ux,cb
ug,ux,ux,ux,ux,ux,ub,ub,ub,ub,ub,ub,ub,ux,ux,ub,ux,ux,ux,ux,ux,ux,ur
ug,ux,ux,ux,ux,ub,ub,ub,ub,ub,ub,ub,ub,ub,ub,ub,ux,ux,ux,ux,ux,ux,ur
ug,ux,ux,ux,ux,ub,ux,ub,ub,ux,ub,ub,ux,ux,ux,ux,ux,ux,ux,ux,ux,ux,ur
cr,ur,ur,ur,ur,ur,ur,ur,ur,ur,ur,ur,ur,ur,ur,ur,ur,ur,ur,ur,ur,ur,ur