ux,ux,ur,ur,ur,ur,ur,ur,ur,ur,ur,ur,ur,ur,ur,ur,ur,ur,ur,ur,ur,ur,ur
ux,ux,ur,cg,ug,ug,ur,ur,ur,ur,ur,ur,ur,ur,ur,ur,ur,ur,ur,ur,ur,ur,ur
ux,ug,ug,ug,ug,ug,ur,ur,ur,ur,ur,ur,ur,ur,ur,ur,ur,ur,ur,cr,ur,ur,ur
ux,ug,ug,ug,ug,ug,ur,ur,ur,ur,ur,ur,ur,ur,ur,ur,ur,ur,ur,cr,ur,ur,ur
ux,ug,ug,ug,ug,ug,ur,ur,ur,ur,ur,ur,ur,ur,cg,ur,ur,ur,ur,ub,ub,ur,ur
ux,ux,ux,ux,ur,ug,ur,ur,ur,ur,ur,ur,ur,ur,ug,ur,ur,cr,ux,ub,cb,ur,ur
ux,ux,ur,ur,ur,ur,ur,ur,ur,ur,ur,ur,ur,ur,ug,ur,ux,ux,ux,ur,ur,cr,ur
ux,ux,ur,ux,ux,ur,ur,ux,ug,ug,ug,ug,ug,ug,ug,ur,ux,ux,ux,ur,ur,cr,cb
cg,ux,ur,ux,ux,ur,ur,ur,ug,ur,ub,ur,ur,ur,ug,ur,ux,ux,ux,ur,ux,ux,ux
ur,ux,ur,ur,ux,ur,ur,ur,ug,ur,ub,ub,ub,ub,ub,ur,ug,ug,ug,cr,ur,ux,ux
ur,ur,ur,ur,ur,ur,ur,ur,ug,ur,ub,ur,ub,ub,ub,ub,ub,ub,ug,ux,ur,ux,ux
ur,ur,ur,ur,ur,ur,ur,ur,ug,cg,ug,ug,ub,ub,ub,ub,ub,cb,ug,ub,ur,ux,ux
ur,ur,ub,ub,ug,ur,ur,ur,ug,ur,ug,ug,cb,ux,ub,ub,ub,ub,ug,ub,ur,ub,ux
ur,ur,ur,ur,ug,ur,ur,ur,ug,ur,ug,ug,ug,ug,ub,ub,ub,ub,ug,ux,ur,ur,ur
cg,ur,ur,ur,ug,ur,ur,ur,ug,ub,ug,ug,ub,ub,ub,ur,ug,ug,ug,ux,ux,ux,ur
ur,ur,ur,ur,ug,ug,ug,ux,ug,ux,ug,ug,ub,ub,ub,ur,ug,ug,ux,ux,ug,ug,ur
ur,ur,ur,ux,ub,ub,ug,ub,ug,ug,ug,ug,ub,ub,ub,ur,ug,ug,ub,ub,ub,ub,ub
ux,ux,ug,ug,ug,ug,ug,ub,ug,ub,ug,ug,ub,ub,ub,ub,ub,ub,ub,ux,ux,ub,ub
ux,ux,ug,ux,ux,ug,ug,ub,ug,ub,ub,ug,ux,ux,ux,ur,ux,ux,ux,ub,ub,ub,ub
ux,ux,ug,ux,ux,ux,ux,ub,ug,ub,ub,ub,ux,ub,ub,ur,ub,ub,ub,ub,ux,ux,ub
ux,ux,ug,ug,ub,ug,ub,ux,ug,ub,ub,ub,ux,ub,ub,ur,ub,ub,ub,ub,ub,ub,ub
ux,ux,ub,ub,ub,ub,ub,ub,cb,ub,ub,ub,ub,ub,ub,ur,ub,ub,ub,ub,ub,ub,cb
ux,ux,ux,ux,ux,ub,ux,ub,ux,cg,ub,ub,ub,ub,ub,ur,ur,ur,ur,ur,ur,ur,ur