cb,cb,cb,cr,ur,ur,ur,ur,ur,ur,ur,ur,ur,ur,ur,ur,ur,ur,ur,ur,ur,ur,cb
ur,ur,ur,ur,ur,ur,ur,ur,ur,ur,ur,ur,ur,ur,ur,ur,ur,ux,ux,ur,ur,ur,ux
ur,ur,cr,cr,ur,ur,ur,ur,ur,ur,ur,ur,ur,ur,ur,ur,ur,ux,ux,ur,ux,ux,ux
ur,ur,ub,ur,ur,ur,ur,ur,ur,ur,ur,ur,ur,ur,ur,ug,ug,ug,ug,ug,ug,ux,ux
ur,ur,cb,ub,cb,ur,ur,ur,ur,ur,ur,ur,ur,ur,ur,ug,ug,ug,ug,ug,ug,ur,ux
ur,ug,cg,cr,ur,ur,ur,ur,ur,ur,ur,ur,ur,ur,ur,ug,ug,ug,ug,ug,ug,ur,ux
ur,ur,cr,ug,ug,ur,ur,cr,ur,ur,ur,ur,ur,ur,ug,ug,ug,ug,ug,ug,ug,ur,ur
cb,ub,ub,ug,ug,ug,ub,ux,ub,ub,ub,ub,ub,ug,ur,ug,cb,ug,ug,ug,ug,ur,ur
ug,ug,ug,ug,ur,ug,ur,ur,ur,ub,ub,ug,ub,ub,ub,ub,ub,ug,ug,ug,ug,ur,ur
ug,ur,ur,ug,ux,ug,ux,ux,ug,ub,ub,ub,ub,ug,ug,ug,ug,cg,ug,ug,ux,ux,ur
ug,ux,ux,ug,ux,ug,ux,ug,ug,ug,ub,ub,ux,ux,ux,ur,ug,ux,ux,ug,ux,ux,ur
ug,ug,ug,ug,ug,ug,ug,ug,ug,ug,ug,ug,ug,cg,ur,ur,ur,ur,ur,ur,cr,ug,ur
cb,ux,ux,ug,ug,ug,ux,ug,ug,ug,ug,ub,ug,ub,ub,ub,ug,ur,ur,ug,ur,ur,ur
ux,ux,ux,ug,ug,ug,ux,ug,ug,ug,ug,ug,ub,ub,ub,ub,ug,ug,ug,ug,ug,ur,ug
ux,ux,ug,ug,ux,ux,ux,ug,ux,ug,ug,ug,ub,ub,ub,ub,ug,ub,ux,ux,ur,ur,ug
ux,ux,ug,ug,ux,ux,ux,ug,ub,ub,ug,ug,ug,ub,ub,ub,ug,ux,ux,ux,ur,ux,ug
ux,ux,ug,ug,ux,ux,ub,ug,ux,ug,ug,ub,ub,ub,cb,cg,ug,ug,ug,ug,ub,ub,ub
cr,ux,ug,ug,ux,ux,ub,ug,ux,ux,ux,ub,ug,ub,ub,ug,ug,ug,ug,ug,ub,ub,ub
cg,ux,ug,ug,ux,ux,ub,ug,ug,ug,ug,ub,ug,ub,ub,ub,ub,ub,ub,ub,ub,ub,ub
cb,ux,ug,ug,ux,ux,ux,ux,ux,ux,ux,ub,ux,ub,ub,ub,ub,ub,ub,ub,ub,ub,ub
ux,ux,ug,ug,cg,ux,ux,ux,ux,cb,ux,ub,ux,ug,ux,ux,ux,ux,ux,ux,ux,ux,cr
cr,ux,ug,ug,ug,ug,ug,ug,ub,ub,ub,ub,ug,ug,ux,ux,ux,cb,cg,ux,cb,ux,cr
cg,cb,cg,cb,ux,ux,ux,ux,ub,ub,ub,ub,ux,ux,ux,cg,ux,ux,ux,cg,cg,ux,cr