cb,cb,cb,cr,ur,ur,ur,ur,ur,ur,ur,ux,ux,ux,ur,ur,ur,ux,ux,ux,ux,ux,cb
ur,ur,ur,ur,ur,ur,ur,ur,ur,ur,ur,ur,ur,ur,ur,ur,ur,ux,ux,ux,ux,ux,ux
ur,ur,ur,ur,ur,ur,ur,cb,ub,ub,ub,ub,ub,ub,ub,ub,ub,ub,ub,ub,ux,ux,ux
ur,ur,ur,ur,ur,ur,ur,ur,ur,ur,ur,ur,ur,ur,ur,ur,ur,ur,ur,ub,ub,ur,ur
ur,ur,ur,cr,ub,ur,ur,ur,ur,ur,ur,ur,ur,ux,ur,ur,ur,ur,ug,ur,ub,ux,ur
ur,cr,ug,ur,cb,ur,ur,ur,ur,ur,ur,ur,ur,ux,ur,ur,ur,ur,ur,ur,ur,cr,ur
ur,ur,ug,cg,ur,ur,ur,ur,ur,ur,ur,cr,ug,ug,ur,ur,ug,ug,ur,ur,ub,ur,ur
cb,ur,ug,ur,ur,ur,ur,ur,ur,ur,ur,ur,ur,ug,ur,ur,ug,ux,ux,ux,ub,ux,ug
ur,ur,cr,ur,ur,ur,ur,cr,ur,ur,ur,ur,ur,ug,ug,ur,cg,ug,ux,ux,ub,ux,ug
ub,cb,ub,ub,ub,ug,ug,ub,cb,ug,ug,ur,ur,ur,ug,ur,ur,ug,ux,ub,ub,ug,ug
ub,ub,ub,ub,ub,ug,ub,ug,ub,ux,ug,ug,ug,ug,ug,ub,ur,ug,ux,ub,ux,ug,ux
ub,ub,ub,ug,ug,ug,ub,ub,ub,ux,ug,ub,ub,ug,ug,ub,ur,ug,ug,ub,ux,ug,ux
cb,ub,ug,ug,ug,ux,ug,ug,ux,ux,ug,ub,ub,cg,cg,ub,ur,ub,ug,ub,ux,ug,ux
ux,ug,ug,ug,ug,ug,ug,ug,ux,ux,ug,ub,ub,ug,ub,ub,ur,ug,ug,ub,ux,ug,ux
ub,ug,ug,ug,ug,ug,ug,ug,ux,ux,ug,cb,ub,ux,ux,ux,ur,ux,ux,ub,ug,ug,ux
ug,ug,ug,ug,ug,ug,ug,ug,ux,ux,ug,ux,ub,ux,ux,ux,ur,ux,ub,ub,ux,ux,ux
ug,ug,ug,ug,ug,ux,ug,ug,ug,ug,ug,ux,ux,ux,ux,ux,ur,ux,ub,ug,ux,ux,ux
cr,ux,ux,ux,ug,ux,ug,ug,ux,ug,ug,ux,ux,ux,ux,ux,ur,ux,ub,ug,ub,ub,ub
cg,ux,ux,ux,ug,ug,ug,ug,cg,ug,ug,ub,ub,ub,ub,ub,ur,ub,ub,ug,ub,ub,ub
cb,ux,ux,ux,ug,ug,ug,ug,ug,ug,ug,ux,ux,ux,ux,ux,ur,ux,ux,ug,ux,ux,ux
ug,ug,ug,ug,ug,ug,ug,ug,ug,ug,ug,ug,ug,ug,ug,ug,ug,ug,ug,ug,ux,ux,cr
cr,ug,ug,ug,ug,ug,ug,ug,ug,ug,ux,ux,ux,ux,ux,ux,ur,cb,cg,ux,cb,ux,cr
cg,cb,cg,cb,ux,ux,ux,ux,ux,ux,ux,ux,ux,ux,ux,cg,ur,ur,ur,cg,cg,ux,cr