ux,ux,ux,ux,ux,ux,ux,ux,ur,ur,ur,ur,ur,ur,ur,ur,cr,ux,ux,ux,ux,ux,ux
ur,ux,ux,ug,ug,ux,ur,ur,ur,ur,ur,ur,ur,ur,ux,ux,ux,ux,ux,ux,ux,ux,ux
ur,ub,ub,cb,ug,ur,ur,ur,ur,ur,ur,ur,ur,ur,ur,ur,ur,ur,ur,ur,ur,ur,ur
ux,ub,ux,ug,ug,ug,ug,ug,cr,ur,ur,ur,ur,ur,ux,ux,ux,ux,ux,ux,ur,ur,cb
ux,ub,ux,ug,ug,ur,ur,ur,ub,ur,ur,ur,cr,ur,cr,ux,ux,ux,ux,ux,ur,ur,ur
ur,ub,ur,ur,ug,ur,ur,ur,ub,ur,ur,ur,ur,ur,ur,ur,ur,ur,ur,ux,ur,ur,ur
ur,ub,ur,ur,cg,ur,ur,ug,ub,ub,ug,ur,ug,ur,ur,cb,ur,cr,ur,ux,ur,ur,ur
ur,ub,ur,ur,ur,ur,ux,ur,ub,ub,ug,ur,ug,ur,ug,ub,ur,ur,ur,ur,ur,ur,ur
cg,ub,ur,ur,ur,ur,ux,ur,ub,ub,ub,ur,ub,ur,ug,ub,ub,ur,ur,ur,ur,ur,ur
ub,ub,ur,ur,ur,ur,ur,ur,ub,ub,ub,ur,ug,ur,ug,ug,ub,ur,ur,ur,ur,ur,ur
ub,ub,ur,ur,ur,ur,ub,ub,ub,ur,ur,ub,ub,ur,ug,ug,ub,ub,ug,ur,ur,ur,ur
ub,ub,ub,ur,ur,ur,ub,ur,ur,ub,ub,ub,ub,ur,ub,ux,ug,ub,ug,ur,ur,ur,ur
ub,ur,ub,ub,ur,cg,ub,ub,ub,ub,ur,ub,ub,ub,ub,ux,ug,ub,ug,ur,ur,ur,ur
ub,ub,ux,cb,ub,ug,ux,ub,ub,ub,ub,ub,ub,cb,ub,ub,ug,ub,ug,ur,ur,ur,ur
cg,ub,ux,ux,ug,ug,ub,ux,ub,ub,ub,ub,ub,ub,ub,ub,ug,ub,ug,ur,ur,ur,ur
ub,ub,ux,ux,ug,ux,ub,ux,ub,ub,cr,ub,ub,ub,ub,ub,ug,cg,ug,ur,ur,ur,ur
ub,ub,ug,ug,ug,ux,ux,ux,ub,ub,ur,ub,cb,ux,ux,ub,ug,ub,ur,ur,ur,ur,ur
ub,ub,ug,ux,ux,ux,ux,ux,ub,ub,ur,ub,ub,ux,ux,ub,ug,ub,ur,ur,ur,ur,ur
ub,ub,ug,ux,ux,ux,ux,ux,ub,ub,ur,ux,ux,ux,ux,ub,ug,ub,ur,ur,ur,ur,ur
ub,ub,ug,ug,ug,ug,ug,ug,ug,ub,ur,ug,ug,ug,ug,ub,ug,ub,ur,ur,ur,ur,ur
ub,ux,ug,ug,ug,ug,ug,ug,ug,ug,ur,ub,ub,ub,ub,ub,ug,ub,ub,ur,ur,ur,ur
ub,ub,ub,ub,ub,ub,ub,ub,ub,ub,ur,ug,ug,ub,ug,ug,ug,ub,ur,ur,ur,ur,cb
ux,ux,ux,ux,ux,ux,ux,ux,ux,cg,ur,ur,ur,ur,ur,ur,ur,ur,ur,ur,ur,ur,ur