ur,ur,ur,cb,ug,ug,ub,ur,ur,ur,ur,ur,ur,ur,ur,ur,ur,ug,ux,cg,ux,ux,ux
ur,ur,cr,ub,ub,cg,ub,ur,ur,ur,ur,ur,ux,ur,ur,ur,ur,ug,ux,ux,ux,ux,ux
ur,ur,ur,ur,ub,ub,ug,ug,ug,ug,cr,ug,cg,ur,ur,ur,ux,ug,ug,ux,ux,ux,ux
ur,ur,ur,ur,cr,ub,ug,ur,ur,ug,cb,ug,ux,ur,ur,ug,ug,ug,ug,ux,ux,ux,ux
ub,ug,cr,ub,ub,ub,ub,ub,ub,ub,ub,ug,ug,ug,ug,ug,ux,ug,ug,ux,ux,ux,ux
ub,ug,ur,ur,ub,ub,ub,ub,ub,cb,ur,cg,ur,cr,ug,ug,ug,ug,ug,ux,ux,ux,ux
ug,ug,ub,cb,ub,ub,ub,ub,ug,ug,ug,ug,ux,ug,ug,ug,ug,ug,ug,ux,ux,ux,ux
ug,ub,ub,ug,ug,ug,ug,ug,ug,ug,cg,ug,ub,ub,ug,ug,ug,ug,ug,ux,ux,ux,ux
ub,ub,ug,ug,ug,ug,ug,ug,ug,ug,ub,ug,cb,ub,ug,ug,ug,ug,ug,ug,ux,ux,ux
ub,ub,ub,ug,ub,ub,ug,ug,ub,ub,ub,ub,ub,ub,ux,ux,ux,ug,ux,ug,ug,ug,ug
ub,ub,ub,ub,ub,ur,ug,ug,ub,ub,ub,ub,ub,ub,ug,ug,ug,ug,ug,ug,ug,ug,ug
ub,ub,ub,ub,ur,ur,ug,ug,ub,ub,ub,ub,ub,ub,ug,ug,ug,ug,ug,ux,ux,ug,ug
ub,ub,ub,ug,ug,ug,ug,ug,ub,ub,ub,cb,ub,ub,ug,ug,ug,ug,ug,ux,ux,ug,ug
ub,ub,ub,ug,ux,ux,ug,ug,ug,ub,ub,ub,ub,ub,ug,ug,ug,ug,ug,ug,ug,ug,ug
ub,ub,ub,ug,ub,ux,ug,ub,ug,ub,ug,ub,ub,ub,ub,ug,ug,ug,ug,ug,ug,ug,ug
ub,ub,ub,ug,ub,ux,ug,ug,ug,ug,ug,ub,ub,ub,ux,ux,ux,ux,ug,ug,ux,ug,ug
ub,ub,ub,ug,ub,ub,ub,ug,ub,ub,ug,ug,ub,ub,ug,ug,ug,ug,ug,ur,ur,ur,ur
cg,ub,ub,ug,ub,ub,ub,ug,ux,ub,ux,ug,ub,ug,ug,ux,ux,ux,ux,ux,ur,ur,ur
ux,ub,ub,ug,ug,ub,ug,ug,ux,cg,ug,ug,ug,ug,cb,ux,ux,ux,ux,ux,ur,ur,ur
ux,ub,ub,cr,ur,ur,ur,ur,ur,ur,ur,ur,ur,ub,ub,ub,ur,ur,ur,ur,ur,ur,ur
cr,ur,ur,ur,ur,ur,ur,ur,ur,ur,ur,ur,ur,ur,ur,ur,ur,ur,ur,ur,ur,ur,ur
cg,ur,ub,ub,ub,ux,ub,ub,ub,ub,ux,ux,ux,ux,ux,ux,ux,ux,ux,ur,ur,cb,cr
cr,ur,ur,ur,ur,ur,ur,ur,ur,ur,ur,ur,ur,ur,ur,ur,ur,ur,ur,ur,cb,ux,cr