ur,cb,cb,cr,ux,ux,ux,ux,ur,ur,ur,ur,ur,ur,ur,ur,ur,ur,ur,ur,ur,ur,cb
ur,ur,cb,ur,ur,ur,ur,ur,ur,ur,ur,ur,ur,ur,ur,ur,ur,ur,ur,ur,ur,ur,cg
ur,ur,cb,ub,ub,ub,ub,ub,ub,ur,ur,ur,ub,ur,ur,ur,ur,ur,ur,ur,ur,ur,ug
ur,cr,ug,cg,cb,ub,ub,ub,cr,ur,cr,ur,ur,ur,ur,ur,ur,ur,ur,ur,ur,ur,ug
ub,ub,cr,ub,cg,ub,ug,ug,ug,cr,ur,ur,ur,ur,ur,ur,ug,ug,ug,ug,ug,ub,ug
ur,ur,ur,ur,ug,ub,ub,ub,ur,ug,ub,ug,ug,ur,ur,ug,ug,cr,ug,ug,ug,ub,ug
ur,ur,ur,ug,ug,ub,ub,ub,ur,ug,ub,ug,ug,ur,ug,ug,ug,ur,ug,ug,ug,ub,ug
cb,ug,ur,ug,ug,ub,ub,ub,ug,ug,ub,ug,ug,ug,ug,cg,ug,ur,ug,ug,ug,ug,ug
ux,ux,ux,ug,ug,ug,ug,ub,ug,ub,ux,ug,ug,ug,ug,ux,ug,ur,ug,ug,ug,ug,ur
ub,ub,ug,ug,ub,ub,ug,ub,ux,ub,ux,ug,ug,ug,ug,ug,ug,ur,ug,ug,ug,ug,ub
ub,ug,ug,ug,ug,ug,ug,ug,ug,ub,ug,ug,ug,ug,ug,ux,ux,ur,ub,ub,ub,ug,ug
ub,cg,ug,ug,ug,ug,ug,ub,ug,ux,ug,ug,ug,ug,ur,ux,ux,ur,ug,ug,ug,ug,ug
cb,ub,ug,ug,ug,ug,ug,ug,ug,ug,ug,ug,ug,ug,ur,ux,ux,ur,ub,ub,ub,ug,ub
ub,ub,ug,ug,ug,ug,ub,ub,ux,ug,ux,ux,ug,ug,ug,ug,ug,ur,ub,ub,ub,ug,ub
ub,ub,ub,cb,ub,ug,ug,ux,ux,ug,ux,ux,ux,ux,ug,ug,ug,ur,ub,ux,ux,ug,ur
ub,ub,ub,ub,ub,ug,ug,ug,ug,ug,ug,ux,ux,ux,ur,ux,ug,ur,ux,ux,ux,ug,ur
ub,cb,ub,ug,ub,ub,ug,ug,ug,ux,ug,ug,ug,ug,ug,ug,ug,ub,ub,ub,ub,ub,ub
ub,ug,ug,ug,ub,ub,ux,ux,ux,ux,ug,ug,ug,ux,ur,ux,ug,ub,ub,ub,ub,ub,ub
ub,ug,ug,ug,ug,ug,ug,ux,ux,ux,ug,ug,ux,ug,ug,ug,ur,ub,ur,ug,ug,ug,ur
ub,ug,ug,ug,ug,ug,ug,ug,ux,ux,ux,ug,ug,ug,ur,ug,ug,ub,ug,ug,ur,ur,cb
cr,ug,ug,ug,ug,ug,ug,ug,ug,ug,ug,ug,ug,ug,ug,ur,ug,ub,ug,ur,ur,ur,cr
cg,ug,ug,ug,ug,ug,ug,ug,ux,ux,ux,cg,ux,ux,ur,ur,ur,cb,ur,cb,cb,ur,cr
cr,cg,cg,cb,ux,ux,ux,ux,ux,ux,ux,ux,ux,ux,ur,cg,ur,ur,ur,cg,cg,ur,cr