ur,ur,ur,ur,ur,ur,ur,ub,ub,ub,ub,ub,ub,cr,ur,ur,ur,ur,ur,ur,ur,ur,ur
ur,ur,ur,ur,ur,ur,cr,ux,ur,ur,ur,ux,ur,ur,ur,ur,ur,ur,ur,ub,ub,ub,ur
ub,ub,ux,ug,ug,ur,ur,ux,ur,ur,ur,cb,ub,ub,cr,ur,cb,ub,ub,ub,ub,ub,ur
ub,ub,ux,ug,ug,ur,ur,ur,ur,ur,ur,ux,ur,ur,ur,ur,ur,ur,ur,ur,ub,ub,ur
ub,ub,ux,ug,ug,ug,ur,ur,ur,ur,ur,ux,ur,ur,ur,ur,ur,ur,ur,ur,ur,ur,ur
ub,ub,ux,ug,ur,ug,ur,ur,ur,ur,ur,ur,ur,ux,ur,ur,ur,ux,ur,ux,ur,ur,ur
ub,ub,ux,ug,ux,ur,ur,ur,ur,ur,ur,ux,ug,ug,ug,ur,ur,ur,ur,ur,ur,ur,ur
ub,ub,ub,ug,ux,ur,ur,ur,ur,ur,ur,ur,ug,ug,ug,ug,ur,ur,ur,ur,ur,ur,ur
cg,ub,ur,ug,ur,ug,ur,ur,ur,ur,ur,ur,ug,ug,ug,ug,cg,ur,ur,ur,ur,ur,ur
ub,ub,ur,ug,ux,ug,ur,cr,ur,ur,ur,ur,ur,ur,ur,ur,ur,ur,ur,ur,ur,ur,ur
ub,ur,ur,ug,ux,ug,ug,cr,ur,ur,ur,ur,ur,ur,ur,ur,ur,ur,ur,ur,ur,ur,ur
ub,ub,ur,ug,ur,ug,ug,ur,cb,ur,ur,ur,ur,ur,ur,ur,ur,ur,ur,ux,ux,ur,ur
ub,ub,ur,ug,ur,ur,ug,ub,ub,ub,ub,ug,ug,ub,ub,ub,ub,ux,ux,ux,ux,ur,ur
ub,ub,ur,ug,cg,ur,ug,ub,ub,ub,ub,ug,ug,ub,ub,ub,ub,ux,ux,ux,ux,ur,ur
cg,ub,ux,ux,ux,ux,ub,ub,ub,ub,ub,ub,ub,ub,ub,ub,ux,ub,ub,ux,ux,ur,ur
ub,ub,ux,ux,ux,ux,ub,ub,ub,cb,ub,ub,ub,ub,ub,cb,ub,ub,ub,ux,ux,ur,ur
ub,ur,ux,ux,ux,ux,ux,ub,ub,ub,ub,ub,ub,ux,cg,ug,ub,ub,ux,ux,ux,ur,ur
ub,ub,ux,ux,ux,ux,cb,ub,ub,ub,ub,ub,ub,ub,ub,ug,ug,ug,ug,ur,ur,ur,ur
ub,ub,ux,ux,ux,ux,ux,ux,ux,ux,ux,ux,ux,ux,ub,ub,ur,ub,ug,ub,ub,ur,ur
ub,ub,ux,ux,ux,ux,ux,ux,ux,ux,ux,ux,ux,ux,ub,ux,ur,ug,ug,ub,ux,ur,ur
ub,ub,ux,ux,ux,ux,ux,ux,ux,ux,ux,ux,ux,ux,ub,ux,ur,ux,ux,ub,ub,ur,ur
ub,ub,ub,ub,ub,ub,ub,ub,ub,ux,ux,ux,ux,ux,ub,ub,ur,ub,ub,ub,ub,ur,cb
ub,ub,ux,ux,ux,ux,ux,ux,ux,cg,ux,ux,ux,ux,ub,ub,ur,ur,ur,ur,cr,ur,ur