ur,ur,cb,ub,ub,ub,ub,ur,ur,cg,ub,ub,ur,ur,ub,ub,ux,cb,ub,ub,ub,ub,ub
ur,cr,ur,ur,cr,ur,cr,ur,ub,ub,ub,ub,ux,ub,ub,ub,ux,ub,ub,ug,ub,ub,ub
ur,ur,ur,ug,cr,ug,ug,ug,cg,ub,ur,ub,ub,ub,ux,ub,ub,ub,ug,ub,ub,ub,ub
ur,ug,ug,ug,ur,ub,ub,ub,ub,ub,ub,ub,ub,ub,ub,ug,ug,ug,ug,ub,ub,ub,ub
ur,ug,ur,ur,ur,ug,ub,ub,ug,ub,ub,ub,ub,ub,ug,ug,ug,ug,ug,ug,ub,ub,ub
ur,cg,ur,ur,ur,ug,ug,ug,ug,ub,ub,ub,ub,cg,ug,ux,ux,ux,ux,ug,ub,ub,ux
ur,ur,ur,ur,ur,ur,ub,ub,ub,ub,cb,ux,ux,ug,ug,ug,ug,ux,ux,ug,ub,ub,ux
ur,ur,ur,ur,ux,ux,ub,ub,ub,ug,ug,ug,ug,ug,ug,ux,ug,ug,ux,ug,ub,ub,ux
ur,ur,ur,ur,ux,ux,ux,ux,ub,ug,ub,ub,ub,ub,ug,ug,ug,ug,ub,ug,ub,ub,ux
ur,ur,ur,ur,cb,ux,ux,ux,ug,ug,ub,ug,ub,ub,cb,ub,ub,ub,ub,ug,ub,ub,ux
ur,ur,ur,ug,ub,ub,ub,ub,ub,ub,ub,ug,ub,ub,ub,ub,ub,ug,ug,ug,ub,ub,ux
ux,ur,ur,ur,ur,ub,ub,ug,ug,ub,ub,ub,ub,ub,ug,ug,ug,ug,ub,ub,ub,ug,ux
ux,cr,ux,ur,ur,ub,ub,ug,ug,ub,ub,ub,ub,ub,ub,ub,ug,ug,ug,ub,ub,ub,cg
ux,ux,ux,ug,ug,ug,cr,ur,ur,ur,ur,ur,ur,ur,ur,ur,ur,ur,ur,ur,ur,ur,ur
ux,ux,ux,ux,ux,ug,ug,ug,cg,ug,ug,ur,ub,ub,ub,ub,ur,ur,ur,ur,ur,ur,ur
ux,ux,ux,ux,ux,ub,ug,ug,ug,ug,cb,ub,ub,ub,ug,ug,ug,ug,ug,ux,ur,ur,ur
ux,ub,ub,ub,ux,ub,ub,ur,ub,ug,ub,ub,ux,ux,ug,ux,ux,ux,ux,ux,ur,ur,ur
cg,ub,ur,ub,ub,ur,ur,ur,ur,ub,ub,ub,ug,ug,ug,ur,ur,ur,ur,ur,ur,ux,ux
ub,ub,ux,ux,ub,ug,ur,ux,ug,ub,ug,ub,ux,ux,ux,ux,ux,ux,ux,ux,ur,ux,ux
ub,ur,ux,ux,ub,ub,ub,ub,ux,ux,ub,ub,ux,ux,ux,ux,ux,ux,ux,ux,ur,ux,ux
ub,ub,ub,ub,cb,ub,ur,ub,ub,ub,ub,ub,ux,ux,ux,ux,ux,ux,ux,ux,ur,ux,ux
cr,ur,ux,ub,ub,ub,ub,ub,ux,ub,ux,ub,ux,ux,ux,ux,ux,ux,ux,ux,ur,ux,cb
cg,ur,ur,ur,ub,ub,ub,ub,ub,ub,ux,ux,ux,ux,ux,ux,ux,ux,ux,ux,ur,ux,ux