cb,ur,cb,ux,ux,ux,ur,ur,ur,ur,ur,ur,cr,ub,cb,ur,ur,ur,ur,cg,ur,ur,ur
ub,cr,ux,ux,ux,ux,ur,ur,ur,ur,ur,ur,ur,ur,ur,ur,ur,ur,ur,ur,ur,ur,ur
ux,ux,ux,ux,ux,ur,ur,ur,ur,ur,ur,ur,ur,ur,ur,ur,ur,ur,ur,ur,ur,ur,ur
ur,ur,ur,ur,ur,ur,ur,ur,ur,ur,ur,ur,ur,ur,ur,ur,ur,ur,ur,ur,ur,ur,ur
ur,ux,ur,ur,ur,ur,ur,ur,ur,ur,ur,ur,ur,ur,ur,ur,ur,ur,ur,ur,ur,ur,ur
ur,ur,ur,ux,ux,ux,ux,ur,ur,ur,ur,ur,cg,ur,ur,ur,ur,ur,ur,ur,ur,ur,ur
ur,ur,ur,ux,ux,ux,ux,ur,ur,ur,ur,ur,ug,ur,ur,ur,ur,ur,ur,ur,ur,ur,ur
ur,ur,ur,ur,ur,ur,ux,ur,ur,ur,ur,ur,ug,cb,ur,ur,cr,ur,ur,ur,ur,ur,ur
ur,ur,ur,ur,ug,ug,cr,ur,ur,ur,ur,ur,ub,ub,cr,ug,ug,ug,ur,ur,ug,ug,ux
ur,ux,ux,ur,ug,ur,ur,ur,ug,ub,ur,ur,ub,ug,ub,ub,ub,ux,ux,ug,ug,ug,ux
ur,ux,ux,ur,ug,ug,ur,ur,ug,ub,ub,ub,ub,ub,ub,ub,ub,ug,ug,ug,ug,ug,ux
ux,ux,ux,ur,ur,ug,ug,cg,ug,ub,ub,ub,ub,ub,ug,ug,ug,ug,ug,ug,ug,ug,ux
cg,ux,ux,ux,ur,ur,cb,ub,ub,ub,ub,ub,ub,ub,ux,ug,ug,ux,ug,ug,ug,ug,ux
ux,ux,ug,ug,ug,ug,ug,ub,ug,ug,ug,ug,cg,ug,ug,ug,ug,ug,ug,ug,ug,ur,ux
ux,ug,ub,ub,ug,ug,ub,ub,ug,ub,cr,ug,ug,ug,ug,ug,ug,ug,ug,ug,ug,ur,ux
ux,ug,ub,ug,ug,ug,cg,ub,ub,ub,ur,ug,ug,ug,ug,ug,ug,ug,ug,ug,ug,ur,ux
ux,ug,ub,ug,cb,ub,ub,ug,ug,ug,ur,ub,ug,ub,ug,ug,ug,ug,ug,ux,ug,ux,ux
cg,ug,ub,ub,ub,ub,ug,ug,ug,ug,ur,ug,ug,ub,ug,ux,ug,ux,ux,ux,ug,ux,ux
ux,ug,ug,ub,ug,ug,ug,ux,ug,ug,ur,ub,ub,ub,ug,ug,ug,ux,ug,ug,ug,ux,ux
ux,ux,ug,ub,ug,ug,ug,ub,ub,ug,ur,ub,ug,ug,ug,ug,ug,ux,ug,ug,ug,ux,ux
cr,ux,ug,ux,ug,ug,ug,ug,ug,ug,ur,ub,ub,ug,ug,ug,ug,ug,ug,ug,ur,ux,ux
cg,ur,ur,ur,ur,ur,ur,ur,ug,ug,ur,ub,ub,ur,ur,ur,ur,ur,ur,ur,ur,cb,cr
cr,ur,ur,ur,ur,ur,ur,ur,ur,ur,ur,ub,ub,cb,ug,ug,ug,ug,ug,ug,cb,ux,cr