ur,cb,cb,cr,ur,ur,ur,ur,ur,ur,ur,ur,ur,ur,ur,ux,ur,ur,ur,ur,ur,ur,cb
ur,cb,cb,ur,ur,ur,ur,ur,ur,ur,ur,ur,ur,ur,ur,ur,ur,ur,ur,ur,ur,ur,ur
ur,ur,ur,ur,cr,ur,ur,cr,ur,cr,ur,ur,ur,ur,ur,ur,ur,ur,ur,ur,ur,ur,ur
ur,ur,ur,cr,ur,ur,ur,ub,cb,ur,ur,ur,ur,ur,ux,ur,ur,ur,ur,ur,ur,ur,ur
ux,ux,ux,ug,ux,ur,ur,cg,ug,ug,ug,ur,ur,ur,ur,ur,ur,ur,ur,ur,ur,ur,ur
ux,ux,ux,ug,ux,ug,ug,ug,ux,ug,ur,ur,ur,ur,ub,ub,ub,ur,ur,ur,ur,ur,ur
ux,ux,ux,ug,ux,ug,ug,ug,ug,ug,ur,ur,ur,ur,ur,ug,ug,ux,ug,cb,ur,ur,ur
cb,ux,ug,ug,ur,ug,ug,ur,ug,ug,ur,ur,ur,ur,ur,ur,ug,ur,ug,ub,ur,ur,ur
ug,cg,ug,ur,ur,ug,ug,ur,ug,ur,ur,ur,ur,ur,ur,ur,ug,ur,ug,ub,ub,ub,ub
ug,ug,ug,ur,ug,ug,ug,ug,ug,ur,ur,ur,ur,ur,ur,cr,cg,ug,ug,ub,ub,ug,ub
ug,ug,ur,ur,ug,ug,ug,ug,ug,ur,ur,ur,ur,ur,ur,ug,ug,ug,ug,ub,ub,ub,ub
ur,ur,ur,ug,ug,ug,ub,ub,ug,ug,ur,ur,ug,ug,ug,ug,ug,ug,ug,ux,ux,ug,ug
cb,ux,ux,ug,ug,ug,ug,cb,ub,ug,ur,ur,ug,ug,ug,ug,ux,ux,ug,ux,ux,ug,ug
ub,ub,cg,ug,ug,ug,ug,ub,ub,ug,ub,ug,ug,ug,ug,ug,ux,ux,ug,ux,ux,ug,ug
ub,ub,ub,ug,ug,ug,cg,ug,ub,ug,ug,ug,ug,ug,ub,ug,ub,ug,ug,cg,ub,ub,ux
ub,ug,ug,ug,ug,ug,ub,ug,ug,ug,ub,ub,ub,ug,ug,ug,ub,ug,ug,ub,ux,ub,ux
ug,ug,ug,ug,ug,ug,ux,ug,ux,ux,ug,ux,ux,ux,ux,ux,ux,ug,ug,ub,ux,ub,cb
ug,ug,ug,ug,ug,ug,ux,ug,ux,ug,ug,ux,ux,ux,ux,ux,ux,ug,ug,ub,ux,ub,ux
ug,ug,ug,ug,ub,ub,ux,ug,ux,ug,ux,ux,ux,ux,ux,ux,ux,ux,ux,ub,ux,ub,ur
ug,ug,ug,ug,ug,ub,ub,ub,ub,ur,ur,ub,ub,ub,ub,ub,ub,ub,ur,ur,ur,ur,ux
cr,ur,ur,ur,ur,ur,ur,ur,ur,ur,ub,ub,ub,ur,ur,ur,ur,ub,ur,ur,ur,ur,cr
cg,ur,ur,ur,ur,ur,ur,ur,ur,ur,ur,ur,cr,ux,ux,ux,ux,ub,ux,cb,cb,ur,cr
cr,cg,cg,cb,ug,ub,ub,ux,ub,ub,ux,ub,ub,ux,ux,cg,ux,cb,ux,cg,cg,ur,cr