ur,ub,ub,cr,ur,ur,ur,ur,ur,ur,ur,ux,ur,ur,ur,ur,ur,ur,ub,ub,ub,ur,ur
cr,ub,ub,ur,ub,ur,ug,ur,ur,ur,ur,ug,ur,ur,ur,ur,ur,ur,ub,ur,ub,ub,ur
ur,ub,cb,ur,ur,ur,cr,ur,ug,ur,cr,cb,ub,ub,ub,ub,ub,ub,ub,ub,ur,ub,ur
ub,ub,ug,ug,ub,ux,ub,ub,ug,ur,ur,ux,ux,ur,ur,ub,ur,ub,ub,ub,ur,ub,ur
ub,ub,ur,ug,ub,ub,ub,ub,cg,ub,ur,ux,ux,ub,ur,ur,ur,ub,ub,ub,ub,ub,ur
ux,ur,ub,ub,ub,ug,ug,ub,ub,ub,ub,ug,ur,ur,cr,ur,ur,ub,ub,ub,ub,ub,ub
ux,ur,ub,ub,ub,ug,ur,ub,ub,ub,ub,ub,ur,ur,ur,ur,ug,ub,ur,ur,ug,ur,ub
ux,ur,ux,ub,ub,ug,ug,ug,cb,ub,ub,ub,ub,ub,ug,ug,ub,ub,ur,ur,ur,ur,cb
cg,ur,ur,ur,ur,ur,ur,ub,ub,ug,ug,ug,cg,ub,ub,ub,ub,ug,ux,ux,ub,ub,ur
ux,ux,ux,ux,ux,ub,ux,ub,ub,ub,ug,ug,ur,cb,ub,ub,ug,ub,ub,ub,cb,ub,ur
ux,ux,ux,ux,ux,ub,ux,ub,ub,ub,ug,ug,ub,ub,ux,ub,ug,ub,cg,ub,ub,ub,ur
ux,ux,ux,ub,ub,ub,ux,ug,ub,ub,ug,ug,ub,ub,ub,ux,ug,ub,ug,ub,ub,ub,ur
ux,ux,ux,ub,ub,ub,ub,ug,ug,ub,ug,ub,ub,ub,ub,ub,ug,ub,ug,ub,ub,ub,ur
ux,ux,ux,ux,ux,ub,ug,ug,ub,ub,ug,ug,ub,ux,ub,ug,ug,ug,ug,ub,ub,ub,ur
ux,ux,ux,ux,ux,ub,ug,ug,ub,ub,ub,ug,ug,ug,ug,ug,ug,ug,ug,ub,ub,ub,ur
ux,ux,ux,ux,ux,ub,ub,ux,ub,ub,ug,ug,ug,ug,ug,ug,ug,ug,ug,ub,ub,ub,ur
ux,ux,ux,ux,ux,ub,ub,ub,ub,ux,ug,ug,ug,ug,ug,ug,ug,ug,ug,ub,ub,ub,ur
cr,ux,ux,ux,ux,ub,ub,ub,ub,ux,ug,ug,ug,ug,ug,ug,ug,ug,ug,ub,ub,ub,ur
ur,ux,ux,ux,ux,ub,ux,ub,ux,ux,ux,ux,ux,ux,ug,ug,ug,ug,ug,ub,ub,ub,ur
ur,ux,ux,ux,ux,ub,ux,ux,ux,ux,ux,ux,ux,ux,ux,ub,ub,ub,ub,ub,ux,ux,ur
ur,ux,ux,ux,ux,ub,ux,ux,ux,ux,ux,ux,ux,ux,ux,ux,ux,ux,ux,ub,ub,ub,ur
ur,ux,ux,ux,ux,ub,ub,ub,ub,ub,ub,ub,ub,ub,ub,ub,ub,ub,ub,ub,ub,ub,ur
ur,ur,ur,ur,ur,ur,ur,ur,ur,ur,ur,ur,ur,ur,ur,ur,ur,ur,ur,ur,ur,ur,ur