cb,ur,ur,ur,ur,ur,ur,ur,ub,ub,ub,ub,ub,ub,cr,ur,ur,ur,ur,cg,ur,ub,ub
ur,ur,ur,ur,ur,ur,ur,ur,ux,ub,ux,ur,ur,ur,ux,ub,ub,ur,ur,ur,ur,ub,ub
cb,ur,ur,ur,ur,ur,ur,ur,ux,ub,ur,ur,ur,ur,ur,ux,ub,ur,ur,ub,ub,ub,ub
ub,ur,cr,ur,ur,ur,ur,ur,ur,ub,ur,ur,ur,ur,ur,ur,ur,ur,ur,ug,ub,ub,ub
cr,ur,ub,ur,ur,ur,ur,ux,ur,ur,ur,ur,ub,cr,ub,ur,ur,ur,ur,ub,ub,ug,ux
ur,ur,cb,ur,ur,ux,ur,ur,ug,ur,ur,ur,cb,ur,ub,cg,ug,ur,ux,ub,ux,ug,ux
ub,cr,ur,ur,ux,ux,ux,ur,ug,ur,ur,ug,ug,ug,ug,ug,ug,ur,ux,ub,ub,ub,cb
ub,ub,ur,ur,ux,cg,ur,ug,ug,ur,ur,ug,ur,ug,ug,ug,ug,ur,ux,ux,ux,ug,ux
ur,ub,ub,ux,ux,ug,ur,ug,ur,ur,ug,ug,ug,ug,ug,ug,ug,ug,ux,ux,ux,ug,ux
ur,ub,ub,ur,ur,ug,ug,ug,ub,ub,ug,ug,ur,ug,ug,ur,ux,ug,ur,ur,ux,ug,ux
cb,ub,ub,ub,ub,ug,ug,ub,ux,ub,ub,ug,ug,ug,ug,ur,ug,ug,ur,ux,ux,ug,ux
ub,ub,ub,ub,ub,ug,ug,ub,ub,ub,ub,cb,ub,ug,ug,ug,ug,ug,ug,ug,ub,ug,ux
ub,ub,ub,ub,ub,ug,ug,ub,ux,ub,ub,cg,ub,ux,ux,ux,ug,ux,ug,ug,ub,ug,ux
ub,ub,ub,ub,ub,ug,ug,ux,ux,ub,ub,ub,ub,ux,ux,ug,ug,ux,ug,ug,ux,ug,ux
ub,ub,ub,ux,ux,ug,ug,ux,ub,ub,ub,ub,ug,ug,ug,ug,ug,ux,ug,ug,ux,ug,ux
ub,ub,ub,ub,ub,ug,ug,ub,ub,ub,ug,ub,ug,ub,ug,ug,ug,ub,ub,ug,ub,ug,cg
ur,ur,ur,ur,ur,ub,ur,ur,ur,ur,ur,ur,ur,ur,ur,ug,ur,ur,ur,ur,ur,ug,ux
cg,cr,ur,ur,ur,ur,ur,ur,ur,ur,ur,ur,ur,ur,ur,ur,ur,ur,ur,ur,ur,ug,ux
ub,ub,ub,ub,ux,ub,ub,ux,ug,ug,ug,ux,ux,ux,ux,ux,ux,ux,ur,ur,ur,ug,ux
ub,ub,ux,ux,ux,ux,ux,ug,ug,ux,ux,ux,ux,ux,ux,ux,ux,ux,ur,ur,ur,cg,ux
cr,ub,ub,ub,ub,ub,ub,ug,ub,ux,ug,ug,ug,ug,ux,ux,ux,ux,ux,ux,ux,ux,ux
cg,ux,ux,ux,ux,ux,ux,ug,ub,ux,ug,ub,ub,ug,ux,ux,ux,ux,ux,ux,ux,cb,cr
cr,ux,ux,ux,ux,ux,ux,ug,ug,ug,ug,ug,ug,ug,ug,ux,ux,ux,ux,ux,cb,ux,cr