ub,ub,ub,cb,ur,ur,ur,cg,ur,ur,ur,ur,ur,ur,ur,ux,ux,cb,ux,ux,ux,ub,ub
cr,ur,ur,ur,ur,ur,ur,ug,ur,ur,ur,ur,ur,ur,ur,ur,ux,ur,ur,ux,ub,ub,ub
ur,ur,cr,ur,ur,ur,cr,ug,ur,ur,ur,ug,ug,ug,ur,ur,ur,ur,ur,ux,ub,ux,ub
ur,cr,ur,ug,ug,ur,ur,ub,ur,ur,ug,ug,ur,ug,ur,ur,ug,ub,ub,ur,ub,ub,ub
ur,ug,ur,ur,ur,ur,ub,cr,ur,ur,ug,ug,ur,ur,ur,ur,ur,ur,ur,ur,ux,ub,ur
ur,ur,ur,ur,ur,ur,ub,ub,ub,ug,ug,ug,ur,ux,ug,ug,ug,ug,ur,ur,ux,ub,ub
ub,ub,ur,ur,ur,ur,ub,ub,ub,ug,ug,ug,ur,ux,ug,ug,ub,ub,ur,ub,ub,ub,ub
ub,ub,ur,ub,ub,ur,ub,ub,ub,ug,ug,ug,ur,ux,ug,ub,ug,ug,ur,ub,ux,ux,ux
ub,ub,ur,ur,ub,ur,ub,ub,ub,ug,cg,ub,ur,cg,ub,ub,ug,ug,ur,ux,ux,ux,ux
ub,ub,ub,ur,ur,ur,ub,ub,ub,ug,ug,ub,ub,cb,ub,ub,ug,ug,ur,ux,ux,ux,ux
ub,ub,ub,ug,ug,ug,ug,ug,ub,ug,ug,ub,ub,ug,ug,ug,ug,ug,ur,ux,ux,ux,ux
ub,ub,ub,ux,ux,ux,ux,ug,ux,ux,ux,ub,ur,ub,ub,ub,ux,ug,ur,ux,ux,ux,ux
ux,cb,ug,ux,ux,ux,ux,ug,ux,ux,ux,ub,ur,ub,ub,ub,ux,ux,cr,ux,ux,ux,cg
ux,ux,ug,ug,ug,ux,ux,ug,ux,ux,ux,ub,ur,ux,ux,ub,ux,ux,ux,ux,ux,ux,ux
ux,ux,ux,ux,ux,ux,ux,ug,ub,ug,ug,ug,cg,ug,ug,ub,ug,cb,ux,ux,ux,ux,ux
ux,ux,ux,ux,ux,ux,ux,ug,ub,ug,ug,ug,ug,ug,ux,ub,ub,ub,ux,ux,ux,ux,ux
ux,ux,ur,ur,ug,ug,ug,ug,ug,ur,ur,ug,ug,ug,ug,ug,ug,ug,ug,ug,ug,ug,ug
cg,ur,ur,ur,ur,ur,ur,ur,ur,ur,ug,ug,ug,ur,ur,ur,ur,ur,ur,ur,ur,ur,ug
ub,ub,ub,ug,ug,ug,ug,ug,ug,ug,ug,ub,ug,ux,ug,ug,ug,ug,ug,ug,ug,ug,ug
ub,cb,ux,ug,ug,ug,ug,ux,ux,ug,ug,ux,ug,ux,ug,ug,ug,ug,ug,ug,ug,ug,ug
ub,ub,ub,ub,ux,ux,ug,ux,ux,ux,ux,ug,ug,ug,ug,ug,ux,ux,ux,ug,ug,ug,ug
cr,ur,ub,ub,ux,ux,ug,ux,ux,ux,ux,ug,ur,ug,ug,ug,ug,ug,ug,ug,ux,cb,cr
cg,ur,ur,ur,ur,ur,ur,ur,ur,ur,ur,ur,ur,cb,ug,ug,ug,ug,ug,cg,cb,ux,cr