ub,ub,ug,ug,cr,cr,ur,ur,ur,ur,ur,ur,ur,ur,ur,ur,ur,cb,ux,ux,ur,ub,ub
ub,ur,cg,ur,ur,ur,ur,ur,ur,ur,ur,ur,ur,ur,ur,ur,ur,ur,ur,ur,ub,ub,ub
cb,ur,cr,cr,cb,ub,ub,ub,ub,ur,ur,ur,ur,ur,ur,ur,ur,ur,ur,ur,ub,ux,ub
ur,ur,ur,ur,ub,ub,ur,ub,ub,ur,ur,ur,ur,ux,ur,ur,ug,ub,ub,ur,ub,ub,ub
ur,ur,ur,ur,ur,ub,ub,ub,ub,ur,ur,ug,ug,ur,ub,ub,ug,ub,ub,ur,ur,ub,ur
ur,ur,ur,ur,ur,ub,ub,cb,ub,ur,ug,ug,ug,ug,ub,ug,ug,cg,ub,ur,ur,ub,ub
ur,ur,ur,ur,ur,ub,ub,ur,ub,ur,ug,ug,ug,ug,ub,ug,ub,ub,ub,ub,ub,ub,ub
ur,ur,ur,ub,ub,ub,ub,ub,ub,ug,ug,ug,ug,ug,cg,ug,cb,ub,ub,ub,ux,ux,ux
ur,ur,ur,ur,ub,ur,ub,ub,ub,ug,ug,ug,ug,ug,ug,ug,ux,ux,ux,ux,ux,ux,ux
ur,ur,ur,ur,cr,ub,ub,ub,ub,ux,ug,ug,ug,ug,ug,ug,ux,ux,ux,ux,ux,ux,ux
ux,ux,ug,ug,ug,ug,ug,ug,ub,ux,ug,ug,ug,ug,ug,ug,ux,ux,ux,ux,ux,ux,ux
ux,ux,ug,ux,ux,ux,ux,ug,ux,ux,ux,ub,cr,ub,ub,ug,ux,ux,ux,ux,ux,ux,ux
ux,ux,ug,ux,ux,ux,ux,ug,ux,ux,ux,ub,ur,ub,ub,ug,ug,ug,ux,ux,ux,ux,cg
ur,ur,ug,ug,ug,ug,ug,ug,ug,ug,ug,ub,ur,ug,ug,ug,ug,ug,ux,ux,ux,ux,ux
ur,ux,ux,ux,ux,ux,ux,ug,ub,ug,ug,ug,ur,ug,ug,ug,ug,ug,ux,ux,ux,ux,ux
ur,ux,ux,ux,ux,ux,ux,ug,ub,ug,ug,ug,ur,ug,ug,ug,ug,ug,ux,ux,ux,ux,ux
ur,ur,ur,ur,ug,ug,ug,ug,ug,ur,ur,ug,ur,ug,ug,ug,ug,ug,ug,ug,ug,ug,ug
cg,ur,ur,ur,ur,ur,ur,ur,ur,ur,ug,ug,ur,ur,ur,ur,ur,ur,ur,ur,ur,ur,ug
ub,ub,ub,ug,ug,ug,ug,ug,ug,ug,ug,ub,ur,ux,ug,ug,ug,ug,ug,ug,ug,ug,ug
ub,cb,ub,ug,ug,ug,ug,ux,ux,ug,ug,ux,ur,ux,ug,ug,ug,ug,ug,ug,ug,ug,ug
ub,ub,ub,ub,ux,ux,ug,ux,ux,ux,ux,ug,ur,ug,ug,ug,ux,ux,ux,cg,ug,ug,ug
cr,ur,ub,ub,ux,ux,ug,ux,ux,ux,ux,ug,ur,ug,ug,ug,ug,ug,ux,ux,ux,cb,cr
cg,ur,ur,ur,ur,ur,ur,ur,ur,ur,ur,ur,ur,cb,ug,ug,ug,ug,ux,cg,cb,ux,cr