ur,cr,ur,ur,cr,ur,ur,ur,ur,cg,ur,ur,ur,ur,ur,ux,ux,cb,ux,ux,ux,ur,ur
ur,ur,ub,ub,ub,ub,ur,cg,ug,ug,ur,ux,ux,ux,ur,ux,ux,ux,ux,ux,ux,ur,ur
ur,ur,ur,ur,cb,ub,cr,ur,ug,ur,cr,ur,ub,ub,ur,ub,ub,ub,ub,ub,ub,ur,ur
ur,ur,ur,ur,cr,ug,ug,ug,ug,ur,ur,ur,ub,ub,ur,ux,ub,ux,ux,ux,ug,ur,ur
ur,ur,ub,ug,ub,ug,ur,ur,ur,ur,ur,ur,ub,ub,cg,ux,ub,ux,ux,ub,ug,ur,ur
ur,ur,ur,ug,ug,ug,ur,ug,ug,ur,ur,ur,cb,ug,ug,ub,ub,ux,ux,ub,ug,ur,ur
ub,ub,ub,ug,ug,ug,ug,ug,ug,ub,ub,ub,ux,ux,ux,ux,ub,ux,ux,ub,ub,ur,ur
ub,ux,ub,ub,ug,ug,ug,ug,ug,ug,ub,ub,ub,ub,ux,ub,ub,ux,ux,ub,ux,ur,ur
ub,ux,ub,ug,cb,ub,ub,ug,ug,ug,ug,cg,ub,ub,ub,ub,ub,ub,ub,ub,ux,ur,ur
ub,ux,ub,ub,ux,ug,ub,ug,ug,ub,ub,ux,ub,ub,ub,ux,ub,ub,ub,ug,ux,ur,ur
ub,ux,ur,ub,ub,ug,ub,ub,ux,ub,ub,ub,ub,ub,ub,ub,ub,ub,ub,ug,ug,ur,ur
ub,ux,ub,ub,ub,ug,ub,ub,cb,ub,ub,ub,ub,ub,ub,ug,cg,ub,ux,ug,ug,ur,cr
ub,ux,ub,ub,ub,ub,ub,ug,ub,ub,ub,ux,ub,ub,ug,ug,ug,ub,ub,ug,ux,ur,ux
ub,ux,ux,ug,ux,ug,ug,ug,ub,cb,ug,ub,ub,ug,ug,ug,ug,ub,ub,ug,ux,ur,ux
ub,ux,ux,ug,ug,ug,ug,ug,cg,ug,ug,ux,ub,ug,ug,ug,ug,ug,ub,ug,ux,ur,ux
ub,ux,ux,ug,ug,ug,ug,ug,ug,ug,ug,ub,ub,ub,ug,ug,ug,ug,ub,ug,ux,ur,ux
ub,ub,ub,ug,ug,ug,ug,ug,ug,ug,ug,ub,ub,ub,ug,ug,ub,ug,ux,ug,ux,ur,ux
ur,ur,ub,ug,ug,ug,cb,ug,ug,ug,ub,ub,ub,ub,ug,ug,ug,ug,ux,ug,ux,ur,ux
ur,ux,ub,ug,ug,ug,ub,ug,ub,ub,ub,ux,ub,ub,ug,ug,ub,ub,ux,ug,ux,ur,ux
ur,ux,ub,ub,ux,ub,ub,ux,ub,ux,ux,ux,ux,ub,ub,ub,ub,ub,ux,ug,ux,ur,ux
ur,ur,ub,ub,ub,ub,ug,ug,ub,ug,ug,ug,ug,ub,ub,ub,ub,ub,ux,ug,ub,ur,ux
cr,ux,ub,ub,ub,ub,ub,ub,ub,ux,ux,ux,ux,ux,ur,ub,ub,ub,ug,ug,ub,ur,cb
cg,ux,ub,ub,ub,ub,ub,ub,ub,ub,ub,ub,ub,ub,ur,ur,ur,ur,ur,ur,ur,ur,ur