ur,ur,ur,ur,ur,ur,ur,cr,ur,ur,ur,ub,ub,ub,ux,ux,ux,ur,ur,ur,ug,ur,cb
ur,ur,ur,ur,ur,ur,ur,cr,ur,ur,ur,ub,ub,ub,ux,ux,ux,ur,ur,ur,ug,ug,ux
ur,ur,ur,ur,cr,ur,ur,ur,ub,ur,ur,ux,ux,ub,ub,ux,ur,cr,ub,ug,ug,ug,ux
ur,ur,ur,ur,ub,ub,ur,ur,ub,ur,ur,ux,ux,ux,ub,ub,ub,ub,ub,ug,ux,ug,ux
ur,ur,ur,ub,ur,cb,ur,cr,ub,ub,ub,ub,ub,ub,ub,ub,ub,ub,ub,ug,ug,ug,ux
ur,ur,ur,ub,ur,cg,ug,ug,ug,ub,ub,ug,ug,ug,ux,ub,ub,ux,ug,ug,ug,ug,ux
ur,ur,ur,ub,ug,ug,ug,ug,ug,ug,ug,ug,ug,ub,ub,ub,ub,ux,ug,ux,ug,ux,ux
ur,ur,ur,ub,ug,ug,ux,ux,ub,ug,ug,ur,ug,ub,ug,ub,ub,ux,ug,ug,ug,ux,ux
cg,ur,ur,ub,ug,ug,ug,ug,ub,ug,ub,ub,ug,ub,ub,ub,ub,ux,ux,ug,ug,ux,ux
ur,ur,ur,ub,ug,ug,ug,ug,ur,ug,ug,ub,ug,ug,ug,ug,ub,ub,ug,ug,ug,ux,ux
ur,ux,ur,ub,ug,ux,ug,ug,ur,ug,ug,ub,ub,ug,ub,ub,ug,ub,ug,ux,ug,ug,ug
ur,ur,ur,cb,ug,ur,ug,ug,ur,ug,ug,ur,ug,ug,ux,ub,ug,ub,ug,ug,ug,ux,ug
ur,ur,ur,ur,ug,ur,ub,ub,ug,ug,ub,ur,ug,ug,ub,cg,ug,ub,ux,ux,ug,ug,ug
ur,ur,ur,ur,ug,ub,ub,ub,ug,ub,ub,ub,ub,cg,ub,ug,ug,ux,ux,ux,ux,ug,ug
ur,ur,ur,ur,ug,ub,ub,ub,ug,ub,ub,ub,ug,ug,ub,ug,ug,ux,ux,ux,ux,ug,ug
ur,ur,ux,ux,ug,ub,ub,ub,ub,ub,cb,ub,ub,cb,ub,ug,ug,ux,ux,ux,ux,ug,ug
ur,ur,ur,ur,ug,ur,ur,ur,ub,ub,ub,ur,ur,ur,ur,ug,ur,ur,ur,ur,ur,ur,ur
ur,ux,ux,ux,ug,ux,ux,ux,ux,ux,ux,ug,ug,ug,ug,ug,ug,ug,ub,ug,ug,ug,ur
ur,ux,ux,ux,ug,ug,ug,ug,ug,ug,ug,ug,ug,ug,ug,ug,ux,ub,ux,cr,ur,cb,ub
ur,ux,ux,ux,ux,ux,ux,ux,ux,ux,ug,ug,ug,ur,ug,ug,ug,ug,ug,ug,ub,ub,ub
ur,ux,ux,ux,ux,ux,ux,ux,ux,ux,ux,ur,ux,ur,ug,ug,ug,ug,ug,ug,ub,ub,ub
ur,ux,ux,ux,ux,ux,ux,ux,ux,ux,ux,ur,ux,ur,ur,ur,ur,ur,ur,ug,ub,ub,ub
ur,ur,ur,ur,ur,ur,ur,ur,ur,ur,ur,ur,ux,ux,ux,ux,ux,ux,ux,ux,ux,ub,ub