ur,ur,ur,ur,ur,ur,ur,ur,ur,ur,ur,ur,ur,ur,ur,ur,ur,cb,ur,ur,ur,ux,ux
ur,ur,ur,ur,ur,ur,ur,ur,ur,ur,ur,ur,ur,ux,ux,ur,ur,ur,ur,ur,ur,ux,ux
ur,ur,ur,ur,ur,ur,ur,ur,ur,ur,ur,ur,ur,cr,ux,ux,ux,ux,ux,ur,ux,ux,ux
ur,ur,ur,ur,ur,ur,ur,ur,ub,ub,ur,ur,ur,ur,ub,ub,ub,cb,ux,ur,ur,ur,ur
cb,ur,ur,ur,cr,ur,ur,ub,cg,cb,ur,ub,ub,ug,ug,ur,ur,ub,ur,ur,ur,ur,ur
ub,cr,ur,ur,ub,ub,ur,ub,ug,cr,ur,ub,ub,ug,ug,ur,ur,ub,ug,ug,ug,ur,ur
ux,ur,ur,ur,ur,ur,ur,ug,ug,ur,ub,cb,ub,ug,ug,ug,ur,ur,ug,ur,ug,ur,ur
ur,ur,ur,ur,ur,ur,ur,ux,ux,ur,ur,ub,ub,ub,ub,ug,ux,ug,ug,ug,ug,ux,ug
ur,ur,ur,ur,ur,ur,ur,ug,ug,cg,ug,ug,ug,ug,ug,ug,ux,ug,ug,ug,ug,ux,ug
ur,ur,ur,ur,cr,ug,ug,ug,ug,ur,ur,ub,ub,ux,ub,ub,ux,ug,ug,ug,ug,ux,ug
ur,ur,ur,ur,ub,ub,ub,ug,ug,ur,ur,ub,ub,ux,ux,ux,ux,ug,cg,ug,ug,ux,ug
ub,ub,ub,ub,ub,ub,ub,ug,ug,ug,ur,ub,ur,ug,ug,ug,ug,ur,ur,ug,ug,ug,ug
ub,ub,cb,ub,ub,ub,ub,ub,ub,ug,ug,ug,ug,ug,ux,ux,ug,ug,ux,ug,ug,ug,cg
ub,ub,ub,ux,ub,ub,ub,ug,ug,ug,ug,ub,ux,ux,ux,ug,ug,ug,ux,ug,ug,ug,ux
ug,ug,ug,ux,ub,ug,ug,ug,ug,ug,ug,ub,ux,ux,ux,ug,ux,ug,ux,ug,ug,ug,ux
ug,ux,ug,ux,ub,ug,ug,ug,ug,ug,ug,ub,ux,ux,ux,ug,ux,ug,ux,ug,ug,ug,ux
ug,ug,ug,ug,ug,ug,ug,ug,ug,ug,ug,ug,ug,ug,ug,ug,ug,ug,ug,ug,ug,ur,ur
cg,ug,ux,ux,ug,ux,ub,ub,ub,ub,ux,ub,ug,ug,ug,ug,ux,ux,ux,ug,ux,ug,ur
ur,ur,ur,ur,ur,ur,ur,ur,ur,ur,cr,ub,ux,ux,ux,ux,ux,ux,ux,ug,ux,ug,ur
ur,ug,ug,ug,ug,ug,ug,ux,ux,ub,ux,ub,ux,ux,ux,ux,ux,ux,ux,ug,ug,ug,ur
ur,ur,ur,ug,ur,ur,ur,ur,ur,ur,ur,ur,ur,ur,ur,ur,ur,ur,ur,ur,ur,ur,ur
cr,ux,ux,ug,ux,ux,ux,ux,cg,ug,ub,ub,ux,ux,ux,ux,ux,ug,ug,ug,ux,cb,cr
cg,ux,ux,ug,ug,ug,ug,ug,ug,ug,ux,ub,ux,cb,ux,ux,ux,ux,ux,cg,cb,ux,cr