ur,ur,ur,ur,ur,ur,ur,ur,ur,ur,ur,ur,ur,ur,ur,ur,ur,ur,ur,ur,ur,ug,ug
ur,cr,ur,cr,ur,ur,ur,ur,ur,ug,ug,ug,ug,ur,ug,ur,ur,ur,ux,ur,ur,ux,ug
ur,cb,ub,ur,ub,ur,ur,ur,ur,ur,ur,ur,ur,cr,ur,ur,ub,ub,ub,ub,ub,ux,ug
ub,ub,ub,cr,ur,ur,ur,ur,ug,ub,cr,ur,ur,ur,ur,ur,cg,ug,ux,ub,ub,ux,ug
ux,ux,ub,ub,ur,ug,ur,ug,ug,ub,ub,ub,ur,ug,ug,ug,ub,cb,ux,ux,ub,ub,ug
ux,ux,ux,ub,ur,ur,ur,ug,ug,ub,ub,ub,ux,ux,ug,ux,ub,ub,ux,ux,ux,ur,ug
ux,ux,ux,ub,ux,ub,ug,ug,ug,ub,ub,ug,ug,ug,ug,ux,ux,ub,ub,ub,ub,ux,ug
ux,ux,ux,ub,ub,ub,ug,ug,ug,cb,ub,ug,ux,ux,ux,ux,ux,ux,ux,ux,ub,ux,ug
cg,ux,ug,ux,ux,ug,ub,ub,ub,ub,ub,ub,ub,ub,ub,ub,ub,ux,ux,ux,ub,ux,ug
ux,ux,ug,ub,ub,ub,ug,ub,ub,ub,ub,ub,cb,ub,ub,ub,ub,ug,ug,ur,ub,ur,ug
ux,ux,ux,ub,ub,ub,ux,ub,ub,ub,ub,ub,ub,ub,ub,ub,ug,ug,ug,ug,ug,ux,cg
ux,ux,ux,ub,ub,ux,ux,ub,ub,ub,ub,ub,ug,ub,ub,ub,ug,ug,ug,ux,ug,ux,ur
ux,ux,ux,ub,ub,ub,ux,ux,ux,ux,ub,ub,ub,ub,ug,ug,ug,ug,ug,ug,ug,ux,ur
ux,ux,ux,ub,cb,ub,ux,ux,ux,ux,ub,ub,ub,ug,ug,ug,ux,ug,ug,cg,ub,ux,ur
ux,ux,ux,ug,ub,ub,ux,ux,ux,ux,ux,ub,ug,ug,ug,ug,ug,ug,ug,ux,ub,ux,ur
ux,ux,ux,ug,ub,ur,ur,ur,ur,ur,ub,ub,ug,ub,ub,ub,ug,ug,ug,ur,ub,ur,ur
ur,ur,ur,ur,ur,ur,ur,ur,ur,ur,ur,ur,ug,ug,ug,ug,ug,ug,ug,ur,ub,ur,ur
ur,ux,ux,ug,ug,ur,ub,ub,ub,ub,ux,ub,ub,ub,ub,ub,ug,ug,ux,ux,ub,ux,ur
ur,ux,ux,ug,ug,ur,ug,ug,ug,ug,ux,ux,ub,ub,ux,ux,ux,ux,ux,ux,ub,ux,ur
ur,ux,ux,ux,ug,ur,ug,ug,ux,ux,ux,ux,ux,ux,ux,ux,ux,ux,ux,ux,ub,ux,ur
ur,ux,ux,ux,ux,ur,ux,ux,ux,ux,ux,ux,ux,ux,ux,ux,ux,cb,ub,ub,ub,ux,ur
ur,ux,ux,ux,cr,ur,ux,ux,ux,ux,ux,ux,ux,ux,ux,ux,ux,ux,ux,ux,ux,ux,ur
ur,ur,ur,ur,ur,ur,ur,ur,ur,ur,ur,ur,ur,ur,ur,ur,ur,ur,ur,ur,ur,ur,ur