ur,ur,ur,ur,ur,ur,ur,ur,ur,ur,ur,ur,ur,ur,ur,ur,ux,cb,ur,ur,ur,ur,ur
ur,ur,ur,ur,ur,ur,ur,ur,ur,ur,ur,ur,ur,ux,ur,ur,ur,ur,ur,ur,ur,ur,cr
ur,ur,ur,ur,ur,ur,ur,ur,ur,ur,ur,ur,ur,ur,ur,ur,ur,ur,ur,ur,cb,ub,ub
ur,ur,ur,ur,ur,ur,ur,ur,ur,ur,cg,ur,ur,ur,ur,ur,ur,ur,ur,ur,ur,ur,ur
ur,cr,ur,ur,ur,cr,ug,ur,cb,ur,ug,ur,ur,ur,ug,ug,ub,ug,ux,ug,ux,ux,ux
ur,ur,ur,ur,ur,ur,cg,ur,ub,ug,ug,ur,ur,ux,ub,ug,ub,ug,ug,ug,ux,ux,ux
cb,ub,cr,ux,ur,ur,ur,ur,ub,ug,ur,ug,ug,ug,ug,ug,ux,ub,ux,ux,ux,ux,ux
ur,cr,ux,ux,ux,ux,ub,ub,ub,ub,ub,ux,ux,ug,ug,ug,ug,ub,ux,ux,ux,ux,ux
ub,ub,ub,ub,ub,ub,ub,ub,ub,ub,ub,ug,ug,ug,ug,ub,ub,ub,ux,ux,ux,ux,ux
cb,ux,ux,ux,ux,ux,ub,ub,ub,ub,ub,ug,ub,ug,ug,ux,ux,ux,ux,ux,ux,ux,ux
ub,ub,ub,ub,ub,ub,ub,ub,ub,ub,ug,ug,ub,ug,ug,ug,ug,ug,ub,ub,ux,ux,ux
ug,ug,cg,ug,ug,ug,ub,ub,ub,ub,ug,ug,ub,ug,ub,ug,ug,ub,ub,ub,ub,ur,ux
ug,ug,ug,ug,ug,ug,ug,ug,ug,ug,ug,ug,ug,ug,ug,ug,ug,ub,ub,ub,ub,ug,cg
ux,ug,ux,ux,ux,ux,ux,ux,ug,ug,ug,ug,ug,ug,ug,ub,ub,ub,ub,ug,ux,ur,ur
ux,ug,ux,ux,ux,ux,ux,ux,ug,ug,ug,ug,ug,ug,ub,ub,ub,ur,ur,ur,ur,ur,ur
ux,ug,ux,ux,ux,ux,ux,ux,ug,ug,ug,ug,ug,ug,ub,ub,ub,ub,ub,ub,ux,ur,ur
ux,ug,ux,ux,ux,ux,ux,ux,ug,ug,ug,ug,ug,ug,ux,ub,ub,ub,ub,ux,ux,ur,ur
cg,ug,ux,ux,ux,ux,ux,ux,ug,ug,ug,ug,ux,ug,ux,ub,ub,ub,ub,ux,ux,ur,ur
ux,ug,ux,ux,ux,ux,ux,ux,ug,ug,ug,ug,ux,ux,ux,cr,ub,ux,ux,ux,ux,ur,ur
ur,ug,ur,ur,ur,ur,ur,ur,ur,ur,ug,ug,ur,ur,ur,ur,cb,ur,ur,ur,ur,ur,ur
ur,ug,ur,ur,ur,ur,ur,ur,ur,ug,ug,cg,ur,ur,ur,ur,ur,ur,ur,ur,ur,ur,ur
cr,ug,ux,ux,ux,ux,ux,ux,ux,ux,ux,ug,ux,ux,ux,ux,ux,ux,ux,ux,ux,cb,cr
cg,ug,ug,ug,ug,ug,ug,ug,ug,ug,ug,ug,ux,cb,ux,ux,ux,ux,ux,cg,cb,ux,cr