ub,ub,ub,cb,ur,ur,ur,ur,ur,ur,ur,ur,ur,ur,ur,ur,ur,ur,ur,ur,ur,ur,ur
ub,ub,ub,ur,ur,ub,ub,ub,cr,cr,ur,ur,ur,ur,ur,ur,ur,ur,ur,ur,ur,ur,ur
ub,cr,ur,ur,ur,ub,ub,ub,ub,ur,ur,ur,ur,ur,ur,ur,ur,ur,ur,ur,ur,ur,ur
ub,ur,ub,ur,ur,ub,ub,ub,ub,ub,ub,ur,ur,ur,ur,ur,ur,ur,ur,ub,ur,ur,ur
ub,ur,ur,ur,ub,ub,ub,ub,ub,ub,ub,ur,ur,ur,ur,ur,ur,cr,ur,ux,ur,ur,ur
ub,ub,ub,ub,ub,ug,ub,ub,ub,ub,ub,ux,ux,ub,ug,ux,ub,ub,cr,ub,ur,ur,ur
ub,ub,ub,ub,ug,ug,ub,cb,cb,ub,ub,ub,ub,ub,ug,ux,ub,ux,ub,ub,ub,ur,ur
ub,ur,ur,ug,ug,ux,ub,ur,cg,ug,ug,ub,ub,ub,ug,ux,ub,ux,ub,ub,ub,ur,ur
ub,ur,ur,ug,ug,ux,ug,ur,cg,ug,ug,ug,ug,ug,ug,ug,ub,ub,ub,ux,ub,ur,ur
ub,ur,ur,ug,ug,ur,ur,ug,ug,cb,ub,ug,ug,ug,ug,ug,ug,ub,ur,ur,ub,ub,cb
ub,ur,ux,ug,ug,ux,ug,ug,ug,ub,ub,ug,ug,ug,ug,ug,ug,ug,ug,ug,ug,ur,ur
ub,ur,ux,ug,ug,ub,ub,ux,ug,ub,ub,ub,ug,ug,ug,ux,ux,ug,ux,ux,ux,ur,ur
ub,ur,ur,ug,ug,ub,ub,ub,ug,ub,ub,ub,ub,ub,ub,ug,ug,ug,ux,ux,ux,ur,cr
ub,ux,ux,ug,ug,ub,ub,ub,ub,cb,ub,ub,ub,ub,ub,ug,ug,ug,ux,ux,ux,ur,ug
ub,ux,ux,ug,ug,ux,ux,ub,ub,ug,ux,ug,ub,ub,ug,ug,ux,ug,ux,ux,ux,ur,ug
ub,ux,ux,ug,ug,ux,ux,ug,ug,ug,ub,ug,ug,ug,ug,ug,ug,ug,ux,ux,ux,ur,ug
ub,ux,ux,ug,ug,ux,ux,ug,ug,ug,ux,ug,ux,ux,ux,ux,ux,ux,ux,ux,ux,ur,ug
ub,ux,ux,ug,ug,ux,ux,ug,ug,ug,ug,ug,ux,ux,ux,ux,ux,ux,ux,ux,ux,ur,ug
ub,ux,ux,ug,ug,ux,ux,ug,ug,ub,ux,ux,ux,ux,ux,ux,ux,ux,ux,ux,ux,ur,ug
ub,ux,ux,ux,ux,ux,ux,ux,ub,ub,ux,ux,ux,ux,ux,ux,ux,ux,ux,ux,ux,ur,ug
ub,ux,ux,ux,ux,ux,ux,ux,ux,ux,ux,ux,ux,ux,ux,ux,ux,ux,ux,ux,ux,ur,ug
ub,ux,ux,ux,ux,ux,ux,ux,ux,ux,ux,ub,ub,ux,ux,ux,ux,ux,ux,ux,ux,ur,ug
ub,ub,ub,ub,ub,ub,ub,ub,ub,ub,ub,ub,ug,ug,ug,ug,ug,ug,ug,ug,cg,ug,ug