ux,cb,cb,cr,cb,ux,ux,ux,ux,ux,ur,ur,ur,ur,ur,ur,ur,ur,ur,ur,ur,ur,cb
ux,ux,cb,ux,ux,ux,ux,ux,ux,ux,ur,ur,ur,ur,ur,ur,ur,ur,ur,ur,ur,ur,ur
ux,ux,ux,ux,ux,ux,cr,ux,ux,ur,ur,ur,ur,ur,ur,ur,ur,ur,ur,ur,ur,ur,ur
ux,cb,ub,ub,ub,ub,ur,ur,ux,ur,ur,ur,ur,ur,ur,ur,ur,ur,ur,ur,ur,ur,ur
ub,ub,ub,ub,ub,ub,ur,ur,cr,ur,ur,ur,ur,ur,ur,ug,ug,ug,ur,ur,ur,cr,ur
ub,ub,ub,ub,ub,ub,ur,cg,ug,ur,ur,ur,ur,ur,cr,ug,ur,ug,ur,ur,ur,ur,ur
ux,ux,ux,ur,ur,ur,ur,ur,ur,ur,ur,ur,ur,ur,ur,ur,ur,cg,ur,ur,ur,ur,cr
cb,ux,ux,ur,ur,ur,ur,cb,ur,ur,cg,ug,ur,ur,ur,ur,ur,ug,ug,ug,ur,ur,ug
ur,ur,ux,ur,ur,ur,ur,ub,ur,ur,ur,ug,ub,ub,ub,ub,ub,ug,ug,ug,ug,ux,ug
ur,ur,ux,ur,ur,ur,ur,ub,ub,ur,ur,ug,ug,ug,ug,ug,ux,ug,ug,ug,ug,ux,ug
ur,ub,ub,ub,ur,ux,ux,ux,ub,ub,ub,ub,ug,ug,ug,ug,ux,ug,ug,ug,ug,ux,cg
ur,ub,ub,ub,ug,ug,ug,ug,ug,ug,ux,ux,ug,ug,ug,ug,ug,ug,ug,ug,ug,ux,cb
cb,ub,ub,ug,ug,ug,ug,ug,ux,ug,ux,ux,ug,ug,ug,ug,ub,ub,ub,ug,ug,ux,cg
ur,ur,ur,ur,ur,cr,ug,ug,ug,ug,ux,ux,ug,ug,ux,ug,ug,ub,ux,ug,ug,ub,ub
ur,ug,ug,ub,ug,ug,ug,ug,ug,ug,ux,ux,ug,ug,ux,ux,ug,ug,ug,ug,ug,ug,ug
ur,ug,ug,ub,ug,ug,ux,ug,ug,ug,ux,ux,ux,ux,ux,ux,ux,ux,ux,ux,ub,ug,ug
ug,ug,ub,ub,cb,ug,ug,ug,ug,ug,ug,ux,ux,ux,ub,ub,ug,ug,ug,ug,ug,ug,ub
ug,ug,ux,ub,ub,ug,ug,ug,ug,ug,ug,ug,ub,ub,ub,ux,ug,ur,ur,ur,ur,ur,ur
ug,ug,ug,cg,ur,ur,ur,ur,ur,ur,ur,ur,ur,ur,ur,ur,ur,ur,ur,ur,ur,ur,ur
cr,ug,ug,ug,ug,ug,ug,ug,ug,ug,ur,ur,ur,ug,ur,ur,ug,ur,ur,ur,ur,ur,ur
cg,ug,ug,ug,ug,ug,ug,ug,ug,ug,ux,ux,ux,ug,ug,ug,ug,ur,ur,ur,ur,ur,cr
cr,ug,ug,ug,ug,ug,ug,ug,ug,ug,ux,ux,ux,ur,ux,ux,ux,ux,ux,cb,cb,ur,cr
cg,ur,cg,cb,ug,ug,ug,ug,ug,ug,ur,ur,ur,ur,ux,cg,ux,ux,ux,cg,cg,cb,cr