ux,ur,cb,ur,ur,ur,ur,ur,ur,ur,ur,ur,ur,cb,ub,ub,ub,ub,ur,cg,cg,ug,ug
ux,cr,ub,ur,ur,ur,ur,ur,ur,ur,ur,ur,ur,ur,ur,ur,ur,ub,ur,ux,cr,ur,ur
ur,ur,ur,ur,ur,ur,ur,ur,ur,ur,ur,ur,ur,ur,ur,ur,ur,ub,ur,ub,ug,ub,ur
ur,ub,ur,ur,ur,ur,ur,ur,ur,ur,ur,ur,ub,cr,ur,cr,ur,ub,ub,ub,ug,ub,ur
ux,ur,ur,ur,ur,ur,ur,ur,ur,ur,ur,ur,ub,ub,ur,ur,ub,ub,ub,ur,ug,ur,ur
ur,ur,ur,ur,ur,ur,ur,ur,ur,ur,ur,ur,ub,ub,ur,ur,ub,ub,ub,ur,ug,ur,ur
ur,ur,ur,ur,ur,ur,ur,ur,ur,ur,cg,ug,ub,cb,ur,ur,ur,ub,ub,ux,ug,ur,ur
ur,ur,cr,ur,cr,ur,ur,ur,ur,ub,ub,ug,ub,ub,ub,ug,ug,ub,ur,ub,ug,ug,ur
ub,ug,ur,ur,ub,ug,ug,ux,ub,ub,ub,ub,ub,ub,ug,ug,ug,ur,ur,ux,ux,ur,ur
ub,ug,ug,ug,ug,ug,ug,ur,ub,ub,ub,ub,ub,cb,ub,ug,ug,ug,ug,ux,ux,ur,ur
ub,ug,ug,ug,ug,ub,ug,ux,ub,ub,ub,ub,ub,ub,ub,ug,ub,ug,ug,ug,ub,ur,ur
ux,ug,ug,ug,ug,ug,ug,ug,ug,ub,ub,ub,ug,ub,ub,ub,ub,ub,ug,ub,ub,ur,ur
cg,ux,ug,ug,ub,ug,ub,ug,ug,ub,ub,ug,ug,ub,ub,ug,ug,ub,ub,ub,ux,ur,ur
ug,ug,ug,ug,ug,ug,ug,ug,ug,ub,cg,ug,ub,ub,ug,ug,ug,ug,ug,ub,cg,ur,ur
ug,ug,ug,ug,ug,ug,ub,ub,ug,ug,ug,ub,ub,ux,ug,ug,ug,ug,ug,ub,cb,ur,ur
ug,ug,ug,ug,ug,ug,ug,ug,ug,ug,ux,ux,cb,ux,ug,ug,ug,ux,ux,ux,ux,ur,ur
ug,ug,ug,ug,ux,ux,ug,ux,ux,ux,ux,ux,ub,ug,ug,ub,ug,ug,ug,ug,ux,ur,ur
cg,ug,ug,ug,ug,ux,ug,ux,ux,ux,ux,ux,ug,ug,ug,ug,ug,ug,ug,ug,ub,ur,ur
ux,ux,ug,ux,ug,ux,ug,ug,ug,ug,ug,ug,ug,ug,ug,ug,ug,ug,ug,ug,ug,ur,ur
ux,ux,ug,ug,ug,ug,ux,ux,ux,ux,ug,ug,ug,ux,ux,ux,ux,ux,ux,ux,ux,ur,ur
cr,ux,ug,ug,ux,ug,ux,ux,ux,ux,ug,ux,ux,ux,ux,ux,ux,ux,ux,ux,ux,ur,ur
cg,cb,ug,ug,ug,ug,ug,ug,ug,ug,ug,ux,ux,ux,ux,ux,ux,ux,ux,ux,ux,cb,cr
cr,ux,ux,ug,ug,ug,ux,ux,ux,ux,ux,ux,ux,ux,ux,ux,ux,ux,ux,ux,cb,ux,cr