ur,ur,ur,ur,ur,ur,ur,ur,ur,ur,ur,ur,ur,ur,ur,ur,ur,ur,ur,ur,ur,ur,ur
ur,ur,ur,ur,ur,ur,ur,ur,ur,ur,ur,ur,ur,ur,ur,cr,ur,ur,ur,ur,ur,ur,ur
ur,ur,ur,ur,ur,ur,ur,ur,ur,ur,ur,ur,ur,ur,ur,ur,ur,ur,ur,ur,ur,ur,ur
ur,ur,ur,ur,ur,ur,ur,ur,ur,ur,ur,ur,ur,cr,ur,ur,ur,ub,ur,ur,ur,ur,ur
ur,ur,ur,ur,ur,ur,ur,ur,ug,ur,ur,ur,ur,ug,ub,ub,cr,ur,ur,ur,ur,ur,ur
ur,ur,ur,ur,cr,ug,ug,ug,ur,ur,ur,ur,ur,ug,ub,cb,ub,ub,ur,ur,ur,ur,ur
ur,ur,ur,ur,ur,ur,ur,cg,ur,ur,ur,ur,cr,ug,ub,ub,ub,ur,ur,ur,ur,ur,ur
ur,ur,ur,ur,ur,ur,ur,ur,ur,ur,ub,ur,ur,ug,ub,ub,ur,ug,ug,ur,ur,ur,ur
ur,ur,ur,ur,ux,ur,ur,ur,ur,ur,ur,ub,ub,ug,ub,ub,ur,ub,ux,cr,ur,ux,ur
ur,ur,ur,ur,ux,ug,ux,ux,ub,ub,ub,ub,ub,ug,ug,ug,ug,ug,ux,ub,ur,ux,ur
ux,ux,ug,ug,cg,ug,ug,ug,cb,ub,ug,ug,ub,ug,ub,ub,ub,ug,ux,ub,ur,ux,ur
ux,ux,ug,ug,ux,ug,ux,ux,ug,ug,ub,ug,ub,ug,ub,ub,ub,ug,ux,ub,ur,ub,ur
ux,ux,ug,ug,ux,ug,ux,ux,ug,ux,ub,ug,ug,ug,ub,ug,ug,ug,ux,ub,ur,ub,ur
ux,ux,ug,ug,ux,ug,ux,ux,ug,ug,ub,ub,ub,ub,ux,ug,ug,ux,ux,ub,ur,ug,ur
ux,ux,ug,ug,ug,ug,ux,ux,ux,ub,ub,ux,ux,ug,ug,ug,ug,ux,ux,ub,ur,ub,ur
ux,ux,ug,ux,ug,ug,ug,ux,ub,ub,ux,ug,ug,ug,ug,ug,ug,ux,ux,ub,ur,ub,ur
ux,ux,ug,ux,ux,ux,ux,ux,ub,ub,cb,ug,ug,ug,ug,ug,ug,ux,ux,ub,ur,ub,ur
ux,ux,ux,ux,ux,ux,ux,ux,ux,ux,ub,ub,ug,ur,ub,ug,ug,ug,cg,ub,ur,ub,ur
ux,ux,ux,ux,ux,ux,ux,ux,ux,ux,ub,ub,ug,ug,ug,ug,ux,ux,ux,cb,ur,ub,ur
ux,ux,ux,ux,ux,ux,ux,ux,ux,ux,ux,ux,ux,ur,ux,ux,ux,ux,ux,ux,ur,ub,ur
ux,ux,ux,ux,ux,ux,ux,ux,ux,ux,ux,ux,ux,ur,ux,ux,ux,ux,ux,ux,ur,ub,ur
ux,ux,ux,ux,ux,ux,ux,ux,ux,ux,ux,ux,ux,ur,ux,ux,ux,ux,ux,ux,ur,ub,ur
cb,ux,ux,ux,ux,ux,ux,ux,ux,ux,ux,ux,ux,ur,ur,ur,ur,ur,ur,ur,ur,cb,ur