ur,ub,cb,ur,ur,ur,ur,ur,ur,ur,ur,ur,ur,ur,ur,ur,ur,ur,ur,ur,ur,ur,ur
ur,ub,cr,ur,ur,ur,ur,ur,ur,ur,ur,ur,ur,ur,ur,ur,ur,ur,ur,ur,ur,ur,ur
ur,ur,ug,ug,ug,ur,ur,ur,ur,ur,ur,cb,ur,ur,ur,ur,ur,ur,ur,ur,ur,ur,ur
ur,ur,ug,ug,cr,ur,ur,ur,ur,ur,ur,ub,ub,ur,ur,ur,ur,ur,ur,ur,ur,ur,cb
ur,ur,ug,ug,ur,ur,ur,ur,ur,ur,ur,ur,ub,ub,ub,ur,ur,ur,ur,ur,ur,ur,ur
ur,ur,ur,ur,ug,cr,ur,ur,ur,ur,ur,ur,ur,ur,ub,ub,ub,ub,ub,ub,ur,ur,ur
ur,ur,ur,ur,ug,ur,ur,ur,ur,ur,ur,ur,ur,ur,ur,ur,ub,ub,ur,ur,ur,ur,ur
ur,ur,ur,ur,ug,ur,ur,ur,ur,ur,ur,ug,ug,ug,ug,cg,ur,ur,ur,ur,ur,ur,ur
cg,ux,ux,ux,ug,ug,ub,ur,cr,ur,ur,ur,ur,ur,ug,ug,ur,ur,ur,ur,ur,ur,ur
ub,ub,ub,ub,ug,ug,ub,ub,ub,ur,ug,ub,ub,ub,ug,ug,ug,ug,ug,cr,ur,ur,ur
ub,ux,ux,ux,ug,ug,ug,ug,ug,ug,ub,ub,ub,ub,ug,ug,ug,ux,ub,ur,ur,ur,ur
ub,ux,ux,ux,cg,ux,ux,ux,ub,ub,ub,ub,ub,ub,ub,ub,ub,ux,ux,ux,ur,ur,ur
ub,ux,ux,ux,ux,ux,ux,ux,ub,ub,ub,ub,ub,ub,ub,ux,ux,ux,ux,ux,ug,ux,ub
ub,ub,ub,ub,ub,ub,ub,ub,ub,ub,ub,ub,ub,ub,ub,ub,ub,ub,ub,ub,ub,ub,ub
cg,ux,ux,ux,ux,ux,ux,ux,ub,ub,ub,cb,ub,ux,ux,ux,ux,ux,ux,ug,ug,ux,cb
ug,ug,ug,ug,ug,ug,ug,ug,ug,ug,ub,ub,ub,ub,ug,ug,ug,ug,ug,ug,ux,ux,ur
ug,ux,ux,ux,ux,ux,ux,ux,ub,ug,ux,ux,ub,ub,ub,ub,ux,ux,ux,ux,ux,ux,cr
ug,ux,ux,ux,ux,ux,ux,ux,ub,ug,ux,ux,ub,ub,ub,ub,ux,ux,ux,ux,ux,ux,ub
ug,ux,ux,ux,ux,ux,ux,ux,ub,ug,ux,ux,ux,ux,ub,cb,ux,ux,ux,ux,ux,ux,ub
ug,ux,ux,ux,ux,ux,ux,ux,cg,ux,ux,ux,ux,ux,ux,ux,ux,ux,ux,ux,ux,ux,ub
ug,ub,ub,ub,ub,ub,ub,ub,ug,ub,ub,ub,ub,ub,ub,ub,ub,ub,ub,ub,ub,ub,ub
ug,ux,ux,ux,ux,ux,ux,ux,ug,ux,ux,ux,ux,ux,ux,ux,ux,ux,ux,ux,ux,ux,cb
ug,ug,ug,ug,ug,ug,ug,ug,ug,cg,ux,ux,ux,ux,ux,ux,ux,ux,ux,ux,ux,ux,ux