ur,ur,ur,ur,ur,ur,ur,ur,ur,ur,ur,ux,ux,ux,ux,ux,ux,ux,ux,ux,ux,cb,ux
ur,ur,ur,ur,ur,ur,ur,ur,ur,ur,cr,ux,ux,ux,ux,ux,ux,ur,ux,ur,ub,ub,ux
ur,ur,ur,ur,ur,ur,ur,ur,ur,ur,ur,ux,ux,ux,ux,ux,ux,ur,ux,ub,ub,ux,ux
ur,ur,ur,ur,ur,ur,cr,ur,ur,ur,ur,ux,ux,ur,ur,ur,ur,ur,ub,ub,ux,ux,ux
ur,ur,ur,ur,ur,ur,ur,ur,ur,ur,ur,ur,ur,ur,ur,ur,ur,ub,ub,ur,ux,ux,ux
ux,ux,ur,ur,ur,ur,ur,ur,ur,ur,ur,ur,ur,ur,cr,ur,ub,ub,ur,ur,ux,ux,ux
ur,ur,ur,ux,ur,ur,ur,ur,ur,ur,ur,ur,ug,ur,cr,ur,ur,ur,ur,ur,ur,ur,ur
ur,ur,ux,ur,ur,ur,ur,ur,ug,cr,ur,ur,ur,ur,ur,ur,ub,ub,ub,ub,ub,ub,cb
cg,ur,ux,ur,ur,ur,ur,ur,ug,ur,ur,ur,ur,ur,ur,ur,ur,ur,ux,ux,ux,ux,ur
ur,ur,ux,ur,ur,ur,ub,ub,ug,ub,ur,ur,ub,ur,ub,ur,ur,ub,ur,ur,ur,ur,ur
ur,ub,ux,ur,ux,ur,ub,cg,ug,ub,ur,ur,cb,ur,ub,ub,ub,ub,ur,ur,ur,ub,ub
ur,ub,ur,ur,ur,ur,ub,ub,ub,ub,ub,ub,ub,ub,ub,ub,cb,ur,ur,ur,ur,ub,ub
ur,ur,ur,ur,ur,ub,ub,ub,ub,ub,ub,ub,ub,cb,ub,ub,ub,ub,ux,ux,ux,ub,ub
ur,ur,ur,ur,ur,ur,ux,ub,ub,ub,ug,ub,ub,ub,ub,ub,ub,ub,ub,ux,ux,ub,ub
cg,ub,ux,ux,ux,ug,ug,ug,ug,ug,ub,ub,ug,ub,ub,ub,ub,ub,ub,ux,ux,ub,ub
ub,ub,ux,ux,ux,ug,ux,ux,ub,ub,ug,ug,ug,ug,ub,ug,ug,ug,ux,ux,ux,cg,ug
ub,ub,ux,ux,ux,ug,ux,ux,ux,ux,ug,ub,ub,ub,ub,ug,ug,ug,ux,ux,ux,ub,ug
ux,ub,ux,ux,ux,ug,ug,ug,ug,ug,ug,ub,ub,ub,ub,ug,ug,ug,ub,ug,ug,ub,ug
ux,ug,ug,ug,ub,ub,ub,ub,ub,ub,ub,cg,ug,ug,ug,ug,ug,ug,ub,ux,ux,ub,ug
ux,ug,ub,ug,ub,ub,ub,ub,ub,ub,ub,ux,ur,ux,ur,ug,ux,ub,ug,ug,ux,cb,ug
ux,ug,ub,ug,ug,ug,ug,ug,ug,ug,ug,ug,ug,ug,ug,ug,ug,ub,ug,ug,ug,ur,ub
ub,ug,ug,ug,ub,ub,ub,ug,ug,ug,ug,ug,ug,ug,ur,ug,ux,ub,ux,ux,ug,ur,ub
ub,ub,ub,ug,ug,ug,ug,ug,ub,cg,ub,ub,ur,ug,ug,ug,ug,ug,ug,ug,ug,cr,ub