ur,ur,ur,ur,ur,ur,ur,cr,ub,cr,ur,ur,ur,ur,ur,ur,ur,cb,ur,ur,ur,ur,ur
ur,ur,ur,ur,ub,ur,ur,ur,ur,ur,ur,ur,ur,cg,ur,ug,ug,ug,ur,ur,ur,ur,ur
ur,ur,ur,ur,ub,ur,ur,ug,ug,ug,ug,ug,ur,ug,ur,ug,ur,ug,ur,ur,ur,ur,ur
ur,ur,ur,cr,ub,ur,ur,ug,ug,ux,ux,ug,ug,ug,ug,ug,ug,ug,ub,ur,ur,ub,ur
ug,cr,cb,ur,cb,ug,ur,ur,ug,ug,ur,ug,ug,ub,ub,ug,ug,ug,ug,ug,ur,ur,ur
ug,ub,cr,ur,ur,ug,ur,ug,ug,ug,ug,ur,ug,ub,ub,ub,ug,ub,ug,ug,ux,ub,ux
ug,ub,ur,cb,ur,ug,ur,ux,ux,ug,ug,ug,ug,ub,ub,ug,ug,ub,ug,ug,ub,ub,ux
ug,ub,ub,ub,ub,ug,ug,ug,ug,ug,ur,ug,ug,ub,ub,ug,ug,ub,ug,ug,ub,ux,ux
ug,ub,ub,ub,ur,ur,ux,ur,ux,ur,ux,ug,ug,ug,ug,ug,ug,ug,ug,ug,ux,ux,ux
ug,ub,ub,ub,ub,ux,ux,ur,ur,ur,ub,ub,ug,ug,ug,ug,ug,ug,ur,ug,ux,ux,ux
cg,ub,ub,ub,ub,ug,ug,ug,ub,ub,ug,ug,ug,ug,ug,cg,cb,ub,ur,ug,ux,ux,ux
ux,ux,cb,ub,ux,ux,ux,ux,ux,ub,ub,ub,ug,ug,ug,ub,ub,ub,ur,ug,ux,ux,ux
ux,ux,ux,ub,ux,ux,ux,ux,ug,ub,ub,ub,ub,ug,ug,ub,ub,ub,ur,ug,ux,ux,cg
ux,ux,ux,ub,ux,ux,ux,ux,ub,ub,cb,ub,ug,ug,ug,ub,ug,ub,ur,ug,ux,ux,ux
ub,ux,ux,ub,ux,ux,ux,ux,ub,ub,ug,ub,ug,ug,ug,ub,ug,ub,ur,ug,ux,ux,ux
ub,ux,ux,ub,ux,ux,ux,ux,ux,ub,ub,ub,ux,ur,ug,ub,ug,ux,ur,cg,ux,ux,ux
ub,ub,ub,ub,ux,ux,ux,ux,ux,ug,ug,ug,ug,ur,ug,ub,ug,ux,ur,ux,ux,ux,ux
cg,ur,ur,ur,ur,ur,ur,ur,ur,ur,ur,ur,ur,ur,ur,cr,ug,ux,ur,ux,ux,ux,ux
ux,ur,ux,ug,ux,ux,ux,ux,ux,ux,ux,ux,ux,ur,ux,ux,ug,ux,ur,ux,ux,ux,ux
ux,ur,ux,ug,ux,ux,ux,ux,ux,ux,ux,ux,ux,ur,ux,ux,ug,ux,ur,ux,ux,ux,ux
ux,ur,ux,ug,ux,ux,ux,ux,ux,ux,ux,ux,ux,ur,ux,ux,ug,ux,ur,ux,ux,ux,ux
cr,ur,ux,ug,ux,ux,ux,ux,ux,ux,ux,ux,ux,ur,ux,ux,ug,ux,ur,ux,ux,cb,cr
cg,ur,ur,ur,ur,ur,ur,ur,ur,ur,ur,ur,ur,ur,ur,ur,ur,ur,ur,cg,cb,ux,cr