cb,cb,cb,cr,ur,ur,ur,ur,ur,ur,ur,ur,ur,ur,ur,ur,ur,ur,cr,ur,ur,ur,cb
cb,ur,ur,ur,ur,ur,ur,ur,ur,ur,ur,ur,ur,ur,ur,ub,ub,ub,ug,ur,ur,ur,ur
ub,ur,ur,cr,ur,ur,ur,ur,ur,ur,ur,ur,ur,ur,ur,ub,ub,cb,ug,ug,ug,cr,ur
ub,cr,ub,cg,ug,ur,ur,ur,ur,ur,ur,ur,ur,ur,ur,ub,ub,ur,cg,ur,ur,ur,ur
ub,ug,cg,ug,ug,ur,cr,ur,ur,ur,ur,ux,ur,ur,ur,ub,ur,ur,ub,ub,ub,ur,ur
ub,ub,ub,ub,ug,ur,ug,ur,ur,ur,ur,ur,ur,ur,ur,ur,ur,ur,ur,ub,ub,ux,ux
ub,ub,ub,ub,ug,ub,ur,ur,ur,ur,ug,ux,ux,ux,ub,ux,ur,ur,ur,ug,ub,ux,ux
cb,ux,ub,ub,ug,ug,ub,ub,cb,ur,ug,ux,ux,ux,ub,ux,ur,ug,ur,ug,ug,ux,ux
ux,ur,ur,ub,ug,ug,ub,ub,ub,ub,ug,ux,ux,ug,ug,ug,ur,ug,ur,ug,ug,ug,ux
ux,ub,ub,ub,ug,ur,ub,ub,ub,ub,ub,ub,ux,ug,ub,ug,ur,ug,ur,ug,ux,ug,ux
ux,ub,ub,ur,ug,ug,ub,ub,ub,ub,ub,ub,ug,ug,ux,ug,ur,ug,ur,ug,ux,ug,ux
ux,ur,ub,ur,ur,ug,ub,ug,ug,ub,ub,ub,ug,ug,ug,ug,ug,ug,ur,ug,ub,ug,ux
cb,ux,ub,ub,ur,ur,ub,ub,ub,ub,cb,ub,ub,ug,ug,ug,ug,ug,ur,ug,ub,ug,ux
ux,ux,ur,ub,ug,ub,ub,ub,ub,ub,ub,ug,ug,ug,ug,ug,ug,ug,ur,ug,ux,ug,ux
cb,ub,ub,ub,ug,ub,ub,ub,ub,ub,ug,ug,ug,ug,ug,ug,ug,ug,ur,ug,ux,ug,ux
ux,ux,ux,ux,ug,ub,ux,ux,ux,ub,ug,ug,ug,ug,ug,ux,ug,ug,ur,ug,ub,ug,ux
ux,ux,ux,ux,ub,ub,ux,ux,ux,ux,ug,ux,ug,ux,cg,ug,ug,ux,cr,cg,ux,ug,ux
cr,ux,ux,ux,ub,ub,ub,ub,ub,ub,ug,ug,ug,ub,ub,ub,ur,ub,ub,ub,ub,ug,ub
cg,ux,ux,ux,ub,ux,ux,ux,ux,ux,ux,ux,ux,ux,ux,ux,ur,ux,ux,ux,ux,ug,ub
cb,ub,ub,ub,ub,ub,ub,ub,ub,ub,ub,ub,ub,ub,ub,ub,ur,ug,ug,ug,ug,ug,ub
ux,ub,ux,ux,ux,ux,ux,ux,ux,ux,ux,ux,ux,ux,ux,ux,ur,ux,ux,ux,ux,ux,cr
cr,ub,ub,ub,ub,ub,ub,ub,ub,ub,ub,ub,ub,ub,ub,ub,ur,cb,cg,ux,cb,ux,cr
cg,cb,cg,cb,ux,ux,ux,ux,ux,ux,ux,ux,ux,ux,ux,cg,ur,ur,ur,cg,cg,ux,cr