ur,ur,cb,ur,ur,ur,ur,ug,cr,ur,ur,ur,ur,ur,ur,ur,ur,cb,ur,cg,ur,ur,ux
ur,ur,ur,ur,ur,ur,ur,ur,ug,ur,ur,ur,ur,ur,ur,ur,ur,ur,ur,ur,ur,ur,ur
ur,ur,ur,ur,ur,ux,ur,ur,ug,ur,ur,cr,ur,ur,ur,ur,ur,ur,ur,ur,ur,ur,ur
ur,ur,ur,ur,ur,ur,ur,ur,ug,ug,ur,ug,cg,ur,ur,ur,ur,cg,ur,ur,ur,ur,ur
ur,ur,ur,ur,ur,ur,ur,ur,ur,ug,ug,ur,cb,ur,ur,ur,ur,ug,ur,ur,ur,ur,ur
ur,ur,ur,ur,ur,cg,ur,ur,ur,ur,ug,ur,ub,cr,ur,ub,ur,ug,ug,ur,ur,ur,ur
ur,ur,ur,ur,ur,ug,ur,ub,cb,ur,ur,ub,ub,ub,ur,ub,ug,ug,ug,ug,ur,ur,ur
ur,ur,ur,ur,cr,cr,ur,ub,ub,ub,ub,ub,ub,ub,ub,ub,ug,ur,ug,ur,ur,ur,ur
ur,ur,ur,ur,ur,ur,ur,ur,ub,ub,ug,ub,ub,ub,ug,ux,ug,ug,ug,ur,ux,ux,ux
ur,ur,ur,ur,ur,ub,ub,ub,ub,ub,ug,ug,ug,ug,ug,ub,ux,ux,ug,ur,ux,ux,ux
ux,ux,ub,ug,ug,ug,ug,ub,ub,ug,ug,ug,ug,ug,ug,ub,ub,ux,ub,ub,ub,ub,ub
ux,ux,ub,ug,ug,ug,ub,ug,ug,ug,ug,ug,ug,ug,ug,ug,ug,ug,ub,ur,ug,ux,cb
ug,cg,ub,ug,ug,ux,ub,ug,ug,ug,ug,ug,ug,ug,ug,ug,ug,ug,ub,ub,ug,ux,ux
ux,ux,ub,ug,ux,ux,ux,ug,ug,ug,ug,ug,ug,ug,ug,ux,ux,ux,ug,ub,ug,ux,ux
ux,ux,ub,ug,ux,ux,ux,ug,cg,ux,ug,ug,ug,ug,ug,ux,ub,ub,ub,ub,ug,ux,ux
ux,ux,ub,ug,ux,ux,ux,ux,ux,ux,ug,ug,ug,ug,ug,ux,ub,ub,ug,ub,ug,ux,ux
ux,ux,ub,ug,ux,ux,ux,ux,ux,ux,ux,ug,ug,ux,ux,ux,ux,ub,ub,ub,ub,ux,ux
cg,ux,ub,ug,ux,ux,ux,ux,ux,ux,ux,ug,ug,ux,cr,ux,ux,ux,ub,ur,ub,ub,ux
ux,ux,ub,ug,ux,ux,ux,ux,ux,ux,ug,ug,ug,ux,ur,ux,ux,ux,ug,ur,ug,ub,ux
ux,ux,ub,ug,ux,ux,ux,ux,ux,ux,ux,ux,ux,ux,ur,ux,ux,ux,ug,ur,ug,ux,ux
cr,ux,ub,ug,ug,ug,ug,ub,ub,ub,cb,ug,ug,ug,ur,ug,ug,ug,ug,ur,ux,ux,ux
cg,ux,ub,ub,ub,ub,ub,ub,ux,ux,ux,ux,ux,ux,ur,ux,ux,ux,ux,ur,ux,cb,cr
cr,ux,ub,ub,ux,ub,ub,ux,ux,ux,ux,ux,ux,cb,ur,ur,ur,ur,ur,ur,cb,ux,cr