ur,ur,ur,ur,ux,ur,ur,ur,ur,cg,ur,ur,ur,ub,ub,ub,ub,cb,ux,ux,ux,ub,ub
ur,ur,ur,ur,cr,ur,ur,ur,ub,ub,ur,ur,ur,ub,ub,ub,ub,ug,ug,ug,ub,ub,ub
ur,ur,ur,ur,ub,ur,ug,cg,ug,ub,ur,cr,ug,ug,ug,ug,ug,ux,ux,ug,ug,ug,ug
ux,ur,ug,cr,cr,ug,cg,ug,ug,ub,ug,ug,ug,ug,ub,ux,ug,ux,ux,ug,ux,ux,ug
ux,ur,ur,ug,ug,ur,ug,ug,ug,cr,ug,ug,ug,ug,ug,ux,ug,ux,ux,ub,ub,ub,ub
ux,ur,ur,ug,ub,ur,ug,cb,ug,ur,ug,ug,ug,ub,ug,ug,ug,ub,ub,ub,ub,ub,ub
ur,ur,ur,ug,ug,ur,ur,ub,ub,ur,ub,ub,ug,ug,ug,ug,ug,ux,ux,ub,ub,ub,ub
ur,ur,ur,ub,ur,ug,ur,ub,ug,ug,ug,cb,ub,ub,ub,ug,ug,ux,ux,ub,ux,ux,ub
ur,ur,ur,ub,ub,ub,ub,ub,ur,cg,ub,ub,ub,ub,ug,ug,ux,ux,ux,ub,ux,ux,ub
ur,ur,ur,ur,ug,ug,ub,ub,ub,ug,ub,ub,ub,ub,ug,ux,ub,ux,ux,ub,ux,ux,ub
ur,ur,ur,ur,ug,ux,ub,ub,ub,ug,ug,ug,ug,ug,ub,ub,ub,ux,ux,ub,ux,ux,ub
ub,ux,ux,ux,ug,ux,ub,ub,ub,ub,ub,ub,ub,ub,ub,ub,ub,ux,ux,ub,ub,ub,ub
ub,ux,ux,ux,ug,ug,ug,ug,ug,ub,ux,ug,ub,ub,ub,ub,ub,ub,ub,ub,ub,ub,ug
ub,ux,ug,cr,ug,ug,ug,ug,ug,ub,ub,ug,ub,cg,ub,ub,ub,ux,ux,ub,ub,ub,ug
ub,ux,ux,ur,ux,ub,ug,cb,ug,ug,ub,ub,ug,ug,ub,cb,ub,ux,ux,ub,ub,ub,ug
ub,ux,ux,ur,ub,ub,ug,ub,ug,ug,ug,ug,ug,ug,ub,cb,ub,ux,ux,ub,ub,ub,ug
ub,ub,ub,ur,ub,ux,ub,ub,ug,ug,ux,ub,ub,ub,ub,ux,ub,ux,ux,ub,ub,ub,ug
ur,ur,ub,ur,ub,ub,ub,ub,ub,ub,ub,ub,ub,ub,ub,ur,ur,ur,ur,ub,ur,ur,ug
ur,ux,ub,ur,ub,ub,ub,ub,ux,ux,ug,ub,ub,ub,ug,ux,ux,ux,ux,ub,ur,ur,ug
ur,ux,ub,ur,ux,ub,ub,ub,ub,ub,ug,ub,ug,ug,ug,ux,ux,ux,ux,ub,ur,ur,ug
ur,ur,ur,ur,ug,ug,ug,ug,ug,ug,ug,ug,ug,ug,ug,ug,ug,ug,ug,cb,ug,ug,ug
cr,ux,ur,ur,ug,ub,ub,ub,ux,ub,ub,ub,ub,ub,ub,ur,ur,ur,ur,ur,ur,ur,cb
cg,ux,ur,ur,ug,ug,ug,ug,ug,ug,ug,ug,ug,cg,ub,ur,ur,ur,ur,ur,ur,ur,ur