ux,ur,ur,ur,ur,ur,ur,ug,cb,ub,ub,ub,ub,cr,ur,ur,ur,ur,ur,ur,ur,ur,ur
ur,ur,ur,cr,ur,ur,ur,ug,ur,ur,ux,ur,ur,ur,ur,ur,ur,ur,ur,ur,ur,ur,ur
ur,ur,ur,ub,cb,ur,ur,ug,ur,ur,ur,ur,ux,ux,ux,ur,ur,ur,ur,ur,cr,ur,ur
ur,ur,ur,ur,ur,ur,ur,ug,ug,ur,ur,ur,ur,ur,ur,ur,ur,ur,ur,ur,ux,ur,ur
ur,ur,ur,ur,ur,ur,ur,ur,ug,ug,ur,ur,ur,ur,ur,ur,ur,ur,ur,ur,ur,ur,ur
ur,ur,ur,ur,ur,ur,ur,ur,ur,ug,ur,ur,ur,ur,ur,ur,ur,ur,ur,ur,ur,ur,ur
ur,ur,ur,ur,ur,ur,ur,ur,ur,ug,ur,ur,ur,ug,ug,ug,ux,ug,ux,ux,ub,ub,ub
ux,cr,ur,ur,ub,ur,ur,ur,ur,ug,ur,ur,ur,ug,ug,ug,ug,ug,ux,ux,ub,ub,ub
cg,ur,ur,ug,ub,ug,ux,ug,ug,ug,ub,ub,ub,ub,ug,ug,ug,ug,ug,ug,ub,ub,ub
cr,ur,ug,ug,ug,ug,ub,ub,ub,ug,ub,ub,ub,ub,ug,ub,ug,cg,ug,ug,ub,ub,ub
ux,ux,ug,ub,ug,ug,ub,ub,ub,ug,ug,ub,ub,ub,ug,ug,ug,ub,ux,ux,ub,ub,ub
ux,ux,ug,ub,ug,ug,ub,ux,ux,ub,ug,ub,ub,ug,ug,ug,ug,ux,ur,ur,ub,ub,ub
ux,ux,ug,ub,ug,ug,ub,ub,ub,ub,cg,ub,ub,ug,ug,ug,ug,ub,ub,ux,ub,ux,ub
ux,ux,cg,ux,ug,ug,ub,cb,ub,ub,ux,ux,ub,ug,ug,ub,ub,ub,ub,ux,ub,ux,ub
cg,ux,ub,ug,ug,ug,ub,ub,cb,ub,ux,ux,ux,ub,ub,ub,ub,ux,ux,ux,ub,ub,ub
ug,ug,ub,ug,ug,ug,ug,ug,ug,ug,ug,ug,ug,ug,ub,ub,ub,ub,ub,ub,ug,ug,ug
ug,ux,ub,ug,ug,ug,ux,ux,ug,ux,ux,ux,ux,ux,cb,ub,ub,ub,ux,ub,ux,ux,ur
ug,ux,ub,ug,ug,ug,ux,ux,ug,ux,ux,ux,ux,ux,ux,ub,ub,ub,ub,ub,ux,ux,ur
ug,ux,ub,ug,ug,ug,ux,ux,ug,ux,ux,ux,ux,ux,ux,ub,ub,ux,ux,ux,ux,ux,ur
ug,ux,ub,ug,ug,ug,ux,ux,ug,ux,ux,ux,ux,ux,ux,ux,ux,ux,ux,ux,ux,ux,ur
ub,ub,ub,ur,ur,ur,ur,ur,ur,ur,ur,ur,ur,ur,ur,ur,ur,ur,ur,ur,ur,ur,ur
ub,ux,ux,ux,ux,ux,ux,ux,ub,ub,ub,ub,ub,ub,ub,ub,ub,ub,ub,ub,ub,ur,ur
ub,ub,ub,ub,ub,ub,ub,ub,ub,cg,ux,ux,ux,ux,ux,ux,cr,ur,cb,ub,ub,ur,ur