ur,ur,cb,ux,ur,ur,ur,ur,ur,ur,ur,ur,ur,ur,ur,ur,ur,ur,ur,cg,cg,ug,ur
ux,ur,ur,cr,ur,ur,ur,ur,ur,ur,ur,ur,ur,ur,ur,ur,ur,ur,ur,ur,ur,ug,ur
ux,ur,ur,ur,ur,ur,ur,ur,ur,ur,ur,ur,ur,ur,cb,ub,ur,ur,ur,cr,ur,ug,ur
ux,ur,ur,ur,ux,ub,ub,ub,ub,ur,ug,ug,ug,cr,cr,ub,ur,ur,ur,ur,ur,ug,ur
ur,ur,ur,ur,ur,ub,ur,ur,ug,ug,ug,ug,ug,ub,ur,ur,ur,ur,cr,ur,ur,ug,ur
ur,ur,ur,ug,ur,ub,ur,ur,ug,ug,ug,ug,ug,ug,ub,ur,ur,ux,ux,ur,ur,ug,ur
ub,ub,ub,ug,ur,cg,ug,ug,ug,ug,ug,ug,ub,ug,ug,ur,ur,ug,ug,ur,ur,ug,ur
ub,ur,ur,ug,ug,ug,ug,ug,ug,ug,ux,ux,ux,ub,ub,ur,ur,ug,ug,ug,ug,ug,ur
ub,ur,ur,ug,ug,ub,ug,ug,ug,ug,ug,ug,ub,ub,ub,ur,ur,ur,ur,ug,ur,ur,ur
ub,ub,ux,ug,ug,ub,ug,ug,ug,ug,ug,ub,ub,cb,ub,ur,ur,ur,ur,ur,ur,ur,ur
cb,ub,ux,ub,ug,ub,ux,ug,ub,ub,ub,ub,ub,ub,ub,ub,ub,ur,ur,ur,ur,ur,ur
ux,ub,ux,ub,ug,ub,ug,ug,ub,ub,ub,ub,cg,ug,cb,ub,ug,ug,ur,ur,ur,ug,ur
ub,ub,ux,ub,ux,ub,ug,ug,ug,ug,ub,ub,ub,ug,ub,ub,ug,ux,ub,ub,ug,ug,ur
ub,ub,ub,ub,ux,ub,ug,ug,ug,ug,ug,ub,ub,ug,ub,ug,ug,ub,ub,ub,ug,ug,ur
ux,ux,ux,ux,ux,ub,ug,ux,ux,ug,ug,ug,ug,ub,ub,ug,ug,ub,ub,ub,ug,ug,ur
cg,ug,ug,ug,ug,ub,ug,ug,ug,ug,ug,ug,ub,ub,ub,ub,ub,ub,ux,ub,ug,ug,ur
ux,ug,ug,ux,ug,ug,ug,ug,ug,ug,ug,ug,ub,ub,ug,ug,ug,ug,ug,ub,ug,ux,ur
ux,ug,ug,ux,ug,ug,cg,ub,ub,ub,ug,ug,ug,ug,ug,ub,ug,ug,ux,ub,ux,ub,ur
ux,ug,ug,ug,ub,ub,ux,ub,ub,ub,ub,ub,ug,ub,ug,ug,ug,ux,ux,ub,ub,ub,ur
ux,ug,ug,ub,ub,ug,ux,ux,cb,ub,ub,ux,ux,ug,ug,ug,ux,ux,ux,ub,ub,ug,ur
cr,ug,ug,ub,ux,ug,ux,ux,ug,ub,ub,ur,ur,ur,ur,ug,ur,ur,ur,ur,ur,ur,ur
cg,ug,ug,ub,ug,ug,ux,ux,ug,ug,ux,ur,ur,cr,ux,cg,ug,ux,ux,ur,ux,cb,cr
cr,ug,ug,ub,ub,ub,cb,ug,ug,ug,ur,ur,ur,ur,ur,ur,ur,ur,ur,ur,cb,ux,cr