ur,ur,ur,ur,ur,ur,ur,ur,ur,ur,ur,ub,ug,ug,ub,ub,ur,cb,ur,cg,ur,ur,ur
ur,ur,ur,ur,ur,ur,ur,ur,ur,ur,ur,ub,cg,ub,ub,ub,ub,ub,ur,ur,ur,ur,ur
ur,ur,ur,ur,cr,ur,ur,ur,ur,ur,ur,ub,ug,ug,ub,ub,ub,ub,ug,cr,ur,ux,ur
ur,ur,ub,ur,cr,ug,ur,ug,ug,ub,ub,ug,ug,ub,ub,ur,ub,ur,ug,ux,ur,ur,ur
ur,cr,ur,ub,ub,cr,ur,ub,ur,ub,ur,ub,ug,ug,ur,ur,ur,ur,ug,ux,ux,ur,ux
ub,ub,ur,ub,ur,ub,ub,ub,ub,ub,ub,ub,ub,ug,ug,ux,ux,ur,ur,ur,ur,ur,ur
ub,ub,ur,ur,ur,ug,ub,ub,ub,ub,ub,ub,ub,ub,ug,ux,ux,ur,ux,ux,ux,ux,cr
ub,ub,ub,ux,ug,ug,ub,ug,ug,ub,ub,ub,ub,ub,ug,ux,ux,ur,ux,ux,ux,ux,ux
ux,ux,ux,ux,ux,ux,ub,ug,ug,ug,ub,cb,ug,ub,ug,cb,ux,ur,ux,ux,ux,ux,ux
ux,ux,ux,ub,ub,ub,ub,ug,ub,ug,ux,ux,cg,ub,ub,ub,ux,ur,ux,ux,ux,ux,ux
ux,ux,ux,ub,ub,ub,ub,ux,ub,ux,ux,ug,cg,ub,ub,ub,ux,ur,ux,ux,ux,ux,ux
ux,ux,ux,ux,ub,ub,ub,ux,ug,ug,ub,ug,ub,ug,cg,ub,ux,ur,ux,ux,ux,ux,ux
cg,ug,ug,ug,ug,ug,ug,ug,ug,ug,ug,ug,ug,ug,ub,ub,ux,ur,ub,ux,ux,ux,ux
ux,ux,ux,ub,ub,ub,ug,ug,ug,ug,ug,ug,ug,ug,ub,ub,ug,cb,ub,ub,ub,ux,ux
ux,ux,ux,ub,ub,ub,ub,ug,ug,ug,ug,ug,ug,ub,ub,ub,ub,cb,ux,ux,ub,ux,ux
ux,ux,ux,ux,ug,ug,ug,ux,ug,ux,ug,ug,ug,ub,ub,ub,ub,ub,ub,ux,ub,ux,ux
ux,ux,ux,ux,ug,ug,ug,ug,ug,ug,ug,ub,ub,ub,ub,ub,ub,ub,ub,ub,ub,ug,ug
cg,ux,ux,ux,ug,ug,cb,ub,ug,ug,ug,cb,ub,ub,ug,ug,ug,ub,ub,ub,ub,ub,ug
ur,ur,ur,ur,ur,ur,ub,ub,ug,ub,ub,ub,ub,ug,ug,ub,ub,ub,ub,ub,ub,ub,ug
ur,ur,ur,ur,ur,ur,ur,ub,ub,ub,ub,ub,ub,ur,ub,ub,ug,ub,ug,ug,ub,ug,ug
cr,ux,ux,ux,ux,ux,ux,ux,ug,ug,ug,ux,ug,ur,ub,ub,ux,ub,ub,ub,ub,ub,ub
cg,ux,ux,ux,ux,ux,ux,ux,ux,ux,ug,ug,ug,ur,ub,ub,ub,ub,ux,ub,ub,cb,cr
cr,ux,ux,ux,ux,ux,ux,ux,ux,ux,ux,ux,ux,ur,ur,ur,ur,ub,ub,ub,cb,ux,cr