ur,ur,ur,ur,ur,ur,ur,ur,ur,ur,ur,ux,ux,ux,ux,ux,ux,cb,ur,ur,ub,ub,ub
ur,ur,ur,ur,cb,ub,ub,ub,ub,ub,ub,ub,ub,ub,ub,ub,ub,ub,ub,ub,ur,ur,ub
ur,ur,ur,ur,ur,ur,ur,ur,ur,ur,ur,ur,ux,ur,ur,ur,ur,ur,ur,ub,ub,ub,ub
ur,ur,ur,ur,ur,ur,ur,ur,cr,ug,ur,ur,ur,ur,ur,ur,ur,ur,ur,ub,ux,ux,ux
cb,cb,ur,ur,ur,ur,cg,ur,ur,cg,ur,ur,ur,ur,ur,ur,ur,ub,ux,ux,ux,ux,ux
ur,ub,ur,ur,ur,ug,ug,ug,ub,cb,ur,ur,ur,ur,ur,ur,ur,ub,ug,ug,ug,ur,ur
cr,ub,ur,ur,ur,ug,ug,ug,ub,ub,ur,ur,ur,ur,ur,ug,ur,ur,ug,ur,ug,ur,ur
ur,ur,ur,ur,ur,ug,ug,ub,ub,ub,ur,cr,ur,ur,ur,ur,ur,ur,ur,ur,ur,ur,cr
ub,ub,ub,ub,ub,ug,ug,ub,ub,ur,ur,ub,cb,ur,ur,ug,ux,ux,ug,ux,ug,ux,ux
ub,ub,ub,ub,ub,ug,ug,ub,ub,ug,ur,ur,ur,ur,ur,ug,ug,ug,ug,ux,ug,ux,ux
ub,ub,ub,ur,ur,ur,ur,ur,ug,ug,ug,cr,cr,ur,ur,ug,ux,ug,ug,ux,ug,ux,ux
ub,ub,ub,ur,ur,ur,ur,ur,ur,ur,ur,ux,ux,ux,ug,ug,ux,ug,ug,ux,ug,ux,ux
ub,ub,ub,ux,ux,ub,ub,ux,ub,ux,ux,ux,ux,ux,ug,ux,ux,ug,ug,ux,ug,ux,cg
ub,ub,ub,ux,ux,ub,ub,ub,ub,ug,ug,ux,ux,ux,ug,ux,ux,ug,ug,ux,ug,ux,ux
ug,ug,ug,ux,ub,ug,ug,ug,ug,ug,ug,ux,ux,ux,ug,ux,ux,ug,ug,ux,ug,ux,ux
ug,ux,ug,ux,ub,ug,ug,ug,ug,ug,ug,ux,ux,ux,ug,ux,ux,ux,ux,ux,ug,ux,ux
ug,ug,ug,ug,ug,ug,ug,ug,ug,ug,ug,ug,ug,ug,ug,ug,ug,ug,ug,ug,ug,ur,ur
cg,ug,ux,ux,ug,ux,ub,ub,ux,ux,cg,ug,ug,ug,ug,ux,ug,ug,ug,cg,ux,ux,ur
ur,ur,ur,ur,ug,ug,ug,ug,ug,ug,ug,ug,ug,ug,ur,ur,ug,ug,ug,ug,ug,ug,ur
ur,ug,ug,ug,ug,ug,ug,ux,ux,ux,ux,ux,ux,ug,ur,ug,ug,ug,ug,ug,ug,ug,ur
ur,ur,ur,ug,ug,ug,ug,ug,ug,ur,ur,ur,ur,ug,ug,ug,ur,ur,ur,ur,ur,ur,ur
cr,ux,ux,ug,ug,ug,ux,ux,ug,ug,ux,ux,ux,ux,ux,ux,ux,ux,ux,ux,ux,cb,cr
cg,ux,ux,ug,ug,ug,ug,ug,ug,ug,ux,ux,ux,cb,ux,ux,ux,ux,ux,cg,cb,ux,cr