ur,ur,cb,ur,ur,ur,ur,ur,ur,ur,ur,ur,ux,ur,ur,ur,ur,cb,ur,ur,ur,ug,ug
ur,ur,ur,ur,ur,ur,ur,ur,ur,ur,cr,ug,ug,ug,ur,ur,ur,cr,ug,ug,cg,ux,ug
ur,cr,ur,ur,ug,cg,ur,ur,ur,ur,ur,ur,ur,ug,ur,ur,ur,ur,ur,ur,ur,ux,ug
ur,ur,ur,ur,cr,ur,ur,ur,ur,ur,ur,ur,ux,ug,ur,ug,ur,ur,ub,ub,ub,ub,cb
ux,ur,ur,ur,ur,ur,ur,ur,ur,ur,cb,ub,ux,ug,ur,ub,ug,ub,ux,ug,ux,ub,ug
ux,ur,ur,ur,ur,ur,ur,ur,ur,ur,ub,ub,ur,ug,ur,ux,ug,ub,ux,ug,ux,ux,ug
ux,ur,ur,ur,ur,ur,ur,ur,ur,ur,ub,ub,ug,ug,ur,ub,ug,ub,ub,ug,ux,ux,ug
ux,ur,ur,ur,ur,ug,cg,ur,ur,ub,ub,ur,ur,ug,ur,ux,ug,ub,ux,ug,ux,ux,ug
ux,ux,ur,ur,ur,ug,ug,ug,ur,ur,ur,ur,ur,ug,ub,ub,ug,ug,ug,ug,ug,ug,ug
ur,ux,ux,ur,ur,cr,ur,ur,ur,ur,ur,ug,ur,ug,ub,ub,ug,ug,ux,ug,ug,ug,ug
ur,ux,ux,ur,ur,ur,ur,ug,ub,ub,ub,ub,ur,ug,ug,ug,ug,ug,ux,ug,ux,ux,ux
ur,ur,ur,ur,ur,ur,cb,ug,ug,ug,ug,ug,ug,ug,ug,ug,ug,ug,ug,ug,ug,ux,ux
cg,ur,ur,ur,ub,ub,ub,ux,ug,ug,ug,ux,ug,ug,ug,ug,ug,ug,ug,ug,ug,ux,ux
ur,ur,ub,ub,ub,ub,ug,ub,ug,ug,ug,ug,ug,ug,ug,ug,ug,ug,ux,ug,ug,ux,cb
ur,ub,ub,ub,ub,ub,ug,ub,cg,ug,ug,ug,ug,ug,ug,ug,ug,ux,ux,ug,ug,ux,ub
ub,ub,ub,ux,ux,ug,ug,ux,ux,ug,ug,ug,ug,ug,ug,ug,ug,ug,ug,ug,ug,ux,ub
ub,ub,ub,ub,ug,ug,ug,ur,ur,ug,ug,ug,ug,ug,ug,ug,ug,ur,ur,ug,ur,ur,ub
cg,ux,ux,ux,ug,ux,ug,ub,ub,ux,ux,ug,ug,ug,ug,ug,ug,ug,ux,ug,ux,ux,ub
ur,ur,ub,ub,ug,ug,ug,ub,ub,ub,ub,ub,ub,ub,ub,ub,ub,ub,ub,ub,ub,ub,ub
ub,ub,ub,ux,ux,ux,ub,cr,ur,ur,ur,ur,ur,ur,ur,ur,ur,ur,ur,ur,ur,ur,ur
ub,ub,ub,ub,ub,ub,ub,ub,ub,ub,ub,ub,ur,ur,ur,ur,ur,ur,ur,ug,ur,ur,ur
cr,ux,ux,ux,ub,ub,ub,ub,ux,ux,ub,ub,ux,ux,ux,ux,ux,ux,ux,ug,ux,cb,cr
cg,ux,ux,ux,ux,ux,ub,ub,ux,ux,ub,ub,ux,cb,ux,ux,ux,ux,ux,cg,cb,ux,cr