cb,cb,cb,cr,ur,ur,ur,ur,ur,ur,ur,ur,ur,cr,ux,ux,ux,ux,ux,ux,ur,ur,cb
ur,ur,ur,ur,ur,ur,ur,ur,ur,ur,cr,ux,ur,ur,ug,ug,ug,ug,ug,ug,ug,ur,ux
ur,ur,ur,ur,ur,ur,ub,ub,ub,cb,ur,ug,ug,ug,ug,ux,ux,ux,ux,ux,ug,ug,ux
ur,ur,ur,ur,cg,ur,ub,ur,cg,ug,ug,ur,ur,ur,ux,ug,ug,ug,ug,ug,ur,ug,ur
ur,ur,ur,cr,ug,ur,ub,ur,ur,ur,ur,ur,ur,ur,ur,ug,cr,ug,ug,ug,ug,ug,ur
ur,ur,ur,ur,ub,ur,ub,ug,ug,ug,ug,ur,ur,ur,ur,ug,ur,ux,ux,ug,ug,ur,ur
ur,ur,ur,ur,ub,ub,cr,cg,ug,ug,ug,ur,ur,ur,ur,ur,ur,ur,ur,ur,ur,ur,ur
cb,ur,ur,ur,ur,ur,ur,ug,ur,ur,ur,ur,ur,ur,ur,ur,ur,ur,cr,ux,ug,ux,ux
ur,ur,ur,ur,ur,ur,ur,ug,ur,ub,ub,ug,ub,ug,ug,ug,ug,ug,ug,ug,ug,ux,ux
ur,ur,ur,ur,ur,ur,ug,ux,ug,ub,ub,ub,ub,ug,ug,ug,ug,ug,ur,ur,ug,ur,ux
ub,ub,ub,ug,ug,ug,ub,ug,ug,ug,ub,ub,ub,ug,ug,ug,ug,ug,ur,ur,ug,ur,ux
ug,ub,ub,ug,ug,ug,ub,ug,ug,ug,ug,ug,ug,ug,ub,ug,ug,ug,ur,ur,ug,ug,ux
cb,ub,ug,ug,ug,ug,ub,ug,ug,ug,ug,ub,ub,ub,cg,ug,ug,ug,ux,ux,ux,ug,ux
ux,cb,ug,ug,ub,ub,ub,ug,ug,ug,ub,ub,ub,ub,ug,ub,ub,ub,ux,ux,ux,ug,ux
ux,ux,ug,ug,ug,ub,ub,ug,ug,ux,ub,ub,ub,ub,ub,ub,ub,ub,ux,ux,ux,ug,ux
ux,ux,ug,ug,ug,ub,ub,ub,ub,ub,ub,ub,ux,ug,ub,ub,ub,ux,ux,ux,ux,ug,ux
ux,ux,ug,ug,ug,ub,ug,ug,ug,ub,ux,ub,ub,cb,ub,ug,ug,ug,ug,ug,ux,ug,ux
cr,ux,ug,ug,ug,ub,ug,ug,ub,ub,ub,ub,ub,ub,ub,ug,ug,ug,ug,ug,ux,ug,ux
cg,ux,ug,ug,ug,ub,ug,ug,ub,ug,ug,ug,ub,ub,ug,ub,ub,ub,ub,ub,ub,ug,ub
cb,ux,ug,ug,cg,ub,ug,ug,ub,ug,ug,ug,cb,ub,ub,ub,ub,ub,ub,ub,ub,ub,cb
ux,ux,ug,ug,ug,ug,ug,ug,ub,ug,ug,ug,ux,ux,ux,ux,ux,ux,ux,ux,ux,ux,cr
cr,ux,ug,ug,ug,ub,ub,ug,ug,ug,ub,ub,ux,ux,ux,ux,ux,cb,cg,ux,cb,ux,cr
cg,cb,cg,cb,ux,ub,ub,ux,ub,ub,ub,ub,ux,ux,ux,cg,ux,ux,ux,cg,cg,ux,cr