ur,ur,ur,ur,ur,ur,ur,ur,ur,ur,ur,ur,ur,ux,ux,ux,ur,ur,ur,ur,ur,ur,ur
ur,ur,ur,ur,ur,ur,ur,ur,ur,ur,ur,ur,ur,ur,ur,ur,ur,ur,ur,ur,ur,ur,ur
ur,ub,cb,ur,ur,ur,ur,ur,ur,ur,ur,ur,ur,ur,ur,ur,ur,ur,ur,ur,ur,ur,ur
ux,ub,ur,ur,ur,ur,ur,ur,ur,ur,ur,ur,ur,ur,ur,ur,ur,ur,ur,ur,ur,ur,ur
ux,ub,ur,ur,ur,ur,ur,ur,ur,ur,ur,ur,ur,ub,ub,ur,ur,ur,ur,ur,ur,ur,ur
ur,ub,ur,cr,ur,ur,ur,ur,ur,ur,ur,ur,ur,cb,cr,ub,ub,ur,ur,ur,ur,ur,ur
ur,ub,ur,ug,ur,ur,ur,ur,ur,ur,ur,cr,ur,ur,ur,ug,ub,ur,ur,ur,ur,ur,ur
ur,ub,ur,ug,ug,ug,cr,ur,ur,ur,ug,ug,ub,cb,ub,ug,ub,ub,ub,ub,cr,ur,cb
cg,ub,ur,ur,ur,ug,ug,ur,ur,ug,ug,ug,ug,ur,ub,ub,ub,ur,ur,ur,ur,ur,ur
ur,ub,ur,ub,ux,ug,ug,ux,ur,ug,ug,ug,ug,ur,ub,ub,ux,ux,ux,ur,ur,ur,ur
ub,ub,ur,ub,ux,ug,cg,ur,ur,ux,ug,ug,ux,ub,ub,ub,ub,ux,ux,ux,ur,ub,ub
ub,ur,ur,ub,ur,cg,ur,ur,ub,ub,ug,ug,ub,ub,ub,ub,ub,ux,ux,ux,ur,ux,ub
ub,ur,ur,ub,ur,ur,ur,ur,ub,ub,ug,ug,ug,ug,ub,ub,ux,ux,ux,ux,ur,ux,ub
ub,ub,ur,ub,ur,ur,ur,ur,ub,ux,ug,cb,ub,ub,ub,ub,ub,ub,ub,ux,ur,ux,ub
cg,ub,ur,ub,ur,ur,ux,ux,ux,ux,ug,ug,ub,ub,ub,ug,ug,ug,ug,ug,ur,ub,ub
ux,ub,ux,ub,ux,ux,ux,ux,ux,ux,ub,ub,ub,ub,ub,ub,ub,ug,ug,ug,ur,ux,ur
ub,ub,ux,ub,ux,ux,ux,ux,ux,ux,ub,ub,ub,ug,ug,ug,ub,cg,ug,ux,ur,ur,ur
ub,ub,ur,ur,ur,cb,ur,ur,ur,ub,ub,ub,ub,ub,ug,ug,ug,ug,ur,ur,ur,ur,ur
ur,ub,ux,ub,ux,ub,ub,ux,ur,ur,ur,ur,cr,ub,ub,ub,ub,ub,ug,ub,ub,ux,ur
ur,ux,ux,ub,ux,ux,ub,ub,ur,ub,ub,ux,ub,ub,ub,ub,ub,ux,ux,ux,ux,ux,ur
ur,ux,ub,ub,ux,ux,ub,ub,ur,ux,ux,ux,ux,ur,ux,ux,ub,ux,ux,ux,ux,ux,ur
ur,ub,ub,ux,ux,ux,ux,ux,ur,ux,ux,ux,ux,ur,ux,ux,ux,ux,ux,ux,ux,ux,ur
ur,ur,ur,ur,ur,ur,ur,ur,ur,cg,ux,ux,ux,ur,ur,ur,ur,ur,ur,ur,ur,ur,ur