ux,ur,cb,ur,ur,ur,ur,ur,ur,ur,ur,ur,ur,ur,ur,ur,ur,ur,ur,cg,ur,ur,ux
ux,ur,ur,ur,ur,ur,ur,ur,ux,ur,ux,ur,ur,ur,ur,ur,ur,ur,ur,ux,ur,ur,ur
ur,ur,ur,ur,ur,ur,ur,ur,ur,ur,ux,ur,ur,ur,ur,ur,ur,ur,ux,cr,ur,ux,ur
ux,ux,ux,ur,ur,ur,ur,cb,ub,cr,ur,ur,ur,ur,ur,ur,ur,ur,ur,ur,ux,ux,ux
ux,ur,ur,ur,ur,ur,ur,ug,ug,ug,ug,ug,ug,ug,ug,cg,ur,ur,ur,ur,ub,ub,ub
ux,ur,ur,ur,ur,ur,ur,ug,ur,ur,ur,ur,ur,ur,ur,ur,ur,ur,ur,ub,ub,ub,ub
ux,ur,ur,ur,ur,ur,ur,cr,ur,ur,ur,ur,ur,cr,ur,ur,ur,ur,ur,ug,ug,ug,ub
ux,ur,ur,ur,ur,ur,ur,ur,ur,cr,ub,ur,ub,ub,ub,ub,ub,ub,ub,ug,ub,ug,ub
ux,ur,ur,ur,ur,ur,ur,ug,ug,ur,ur,ur,ug,ub,ub,ub,ub,ub,ub,ug,ug,ug,ux
ux,ux,ur,ur,ur,ug,ug,ug,ug,ug,ug,ug,ug,ub,ug,ug,ug,ug,ug,ug,cg,ux,ux
ur,ur,ur,ur,cg,ur,ur,ur,ug,ux,ux,ug,ug,ug,ug,ug,ug,ug,ux,ux,ur,ux,ux
ur,ur,ur,ur,ug,ux,ug,ug,ug,ux,ug,ug,ug,ub,ub,ub,ug,ug,ux,ux,ur,ux,ux
cg,ux,ux,ux,ug,ug,ug,ug,ug,ux,ug,ug,ub,ub,ub,ub,ug,ug,ub,ub,ur,ux,ux
ux,ux,ux,ux,ux,ug,ug,ux,ub,ug,ub,ug,ub,ub,cb,ug,ug,ug,ub,ux,ur,ux,ux
ux,ux,ux,ux,ux,ug,ug,ug,ub,ub,ub,ub,ub,ub,ub,ug,ug,ub,ub,ux,ur,ux,ux
ux,ux,ux,ux,ux,ug,ug,ug,ug,ug,ug,ub,ub,ub,ub,ub,ub,ub,cb,ux,ur,ux,ux
ux,ux,ug,ug,ug,ug,ug,ug,ug,ux,ug,ug,ub,ub,ub,ub,ub,ub,ub,ub,ur,ux,ux
cg,ux,ug,ug,ug,ux,ub,ub,ug,ug,ug,ug,ub,ug,ug,ug,ug,ug,ux,ub,ub,ub,ux
ug,ug,ug,ux,ug,ub,ub,ub,ug,ug,ug,ub,ub,ub,ux,ub,ub,ub,ux,ub,ub,ub,ux
ug,ug,ug,ug,ug,ub,cb,ub,ub,ub,ug,ux,ub,ub,ub,ux,ub,ub,ub,cb,ub,ub,ux
cr,ux,ug,ux,ug,ux,ub,ub,ub,ux,ug,ug,ub,ub,ub,ux,ub,ub,ub,ur,ub,ux,ux
cg,cb,ur,ub,ug,ug,ub,ug,ug,ug,ug,ug,ub,ub,ub,ub,ub,ub,ub,cr,ub,cb,cr
cr,ux,ur,ub,ug,ug,ug,ug,ub,ub,ug,ug,cg,ub,ub,ub,ub,ub,ub,ub,cb,ux,cr