cr,ur,ur,ur,ur,ur,ur,ur,ur,ur,ur,ur,ur,ur,ub,cr,ub,ub,ur,ur,ur,ur,ur
ub,ur,ur,ur,ur,ur,ur,ur,ur,ur,ur,ur,ur,ur,cb,ur,ub,ub,ub,ur,ur,ur,ur
ub,cb,ur,ur,ur,ur,ur,ur,ur,ur,ur,ur,ur,ur,ur,ur,ub,ub,ub,ur,ur,ur,ur
ur,ur,ur,ur,ur,ur,ur,ur,ur,ur,ur,ur,ur,ur,ur,ub,ub,ub,ub,ur,ur,ur,cb
ur,ur,ur,ur,ur,ur,ur,ur,ur,ur,ur,ur,ur,ur,ur,ub,ub,ur,ur,ur,ur,ur,ur
ur,ur,ur,ur,ur,ur,ug,cr,ur,ug,ur,ur,ur,ur,ur,ur,ug,ug,ub,ub,ur,ur,ur
ux,ux,ur,ux,ur,ur,ug,ug,ur,ug,ur,ur,ur,ur,ur,ur,ug,ug,ur,ur,ur,ur,ur
ux,ux,ur,ux,ur,ur,ug,ug,ur,cg,ur,ur,cr,ur,ug,ug,ug,ug,ur,ur,ur,ur,ur
cg,ur,ur,ur,ur,ur,ug,ux,ur,ur,ur,ur,ug,ug,ug,ug,ug,ug,ur,ur,ur,ur,ur
ur,ur,ur,ur,ur,ur,ug,ur,ur,ur,ur,ur,ub,ub,ug,ug,ug,ug,ur,ur,ur,ur,ur
ur,ur,ur,ur,ur,ur,ug,ur,ur,ur,ur,ur,ub,ub,ug,ug,ug,cg,ux,ur,ur,ur,ur
ur,ur,ur,ur,ur,ur,cr,ur,ur,ub,ur,cb,ug,ub,ub,ub,ub,ub,ub,ux,ur,ur,ur
ur,ur,ur,ur,ur,ur,ur,ug,ug,ub,ub,ub,ug,ux,ub,ub,ub,ub,ub,ux,ug,ux,ux
ur,ur,ur,ur,ur,ur,ur,ug,ub,ub,ub,ub,ub,ub,ub,ub,ub,ub,ub,ub,ub,ub,ub
cg,ur,ur,ur,ur,ur,ur,ux,ub,ub,ub,ug,cg,ub,ux,ub,cb,ub,ux,ug,ug,ux,ub
ug,ug,ug,ug,ug,ug,ug,ug,ug,ub,ug,ug,ub,ub,ug,ub,ub,ub,ug,ug,ux,ux,ub
ug,ux,ux,ug,ug,ug,ug,ug,ug,ux,ug,ux,ub,ub,ub,ub,ux,ux,ux,ux,ux,ux,ub
ug,ux,ux,ug,ux,ug,ug,ug,ug,ug,ug,ux,ub,ub,ub,ub,ux,ux,ux,ux,ux,ux,ub
ug,ux,ux,ug,ug,ug,ug,ux,ug,ux,ux,ux,ux,ux,ub,ub,ux,ux,ux,ux,ux,ux,ub
ug,ux,ux,ug,ug,ug,ug,ux,ug,ux,ux,ux,ux,ux,ux,ux,ux,ux,ux,ux,ux,ux,ub
ub,ub,ub,ub,ub,ub,ub,ub,ub,ub,ub,ub,ub,ub,ub,ub,ub,ub,ub,ub,ub,ub,ub
ub,ux,ux,ug,ug,ug,ug,ux,ug,ux,ux,ux,ux,ux,ux,ux,ux,ux,ux,ux,ux,ux,cb
ub,ub,ub,ub,ub,cb,ur,cr,ug,cg,ux,ux,ux,ux,ux,ux,ux,ux,ux,ux,ux,ux,ux