ux,cb,cb,cr,cb,ur,ur,ux,ux,ux,ur,ur,ur,ur,ur,ur,ur,ur,ur,ur,ur,ur,cb
ux,ux,cb,ux,ux,ur,ux,ux,ux,ux,ur,ur,ur,ur,ur,ur,ur,ur,ur,ur,ur,ur,ur
ux,ux,ux,ux,ux,ur,ux,ux,ux,ur,ur,ug,cr,ur,ur,ur,ur,ur,ur,cr,cr,ug,ug
ux,ux,ux,ux,ux,ur,ur,ur,ux,ur,ur,cg,ur,ur,ur,ur,ur,ur,ur,ur,ur,ur,ug
ub,ub,ub,ub,ub,ub,cb,ur,ur,ur,ur,ur,ur,ur,ur,ug,ug,cg,ur,ur,ur,ur,ug
ub,ub,ub,ub,ub,ub,ub,ur,ur,ur,ur,ur,ur,ur,ug,ug,ur,ur,ur,ur,ur,ur,ug
ux,ur,ur,ur,ur,ur,ub,ub,ur,ur,ur,ur,ur,ur,ug,ur,ub,cr,ur,ur,ur,ur,ug
cb,ur,ur,ur,ur,ur,ur,cr,ur,ur,ur,ur,ur,ur,ug,ug,ub,ug,ug,ug,ur,ur,cg
ur,ur,ux,ur,ur,ur,ur,ur,ur,ur,ur,ub,ub,ub,ub,ub,ub,ug,ug,ug,ug,ux,ux
ur,ur,ux,ur,ur,ur,ur,ur,ur,ur,ur,ub,ur,ub,cg,ug,ux,ug,ug,ug,ug,ux,ux
ur,ub,ub,ub,ur,ux,ux,ux,ur,ur,cb,ub,ug,ug,ug,ug,ux,ug,ug,ug,ug,ux,ux
ur,ub,ub,ub,ug,ug,ug,ug,ug,ug,ux,ux,ug,ug,ug,ug,ug,ug,ug,ug,ug,ux,cb
cb,ub,ub,ug,ug,ug,ug,ug,ux,ug,ux,ux,ug,ug,ug,ug,ub,ub,ub,ug,ug,ux,cg
ub,ub,ub,ub,ug,ug,ug,ug,ug,ug,ux,ux,ug,ug,ux,ug,ug,ub,ux,ug,ug,ub,ub
cr,ug,ug,ub,ug,ug,ug,ug,ug,ug,ux,ux,ug,ug,ux,ux,ug,ug,ug,ug,ug,ug,ug
ur,ug,ug,ub,ug,ug,ux,ug,ug,ug,ux,ux,ug,ug,ux,ux,ux,ux,ux,ux,ub,ug,ug
ur,cg,cb,ub,ug,ug,ug,ug,ug,ug,ug,ux,ux,ug,ub,ub,ug,ug,ug,ug,ug,ug,ub
ur,ug,ug,ug,ug,ug,ug,ug,ug,ug,ug,ug,ub,ub,ub,ur,ug,ur,ur,ur,ur,ur,ur
ur,ur,ur,ur,ur,ur,ur,ur,ur,ur,ur,ur,ur,ur,ur,ur,ur,ur,ur,ur,ur,ur,ur
cr,ug,ug,ug,ug,ug,ug,ug,ug,ug,ur,ur,ur,ug,ur,ur,ug,ur,ur,ur,ur,ur,ur
cg,ug,ug,ug,ug,ug,ug,ug,ug,ug,ux,ux,ux,ug,ug,ug,ug,ur,ur,ur,ur,ur,cr
cr,ug,ug,ug,ug,ug,ug,ug,ug,ug,ux,ux,ux,ur,ug,ug,ug,ux,ux,cb,cb,ur,cr
cg,ur,cg,cb,ug,ug,ug,ug,ug,ug,ur,ur,ur,ur,ux,cg,ux,ux,ux,cg,cg,cb,cr