ux,ux,ux,ux,ux,ux,ux,ur,ur,ur,ur,ur,ur,ur,ur,ur,ur,ux,ux,ur,ur,ur,ur
ux,ux,ux,ux,ux,ux,ux,ur,ur,ur,ur,ur,ur,ur,ur,ur,ur,ur,ur,ur,ur,ur,ur
ux,ur,ug,ug,ug,ur,ur,ur,ur,ur,ur,ur,ur,ur,ur,ur,ur,ur,ur,ur,ur,ur,ur
ux,ug,ug,ug,ug,ur,ur,ur,ur,ur,ur,ur,ur,ur,ur,ub,cr,cr,ur,ur,cr,ur,ur
ux,ug,ug,ug,ug,ug,ux,ux,ur,ur,ur,ur,ur,ur,ur,cb,ur,ur,ur,ur,ub,ub,ub
ux,ur,ur,ur,ug,cg,ux,ux,ur,ur,ur,ur,ur,ur,ur,ur,ur,ur,ur,ur,ub,ub,ub
ux,ur,ur,ur,ur,ur,ur,ur,ur,ur,ur,ur,ur,ur,ur,ur,ur,ub,ub,ub,ub,ub,ub
ux,ur,ur,ur,ur,ur,ur,ur,ur,ur,ur,ur,ur,ur,cr,ur,ur,ub,ub,ub,ub,ub,ub
cg,ur,ur,ur,ur,ur,ur,ur,ur,ur,ur,ur,ur,ur,ub,ur,cb,ux,ux,ux,ux,ux,ub
ur,ur,ur,ur,ur,ur,ur,ur,ur,ur,ur,ur,ur,ur,ub,ub,ub,ux,ux,ux,ux,ux,ub
ur,ur,ur,ur,ur,ur,cr,ug,ug,cg,ur,ur,ur,ur,ur,ur,ub,ux,ux,ux,ux,ux,ub
ug,ux,ur,ur,ur,ur,ur,ur,ur,ur,ur,ur,ur,ub,ub,ub,ux,ux,ux,ux,ux,ux,ub
ug,ug,ug,ur,ur,ur,ur,ux,ux,cb,ub,ub,ug,ug,ug,ub,ux,ux,ux,ux,ux,ux,ub
ub,ub,ug,ux,ug,ug,ux,ux,ux,ug,ub,ub,ub,cg,ub,ub,ug,ux,ux,ux,ux,ux,ub
cg,ub,ug,ux,ug,ug,ug,ug,ug,ug,ux,ub,ug,ug,ub,ug,ug,ug,ux,ux,ux,ux,ub
ux,ug,ug,ux,ug,ug,ub,ub,ug,ux,ux,ub,ug,ug,cb,ub,ub,ub,ub,ux,ux,ux,ub
ub,ug,ux,ux,ux,ub,ub,ux,ug,ux,ux,ux,ub,ub,ub,ub,ub,ub,ub,ux,ux,ux,ub
ub,ug,ux,ux,ux,ub,ub,ux,ug,ub,ub,ub,ub,ub,ug,ug,ug,ug,ux,ux,ux,ux,ub
ur,ug,cb,ux,ux,ub,ub,ux,ug,ur,ur,ur,ub,ub,ur,ur,ur,ur,ur,ur,ur,ur,ub
ur,ug,ub,ub,ub,ub,ub,ub,ug,ub,ub,ux,ub,ux,ur,ur,ur,ur,ur,ur,ur,ur,ub
ur,ur,ur,ub,ub,ur,ur,ub,ur,ur,ur,ub,ub,ub,ub,ub,ub,ub,ur,ur,ur,ur,ub
ur,ur,ur,ub,ub,ur,ur,ub,ub,ur,ur,cb,ur,ur,ur,ur,ur,ur,ur,ur,ur,ur,ub
ur,ur,ur,ur,ur,ur,ub,ub,ub,cg,ux,ux,ub,ub,ub,ub,ub,ub,ub,ux,ur,ur,cr