ub,cr,ur,ur,ur,ur,ur,ur,ur,ur,ur,ur,ur,ur,ur,ur,ur,cb,ur,ur,ur,cb,ur
cb,ur,ur,ur,ur,ur,ur,ur,ur,ur,ur,ur,ur,ur,ur,ur,ur,ur,ur,ur,ub,ub,ur
ur,ur,ur,ur,ur,ur,ur,ur,ur,ur,ur,ur,ur,ur,ur,ur,ur,ur,ur,ur,ub,ur,ur
ur,ur,ur,cr,ub,ur,ur,ur,ur,ur,ur,ur,ur,ur,ur,ur,ur,ur,ur,ur,ub,ug,ug
cb,ur,ur,ur,cb,ur,ur,ur,ur,ur,ur,cg,ur,ur,ur,ur,ur,ur,ur,ur,ub,ur,ug
ur,ur,cr,ur,ur,ur,ur,ur,ur,ur,cr,ug,ur,ur,ur,ur,ug,ug,ur,ug,ub,ug,ug
ur,ur,ux,ux,ux,ub,ub,ub,ur,ur,ub,ur,ur,cr,ur,ur,ur,ur,ur,ur,ub,ur,ur
ub,ub,ux,ux,ux,ux,ub,ub,ug,cb,ub,ub,ug,ug,ur,ur,ur,ur,ur,ur,ub,ur,ur
ux,ug,ux,ux,ux,ux,ub,ub,ug,ub,ub,ub,ug,ur,ur,ug,ug,ug,ur,ur,ub,ug,ux
ux,ug,ux,ux,ux,ux,ub,ux,ub,ug,ug,ug,ug,ur,ur,ug,ur,ur,ur,ur,ub,ug,ux
ux,ug,ux,ux,ux,ux,ub,ub,ub,ug,ug,ur,ur,ug,ug,ug,ur,ur,ur,ur,ub,ug,ux
ux,ug,ux,ux,ux,ux,ub,ux,ux,ug,ug,ur,ur,ub,ub,ub,ur,ur,ur,cr,ub,ug,ux
ux,ug,ux,ux,ux,ux,ub,ub,ub,ug,ub,ub,ub,ux,ux,ug,ur,ug,ug,cg,ub,ux,cg
ux,ug,ux,ux,ux,ux,ug,ug,ug,ug,ug,ug,ug,ug,ug,ug,ur,ug,ug,ur,ub,ux,ux
ux,ug,ur,ub,ub,ub,ug,ug,ug,ug,ug,ug,ug,ug,ug,ug,ur,ur,ug,ur,ub,ux,ux
ur,ug,ux,ub,ux,ux,ux,ux,ux,ug,cg,ug,ug,ug,ug,ug,ur,ur,ug,ur,ub,ux,ux
ur,ug,ux,ub,ux,ux,ux,ux,ux,ug,ug,ug,ug,ug,ug,ug,ur,ug,ug,ur,ub,ux,ux
cg,ug,ux,ub,ux,ux,ux,ux,ux,ug,ug,ug,ug,ug,ug,ug,ug,ug,ur,ur,ub,ux,ux
ux,ug,ub,ub,ux,ux,ux,ux,ug,ur,ug,ug,ur,ug,ug,ug,ux,ub,ub,ub,ub,ux,ux
ux,ug,ux,ux,ux,ux,ux,ux,ux,ur,ux,ux,ur,ux,ux,ug,ug,ur,ur,ur,ux,ux,ux
ux,ug,ug,ug,ug,ug,ug,ug,ug,ug,ug,cg,ur,ux,ux,ux,ur,ur,ur,ur,ux,ux,ux
cr,ux,ux,ux,ux,ux,ux,ux,ux,ur,ux,ux,ur,ux,ux,ux,ux,ux,ux,ux,ux,cb,cr
cg,ux,ux,ux,ux,ux,ux,ux,ux,ur,ur,ur,ur,cb,ux,ux,ux,ux,ux,cg,cb,ux,cr