ur,ur,ur,ur,ur,ur,ur,ur,ub,cb,ur,ur,ur,ur,ur,ur,ur,ur,ur,ur,ur,cb,ub
ur,ur,ur,ur,ur,ur,ur,ur,cr,ur,ur,ur,ur,ur,ur,ur,ur,ur,ur,ur,ur,ur,ub
ur,ur,ur,ur,ur,ur,ur,ur,ur,ur,ur,ur,ur,ur,ur,ur,ur,ur,ur,ur,ur,ur,ub
ur,ur,ur,ur,cr,ur,ur,ur,ur,ur,ur,ur,ur,ur,ur,ur,ur,ur,ur,ur,ur,ur,ub
ux,ur,ur,ur,ur,ur,ur,ur,cb,ur,ur,ur,ur,ur,ur,ur,ur,ur,ur,ur,ur,ur,ub
ux,ur,cr,ub,ub,ub,ub,ub,ub,ur,ur,ur,ur,cr,cg,ug,ur,ur,ur,ur,ur,ur,ub
ur,ur,ub,ub,ub,ug,ur,ur,ur,ur,ur,ur,ur,ub,ub,ug,ub,cr,ur,ub,ur,ur,ub
ur,ur,ug,ur,ub,ub,ux,cr,ur,ur,ur,ur,ur,ur,ug,ug,ug,ub,cb,ub,ur,ux,ub
cg,ux,ug,ug,ug,ug,ux,ur,ur,ur,ur,ur,ur,ur,ug,ug,ug,ub,ug,ug,ur,ux,ub
ub,ub,ub,ux,cb,ug,ux,ux,ux,ug,ub,ug,ub,ug,ug,ub,ub,ub,ug,ug,ur,ux,ub
ub,ux,ub,ub,ub,ug,ug,ug,ug,cb,ub,ub,ub,ug,ug,ub,ub,ug,ug,ug,ur,ux,ub
ub,ux,ug,ub,ub,ub,ub,ug,ug,ub,ub,ub,ub,ug,ug,ug,ub,ug,ug,ug,ur,ux,ub
ub,ub,ug,ux,ub,ux,ux,ux,ug,cg,ub,ub,ub,ug,ub,ug,ug,ug,ub,ug,ub,ub,ub
ub,ub,ug,ug,ux,ux,ux,ux,ux,ub,ub,ub,ub,ug,ub,ub,ub,ug,ug,ug,ux,ux,ub
cg,ux,ux,ug,ux,ux,ux,ux,ux,ub,ub,ub,ub,ug,ub,ub,ub,ug,ug,ug,ux,ux,ub
ub,ub,ub,ub,ub,ub,ux,ux,ux,ux,ux,ux,ux,ug,ub,ub,ux,ug,ug,ug,ux,ux,ub
ub,ub,ub,ug,ux,ub,ub,ub,ub,ub,ub,ub,ux,ug,ux,ux,ux,ub,ub,ub,ux,ux,ub
ub,ub,ub,ug,ux,ux,ux,ux,ux,ux,ux,ub,ub,ug,ux,ux,ux,ur,ux,ux,ux,cg,ub
ub,ub,ub,ug,ub,ux,ux,ux,ux,ux,ug,ug,ug,ug,ub,ub,ub,ub,ub,ux,ux,ug,ub
ub,ub,ub,ug,ug,ux,ux,ug,ug,ug,ug,ug,ux,ug,ux,ux,ux,ug,ug,ug,ug,ug,ub
ub,ub,ub,ux,ug,ug,ug,ug,ub,ux,ug,ug,ug,ug,ug,ug,ug,ug,ux,ub,ub,ux,ub
ub,ub,ub,ux,ux,ux,ux,ub,ub,ux,ug,ux,ux,ux,ux,ux,ux,ur,ux,ux,ub,ub,ub
ub,ub,ub,ub,ub,ub,ub,ub,ux,cg,ug,ug,ug,ux,ux,ux,ux,ur,ur,ur,ur,ub,ub