ux,ux,cb,ux,ux,ux,ux,ur,ur,ur,ur,ur,ur,ur,ur,ur,ur,cb,ur,cg,ux,ux,ux
ux,ux,ux,ux,ur,ur,ur,ux,ur,ur,ur,ur,ur,ur,ur,ur,ur,ur,ur,ur,ux,ux,ux
ux,ur,ur,ur,ur,ur,ur,ur,ur,ur,ur,ur,ur,ur,ur,ur,ur,ur,ur,ur,ur,ux,ux
ux,ur,ur,ur,ur,ur,ur,ur,ur,ur,ur,ur,ur,ur,ur,ur,ux,ur,ux,ux,ur,ux,ux
ux,ur,ur,ur,ur,ur,ur,ur,ur,ur,ur,ur,cr,cr,ur,ur,ur,ur,ux,ux,ur,ux,ux
ux,ur,ur,ur,ur,ur,ur,ur,ur,ur,ur,ur,ur,ub,ur,ur,ur,ur,ug,ux,ur,ux,ux
ux,ur,ur,ur,ur,ur,ur,ur,cr,ur,ur,ur,ur,cb,ur,ur,ur,ug,ug,ug,ur,ux,ux
ux,ur,ur,ur,ur,ur,ur,ug,ug,ur,ur,ur,ur,ur,ur,ug,ug,ug,ug,ug,cg,ur,ur
ux,ug,ur,cb,ub,cr,ur,cg,ur,ur,ur,cg,ur,ur,ur,ur,ur,ur,ur,ug,ug,ux,ux
ux,ug,ug,cr,ur,ur,ur,ur,ur,ug,ug,ug,ux,ug,ug,ux,ux,ux,ug,ug,ug,ub,ur
ux,ux,ux,ux,ub,ug,ug,ub,ub,ux,ux,ug,ux,ug,ug,ug,ug,ug,ug,ub,ub,cb,ub
ux,ux,ux,ux,ub,ug,ug,ug,ug,ug,ug,ug,ub,ub,ub,ug,ub,ug,ug,ux,ux,ux,ub
cg,ug,ug,ug,ub,ug,ug,ug,ug,ug,ub,ug,ub,ub,ub,ug,ub,ug,ug,ub,ux,ux,ub
ux,ux,ux,ux,ux,ug,ug,ug,ug,ug,ub,ug,ub,ub,ub,ug,ub,ug,ug,ug,ub,cg,ub
ux,ux,ux,ux,ux,ug,ug,ug,ug,ug,ug,ug,cr,ur,ur,ur,ur,ur,ur,ur,ur,ug,ub
ux,ux,ux,ux,ux,ug,ug,ug,ug,ub,ub,ub,ub,ub,ub,ux,ug,ug,ug,ub,ub,ug,ub
ux,ux,ux,ux,ux,ug,ug,ug,ux,ub,ug,ub,ug,ug,ug,ug,ug,ux,ux,ub,ub,ug,ub
cg,ux,ub,ux,ux,ug,ug,ug,ug,ub,ug,ux,ug,ug,ur,ug,ux,ux,ux,ur,ub,ug,ub
ux,ux,ub,ux,ux,ug,ug,ug,ug,cb,ug,ub,ug,ug,ug,ug,ug,ux,ux,ur,ux,ug,ub
ux,ux,ub,ux,ux,ug,ux,ux,ux,ux,ub,ub,ub,ub,ub,ub,ub,ub,ub,ub,ub,ug,ub
cr,ux,ub,ux,ux,ug,ux,ub,ug,ug,ug,ug,ug,ug,ug,ug,ug,ug,ug,ug,ug,ug,ub
cg,ux,ub,ub,ub,ug,ub,ub,ug,ux,ux,ux,ux,ux,ur,ux,ux,ux,ux,ur,ux,cb,cr
cr,ux,ub,ub,ux,ug,ug,ug,ug,ux,ux,ux,ux,cb,ur,ur,ur,ur,ur,ur,cb,ux,cr