ur,ur,ur,ur,ur,ur,ur,ur,ur,ur,ur,ur,ur,ur,ur,ur,ur,cb,ur,ur,ur,ur,ux
ur,ur,ur,ur,ur,ur,ur,cr,ug,ux,ur,ur,ur,ur,ur,ur,ur,ur,ur,ur,ur,ur,ux
ur,ur,ur,ur,ur,ur,ur,ur,ug,ur,ur,ur,ur,ur,ur,ur,ur,ur,ur,ur,ur,ur,ux
ur,ur,ur,ur,ur,ur,ug,ug,ug,ur,ur,ur,ur,ur,ur,ur,ur,ur,ur,ur,ur,ur,ux
ur,ur,ur,ur,ur,ur,ur,ur,ur,ur,ur,ur,ur,ur,ur,ur,ub,ub,cr,ug,ug,ug,ur
ur,ur,ur,cg,ur,ur,ur,ur,ur,ur,ur,ur,cb,ub,ur,ub,ub,ub,ub,ug,ug,ug,ur
ur,ur,cr,ug,cb,cr,ur,ur,ur,ur,ur,ur,ur,ub,ub,ub,ug,ug,ub,ug,ug,ug,ur
ur,ub,ur,ug,ub,ug,ug,ub,ub,ub,ux,cr,ur,ug,ug,ug,ug,ug,ub,ub,ug,ug,ur
ub,ub,ub,ub,ub,cg,ug,ux,ug,ug,ux,ux,ux,ug,ug,ug,ub,ub,ug,ub,ug,ug,ug
ub,ub,ub,ub,ug,ug,ug,ux,ug,ug,ub,ux,ub,ug,ug,ug,ub,ug,ux,ub,ux,ux,ug
ux,ux,ub,ub,ub,ub,ux,ux,ux,ux,ub,ub,ub,ug,ug,ub,ub,cb,ub,ub,ug,ux,ug
ux,ux,ub,ub,ub,ub,ux,ux,ux,ub,ub,ub,ub,ub,ub,ub,ub,ub,ub,ub,ug,ux,ug
ux,ux,ub,ub,ub,ub,ux,ub,ub,ub,ub,ub,ug,ug,ub,ub,ub,ub,ub,ub,cr,ug,ug
ux,ux,ub,ub,ub,ub,ub,ub,ub,ub,ub,ug,ug,ug,ub,ug,ub,ub,ub,ub,ur,ug,ug
cg,ux,ub,ub,cb,ub,ub,ub,ub,cb,ub,ug,ug,ug,ug,ug,ux,ub,ub,ub,ur,ug,ug
ub,ub,ub,ub,ub,ub,ub,ub,ur,ur,ug,ug,ug,ug,ug,ug,ub,ub,ub,ub,ur,ug,ug
ub,ux,ub,ub,ux,ux,ug,ux,ux,ux,ug,cg,ux,ug,ub,ub,ub,ub,ub,ub,ur,ug,ug
ub,ux,ub,ub,ux,ux,ug,ug,ug,ux,ub,ub,ub,ub,ub,ub,ub,ur,ub,ub,ur,ug,ug
ub,ux,ub,ub,ux,ux,ux,ux,ug,ug,ug,ug,ug,ug,ug,ug,ub,ur,ub,ux,ur,ug,ug
ub,ux,ub,ub,ux,ux,ux,ux,ux,ux,ub,ub,ub,ux,ux,ug,ug,ur,ux,ux,ur,ug,ug
ub,cb,ur,ub,ub,ub,ub,ub,ub,ub,ub,ub,ub,ub,ub,ub,ug,cg,ub,ug,ur,ug,ug
cr,ux,ub,ub,ux,ux,ux,ug,ux,ux,ub,ub,ub,ux,ux,ux,ux,ur,ub,ux,ur,ux,cb
cg,ux,ub,ub,ux,ux,ux,ug,ux,cg,ub,ux,ux,ux,ux,ux,ux,ur,ur,ur,ur,ur,ur