ur,ur,ur,ur,ur,ur,ur,ur,ur,ur,ur,ur,ur,ur,ur,ub,ub,cb,ur,ur,ur,ur,ur
ur,ur,ur,ur,ur,ur,ur,ur,ur,ur,ur,ur,ur,ur,ur,ub,ur,ur,ub,ur,ur,ux,ur
ur,ur,ur,cb,ub,ub,ur,ur,ur,ur,ub,ur,cr,ub,ub,ub,ub,ur,cr,ur,ur,ur,ur
ur,ur,ur,cr,ur,cr,cr,ur,ub,ur,ur,ur,ub,ub,ub,ub,ub,ug,ux,ux,ub,ub,ux
ur,ur,ur,ug,ur,ur,ur,ur,ur,ub,ux,ur,ub,ub,ub,ub,ub,ug,ux,ux,ub,ux,ux
ux,ux,ur,ug,ur,ur,ub,ur,ur,ug,ug,ub,ub,ub,ub,ub,ub,ub,ub,ub,cb,ub,cr
cb,ux,ux,ug,ur,ur,ub,ur,ur,ux,ug,ug,ux,ux,ux,ux,ux,ug,ux,ub,ux,ux,ur
ub,ur,ur,ug,ur,ur,ub,ur,ur,ux,ug,ug,ux,ub,ux,ux,ux,ug,ux,ux,ux,ux,ur
ub,ur,ur,ug,ur,ur,ug,ur,ug,ug,ug,ub,ub,cb,ux,ux,ux,ug,ux,ux,ux,ux,ur
ub,ur,ur,ug,ur,ur,ur,ug,ug,ug,ur,ur,ur,ub,ur,ur,ur,ur,ur,ur,ur,ur,ur
ub,ur,ux,ug,ur,ug,ug,ug,ug,ug,ub,ub,ub,ub,ug,ug,ug,ug,cg,ug,ug,ug,ug
ub,ur,ux,cg,ur,ub,ub,ug,ug,ub,ug,ub,ub,ub,ug,ug,ug,ug,ux,ux,ux,ux,ug
ub,ur,ur,ur,cb,ub,ub,ub,ug,ub,ub,ub,ub,ub,ub,ub,ub,ug,ux,ux,ux,ux,ug
ub,ug,ux,ur,ur,ug,ub,ub,ug,ub,ub,ub,ub,ub,ub,ub,ub,ug,ug,ux,ux,ux,ug
ub,ug,ux,ur,ur,ug,ub,ub,cg,ub,ub,ub,ub,ux,ub,ub,ux,ub,ug,ux,ux,ux,ug
ub,ug,ux,ur,ur,ug,ub,ub,ub,ub,ub,ub,ux,ux,ub,ub,ug,ug,ug,ux,ux,ux,ug
ub,ug,ux,ur,ur,ug,ub,ub,ub,ub,ub,ub,ug,ug,ub,ub,ug,ug,ug,ux,ux,ux,ug
ub,ug,ux,ur,ur,ug,ub,ub,ub,ub,ub,ub,ub,ug,ug,ug,ug,ug,ug,ux,ux,ux,ug
ub,ug,ux,ur,ub,ub,ub,ub,ub,ub,ux,ux,ux,ux,ub,ub,ux,ux,ux,ux,ux,ux,ug
ub,ug,ux,ur,ub,ux,ub,ux,ub,ub,ux,ux,ux,ux,ux,ux,ux,ux,ux,ux,ux,ux,ug
ub,ug,ux,ur,ub,ux,ub,ux,ux,ux,ux,ux,ux,ux,ux,ux,ux,ux,ux,ux,ux,ux,ug
ub,ug,ux,ur,ub,ux,ub,ux,ux,ux,ux,ub,ub,ux,ux,ux,ux,ux,ub,ub,ub,ux,ug
ub,ub,ub,ub,ub,ub,ub,ub,ub,ub,ub,ub,ug,ug,ug,ug,ug,ug,ug,ug,ug,ug,ug