ur,ur,ur,ur,cr,ub,cb,ur,ur,ur,ur,ur,ur,ur,ur,ur,ux,cb,ub,ub,ux,ub,ub
ur,ur,ur,ur,ub,ub,ur,ur,ur,ur,ur,ur,ur,ur,ur,ur,ux,ux,ub,ub,ux,ub,ub
ur,ur,ur,ur,ur,ur,ur,ur,ur,ub,ub,cb,ur,ur,cr,ub,ux,ux,ub,ub,ub,ub,ub
ur,ur,ur,ur,ur,ug,ug,ur,ur,cr,ur,ur,ur,ur,ur,ub,ux,ux,ub,ub,ub,ux,ub
ug,ug,cr,ur,ur,ug,ug,ub,ub,ur,ur,cr,cb,ub,ub,ub,ub,ub,ub,ur,ur,ux,ub
ug,ur,ur,ur,ur,ug,ug,ub,ub,ub,ub,ub,ug,ug,ub,ub,ub,ur,ur,ur,ur,ux,ub
ug,ur,ur,ur,cg,ug,ug,ug,ug,ub,ub,cb,ug,ub,ub,ug,ub,ug,ux,ug,ug,ux,ub
ug,ur,ur,ur,ur,ur,ur,ur,ur,ur,ur,cg,ub,ub,ub,ug,ub,ug,ug,ug,ug,ux,ub
ug,ur,ur,ur,ur,ur,ur,ug,ug,ug,ug,ug,ux,ux,ux,ug,ub,ub,ux,ux,ug,ux,ub
ug,ug,cg,ur,ur,ug,ur,ug,ub,ub,ub,ub,ub,cb,ux,ug,ug,ub,ub,cb,ug,ux,ub
ur,ur,ur,ur,ug,ug,ug,ug,ur,ur,ub,ub,ub,ux,ux,ug,ug,ub,ub,ub,ub,ub,ub
ug,ur,ur,ug,ur,ug,ur,ur,ur,ub,ub,ur,ub,ux,ux,ug,ug,ub,ub,ub,ux,ux,ux
ug,ug,ug,ug,ug,ug,ug,ub,ug,ug,ub,ur,ug,ug,ug,ug,ug,ub,ub,ub,ux,ux,ux
ur,ur,ur,ur,ug,ur,ur,ub,ub,ug,ug,ug,ug,ug,ug,ug,cg,ub,ub,ub,ux,ux,ux
cg,ug,ug,ug,ub,ur,ur,ub,ub,ub,ug,ur,ug,ug,ug,ug,ug,ub,ub,ub,ux,ux,ux
ux,ux,ux,ug,ux,ug,ub,ub,ub,ub,ug,ur,ug,ug,ug,ug,ug,ub,ub,ub,ux,ux,ux
ux,ux,ux,ug,ux,ux,ux,ub,ub,ub,ug,ur,ub,ug,ug,ug,ug,ub,ub,ub,ux,ux,ux
ux,ux,ux,ug,ux,ux,ux,ux,ug,ub,ub,ur,ub,ug,ug,ug,ug,ux,ux,ux,ux,ux,ux
ux,ux,ux,ug,ux,ux,ux,ub,ug,ub,ub,ur,ub,ub,ub,ux,ux,ux,ux,ux,ux,ux,ux
ux,ux,ux,ug,ux,ux,ux,ub,ug,ub,ux,ur,ub,ub,ub,ux,ux,ux,ux,ux,ux,ux,ux
ux,ux,ux,ug,ux,ux,ux,ub,ug,ux,ux,ur,ux,ux,ux,ux,ux,ux,ux,ux,ux,ux,ux
cr,ux,ux,ug,ux,ux,ux,ub,ug,ux,ux,ur,ux,ux,ux,ux,ux,ux,ux,ux,ux,ux,cb
cg,ux,ux,ug,ug,ug,ug,ug,ug,cg,ux,ur,cr,ux,ux,ux,ux,ux,ux,ux,ux,ux,ux