cr,ur,ur,ur,ur,ur,ur,ur,ur,ur,ur,ur,ur,ur,ug,ug,ug,ug,ug,ug,cr,ug,ug
ub,ub,ur,cr,ug,ur,ur,ur,ur,ug,ug,ug,ug,ug,ug,ur,ur,ur,ux,ur,ur,ux,cg
ub,ub,cb,ur,ur,ur,ur,ur,ur,ur,ur,ur,ur,ur,ur,ur,ub,ub,ub,ub,ub,ux,ub
ub,ub,ub,ux,ug,ur,ur,ur,ug,ug,ug,ug,ug,cg,ur,ub,ub,cr,ux,ub,ub,ux,ub
ux,ur,ub,ub,cr,ug,ur,ug,ug,ug,ug,ug,ur,ur,ur,ub,cb,ur,ux,ux,ub,ub,ub
ux,ub,ug,ub,ur,ur,ur,ug,ug,ub,cb,ug,ux,ux,ug,ux,ub,ub,ux,ux,ux,ur,ux
ub,ub,ug,ub,ux,ub,ug,ug,ug,ub,ub,ug,ug,ug,ug,ub,ux,ub,ub,ub,ub,ux,ux
ub,ub,ug,ub,ub,ub,ug,ug,ug,ub,ub,ug,ux,ux,ux,ux,ux,ux,ux,ux,ub,ux,ux
cg,ub,ug,ub,ub,ug,ub,ub,ub,ub,ub,ub,ub,ub,ub,ub,ub,ux,ux,ux,ub,ux,ux
ux,ux,ug,ug,cb,ub,ug,ub,ub,ub,ub,ub,ub,ub,ub,ub,ub,ug,ug,ur,ub,ur,ur
ux,ux,ux,ug,ub,ub,ux,ub,ub,ub,ub,ub,ug,ug,ug,ug,ug,ug,ub,ux,ub,ux,ur
ux,ux,ux,ug,ub,ux,ux,ub,ub,ub,ub,ub,ug,ub,ub,cb,ug,ug,ub,ux,ub,ux,ur
ux,ux,ux,ug,ub,ub,ux,ux,ux,ux,ub,ub,ub,ub,ug,ug,ug,ug,ub,ux,ub,ux,ur
ux,ux,ux,ug,ug,ub,ux,ux,ux,ux,ub,ub,ub,ug,ug,ug,ux,ug,cg,ux,ub,ux,ur
ux,ux,ux,ug,ub,ub,ux,ux,ux,ux,ux,ub,ug,ug,ug,ug,ug,ug,ug,ux,cb,ux,ur
ux,ux,ux,ug,ub,ur,ur,ur,ur,ur,ub,ub,ug,ub,ub,ub,ug,ug,ug,ur,ur,ur,ur
ur,ur,ur,ur,ur,ur,ur,ur,ur,ur,ur,ur,ug,ug,ug,ug,ug,ug,ug,ur,ur,ur,ur
ur,ux,ux,ug,ug,ur,ub,ub,ub,ub,ux,ub,ub,ub,ub,ub,ug,ug,ux,ux,ux,ux,ur
cr,ux,ux,ug,ug,ur,ug,ug,ug,ug,ux,ux,ub,ub,ug,ug,ug,ux,ux,ux,ux,ux,ur
ux,ux,ux,ux,ug,ur,ug,ug,ux,ux,ux,ux,ux,ux,ux,ux,ux,ux,ux,ux,ux,ux,ur
ux,ux,ux,ux,ux,ur,ux,ux,ux,ux,ux,ux,ux,ux,ux,ux,ux,ux,ux,ux,ux,ux,ur
ux,ux,ux,ux,ux,ur,ux,ux,ux,ux,ux,ux,ux,ux,ux,ux,ux,ux,ux,ux,ux,ux,ur
ux,ux,ux,ux,ux,ur,ur,ur,ur,ur,ur,ur,ur,ur,ur,ur,ur,ur,ur,ur,ur,ur,ur