ur,ur,ur,ur,ur,ur,ur,ur,cb,ur,ur,ur,ur,ur,ur,ur,ur,ur,ur,ur,ur,ur,ur
ur,ur,ur,ur,ur,ur,cr,cr,ub,ur,ur,ur,ur,ur,ux,ux,ur,ur,ur,ur,ur,ur,ur
ur,ur,ur,ur,ur,ur,ur,ur,ur,ur,ur,ur,ur,ur,ur,ux,ur,ur,ur,ur,ur,ur,ur
ur,ur,ur,ur,ur,ur,ux,ux,ur,ur,ur,ur,ug,ug,ur,ur,ur,ur,ur,ur,ur,ur,ur
ur,ur,ur,ur,ur,ur,ur,ur,ur,ur,ur,ur,ur,ur,ur,ur,ur,ur,ur,ur,cr,ur,ur
ur,ur,ur,ur,ur,ur,ur,ur,ur,ur,ur,ur,ur,ur,ur,cr,ub,ur,ur,ur,ux,ux,ug
ur,ur,ur,ur,ur,ur,ur,ur,ur,ur,ur,ug,ug,ug,ub,ub,ub,ub,ur,ur,ur,ur,ug
ur,ur,ur,ur,ur,ur,ur,ur,ur,ur,ur,ur,cg,ug,cb,ub,ur,ub,ur,ur,ur,ux,ug
cg,cr,ub,ub,ur,ur,ur,ur,ur,ur,ur,ug,ug,ug,ub,ur,ub,ub,ub,ux,ux,ux,ug
ux,ug,ux,ux,ug,ux,ux,ux,ux,ux,ur,ub,ug,ug,ub,ur,ub,ub,ub,ug,ux,ux,ug
ug,ug,ux,ux,ug,ug,ug,ug,ug,ub,ur,ub,ug,ux,ub,ur,ug,ug,ug,ug,ux,ux,ug
ug,ux,ux,ux,ug,ug,ux,ub,ub,ub,ur,ug,ug,ug,ub,ur,ug,ug,ug,ug,ug,ux,ug
ug,ug,ug,ug,ug,ug,ub,ub,ub,ub,ur,ug,ug,ug,ug,ur,ux,ug,ug,ug,ug,ux,ug
ux,ux,ux,ux,ux,ug,ub,cb,ub,ub,ur,ug,ug,ux,ux,ur,ub,ug,ug,ux,ux,ux,ug
cg,ux,ux,ux,ux,ux,ub,ub,cg,ug,ug,ub,ub,ub,ub,ur,ub,cb,ur,ur,cr,ub,ug
ux,ux,ux,ux,ux,ux,ux,ug,ug,ug,ug,ub,ub,ub,ub,ub,ub,ux,ux,ux,ux,ub,ug
ux,ux,ux,ux,ux,ux,ux,ug,ug,ug,ug,ub,ux,ux,ux,ub,ub,ux,ux,ux,ux,ub,ug
ux,ux,ux,ux,ux,ux,ux,ug,ug,ug,ug,ub,ux,ux,ux,ub,ub,cb,ux,ux,ux,ub,ug
ux,ux,ux,ux,ub,ub,ub,ub,ub,ug,ug,ub,ux,ux,ux,ux,ub,ub,ux,ux,ux,ub,ug
ux,ub,ub,ub,ub,ux,ux,ux,ur,ug,cb,ub,ub,ub,ub,ub,ub,ub,ub,ub,ub,ub,ug
ub,ub,ub,ub,ub,ub,ub,ub,ur,ux,ub,ux,ux,ux,ux,ux,ux,ux,ux,ux,ux,ux,ug
ub,ub,ub,ub,ub,ub,ub,ux,ur,ux,ub,ub,ub,ub,ub,ub,ub,ux,ub,ub,ub,ux,ug
ub,ub,ub,ub,ub,ub,ub,ur,ur,cg,ub,ub,ub,ub,ub,ub,ub,ub,ub,ur,ub,cg,ug