ur,cb,cb,cr,ur,ur,ur,ur,ur,ur,ur,ur,ur,ur,ur,ur,ur,ur,ur,ur,ur,ur,cb
ur,cb,cb,ur,ur,ur,ur,ur,ur,ur,ur,ur,ur,ur,ur,ur,ur,ur,ur,cg,ug,ug,ug
ur,ur,ur,ur,ur,ur,ur,ur,ur,ur,ub,cr,ur,ur,ur,ug,cr,ur,ur,ur,ur,ur,ur
ur,ur,ur,ur,ur,ur,ur,ur,ur,ur,ub,ur,ug,ur,ur,cg,ur,ur,ur,ur,ur,ur,ur
ur,ur,ur,ur,ur,ug,ug,cr,ur,ur,cb,ur,ug,ur,ur,ur,ur,ur,ur,ur,ur,cr,ur
ux,ux,ux,ur,ur,cg,ur,ur,ur,ub,ub,ub,cg,ug,ur,ur,ur,ur,ur,ur,ur,ug,ug
ux,ur,ur,ur,ur,ur,ug,ug,ur,ux,ur,ug,ug,ur,ur,ur,ur,ur,ug,ug,ug,ug,ug
cb,ux,ur,ur,ur,ur,ug,ug,ur,ur,ur,ur,ug,ur,ur,ub,ub,ub,ug,ug,ug,ur,ug
ur,ur,ur,ur,ur,ur,ur,ur,ur,ur,ub,ug,ug,ub,ur,ug,ug,ub,ux,ux,ug,ug,ug
ur,ur,ur,ur,ur,ur,ur,ur,ur,ub,ub,ub,ub,ub,ub,ub,ub,ub,ux,ug,ug,ug,ug
ux,ux,cr,ur,ur,ur,ur,ur,ur,ub,ur,ub,ug,ug,ug,ug,ug,ug,ug,ug,ug,ug,ug
ux,ux,ux,ux,ug,ug,ux,ug,ug,cb,ug,ug,ug,ub,ux,ug,ug,ug,ug,ug,ug,ug,ug
cb,ux,ux,ug,ug,ug,cg,ug,ug,ug,ug,ug,ug,ub,ux,ug,ug,ug,ug,ug,ug,ug,ug
ux,ux,ug,ug,ug,ug,ux,ug,ub,ub,ub,ub,ub,ub,ug,ug,ug,ug,ug,ug,ug,ug,ug
ux,ux,cb,ux,ux,ug,ug,ug,ug,ug,ug,ug,ub,ub,ub,ub,ub,ub,ub,ub,ub,ub,ux
ub,ub,ub,ug,ug,cr,ur,ur,ur,ur,ur,ur,ur,ur,ur,ur,ur,ur,cb,ub,ur,ub,ux
ub,ub,ub,ux,ug,ug,ug,ug,ug,ug,ug,ub,ub,ug,ux,ux,ux,ux,ux,ub,ur,ub,cb
ub,ub,ug,cg,ug,ug,ug,ug,ub,ug,ug,ug,ug,ux,ux,ux,ux,ux,ux,ub,ur,ub,ur
ub,ub,ug,ug,ug,ug,ug,ug,ug,ug,ug,ug,ug,ux,ux,ux,ux,ux,ux,ub,ur,ub,ur
ux,ux,ux,ux,ux,ux,ux,ug,ux,ug,ug,ug,ug,ux,ux,ux,ux,ux,ur,ub,ub,ub,ur
cr,ux,ux,ux,ux,ux,ux,ug,ug,ug,ug,ux,ug,ux,ux,ux,ux,ux,ux,ux,ux,ux,cr
cg,ux,ux,ux,ux,ux,ux,ux,ux,ux,ug,ux,ux,ux,ux,ux,ux,ux,ux,cb,cb,ux,cr
cr,cg,cg,cb,ux,ux,ux,ux,ux,ux,ux,ux,ux,ux,ux,cg,ux,ux,ux,cg,cg,ux,cr