ur,cb,cb,cr,ur,ur,ur,ur,ur,ur,ur,ur,ur,ur,ur,ur,ur,ur,ur,ur,ug,ug,cb
ur,ux,cb,ur,ur,ug,ur,ug,ug,ug,cg,ur,ur,ur,ur,ur,ur,ur,ur,ur,ux,ug,ug
cr,ur,ur,ur,ub,cb,ug,ug,ur,ur,ur,ur,ur,ur,ur,ur,ur,ur,ug,ug,ug,ug,ug
ux,ur,ur,ur,ub,ub,ug,ug,ur,ur,ur,ur,ur,cr,ur,ur,ur,ur,cr,ux,ub,ug,ub
ux,ux,ux,ux,ub,ug,cr,ub,ur,ub,ur,ur,ur,ur,ur,ug,ur,ug,ub,ur,ur,ur,ur
ux,ux,ux,ux,ub,ub,ur,ur,ur,ug,ug,ur,ug,ug,ur,ur,ur,ub,ub,ub,ub,ub,ur
ux,ux,ux,ux,ub,ub,ur,ub,ur,ub,ug,cr,ug,ug,ub,ub,ux,ux,ub,cb,ub,ub,ur
cb,ur,ur,ug,cg,ub,ub,ub,ub,ux,ux,ur,ux,ug,ub,ub,ug,ug,ur,ug,ug,ub,ur
ur,ur,ur,ug,ux,ug,ug,ug,ug,ug,ur,ur,ux,ux,ub,ub,ub,ub,ur,ub,cg,ub,ur
ur,ur,ur,ug,ug,ug,ug,ug,cb,ub,ub,ub,ub,ub,ub,ub,ub,ub,ub,ub,ub,ub,ur
ur,ur,ur,ug,ug,ug,ug,ug,ux,ux,ux,ug,ux,ug,ug,ug,ug,ug,ur,ug,ug,ux,ur
ur,ur,ur,ug,ug,ug,ug,ug,ux,ux,ux,ug,ug,ug,ug,ug,ur,ux,ur,ux,ux,ux,ur
cb,ux,ux,ux,ux,ub,ux,ub,ux,ux,ux,ug,ug,ug,ug,ug,ug,ug,ug,ug,ug,ug,cg
ux,ux,ux,ux,ux,ub,ub,cg,ug,ug,ux,ux,ux,ux,ug,ug,ug,ug,ur,ux,ux,ux,ur
ux,ux,ux,ux,ux,ug,ug,ug,ug,ug,ub,ub,ub,ub,ug,ug,ug,ug,ur,ux,ux,ux,ur
ug,ug,ux,ux,ux,cb,ub,ub,ug,ug,ub,ub,ux,ux,ux,ug,ug,ux,ur,ux,ux,ux,cg
ug,ug,ux,ux,ug,ug,ub,ub,ug,ux,ux,ub,ub,ux,ux,ux,ub,ux,ur,ux,ux,ux,ug
ug,ug,ug,ug,ug,ug,ub,ub,ug,ub,ub,ub,ub,ub,ub,ub,ub,ux,cr,ur,ur,ur,ug
ug,ug,ug,ux,ug,ug,ug,ug,ug,ub,ub,ub,ub,ux,ux,ux,ur,ur,ur,ur,ur,ur,ug
ug,ug,ug,ug,ub,ux,ux,ux,ug,ug,ub,ux,ux,ux,ux,ux,ur,ur,ur,ur,ur,ur,cb
cr,ug,ub,ug,ub,ug,ux,ug,ug,ug,ug,ux,ux,ux,ux,ux,ur,ur,ur,ur,ur,ur,cr
cg,ub,ub,cb,ub,ug,ug,ug,ug,ug,ug,ux,ux,ux,ux,ux,ur,ur,ux,cb,cb,ur,cr
cr,cg,cg,cb,ub,ub,ug,ug,ug,ug,ub,ux,ux,ux,ux,cg,ur,ur,ux,cg,cg,ur,cr