ur,ur,ur,ur,cr,ur,ur,ur,ub,ub,ur,ux,ux,ux,ux,ux,ux,ux,ub,ub,ub,ur,ur
ur,ur,ur,ur,ur,ur,ur,ur,ub,ub,ub,ub,ur,ur,ux,ux,ux,ux,ub,ur,ub,ub,ur
ur,ur,cr,ur,ur,ub,ur,ur,ub,ub,ub,ug,ug,ug,ug,ug,ug,ug,ug,ug,ug,ug,ug
ur,ub,ub,ur,ur,ur,ur,ur,ur,ur,ur,cr,ux,ur,ur,ub,ur,ub,cg,ug,ur,ub,ug
ur,ub,ub,cr,cr,ub,ub,ub,ub,ug,ug,ur,ux,ug,ug,ug,ug,ug,ub,ug,ub,ub,ug
ux,ub,ub,ub,ur,ub,ub,ub,ub,ub,ub,ur,ur,ug,ug,ug,ug,ug,ug,ug,ub,ub,ug
ux,ub,ub,ub,cb,ub,ub,ub,ub,ub,ub,ur,ur,ur,ur,ur,ug,ug,ug,cb,ug,ur,ug
ux,ub,ux,ub,ub,ub,ug,ug,ub,ub,ub,ur,ub,ur,ug,ug,ug,ug,ug,ub,ub,ur,cg
cg,cb,ur,ur,cb,ur,ur,ub,ub,ug,ug,ur,ur,ur,ug,ug,ug,ug,ug,ug,ub,ub,ub
ur,ur,ur,ur,ur,ur,ur,ur,ur,ur,ur,ur,cr,ub,ub,ub,ug,ub,ug,ug,ub,ub,ub
ur,ux,ux,ux,ux,ub,ux,ux,ux,ub,ub,ug,ub,ub,ux,ub,ug,ub,ug,ug,ub,ub,ub
ur,ux,ux,ub,ub,ub,ux,ux,ub,ub,cb,ub,ub,ub,ux,ux,ug,ub,ug,ug,ub,ub,ub
ur,ux,ux,ub,ub,ub,ub,ug,ug,ub,ub,ub,ub,ux,ux,ux,ug,ub,ug,ug,ub,ub,ub
ur,ux,ux,ux,ux,ub,ug,ug,ub,ub,ub,ub,ux,ux,ux,ug,ug,ug,ug,cg,ub,ub,ub
ur,ux,ux,ux,ux,ub,ug,ug,ub,ub,ub,ug,ux,ug,ug,ug,ug,ug,ug,ub,ub,ub,ub
ur,ux,ux,ux,ux,ub,ub,ux,ub,ub,ux,ug,ug,ug,ug,ug,ug,ug,ug,ub,ub,ub,ub
ur,ux,ux,ux,ux,ub,ub,ub,ub,ux,ux,ug,ug,ug,ug,ug,ug,ug,ug,ub,ub,ub,ub
ur,ux,ux,ux,ux,ub,ub,ub,ub,ux,ux,ug,ug,ug,ug,ug,ug,ug,ug,ub,ub,ub,ub
ur,ux,ux,ux,ux,ub,ux,ub,ux,ux,ux,ux,ux,ux,ug,ug,ug,ug,ug,ub,ub,ub,ub
ur,ux,ux,ux,ux,ub,ux,ux,ux,ux,ux,ux,ux,ux,ux,ux,ux,ux,ux,ux,ux,ux,ub
ur,ux,ux,ux,ux,ub,ux,ux,ux,ux,ux,ux,ux,ux,ux,ux,ux,ux,ux,ux,ux,ux,ub
ur,ux,ux,ux,ux,ub,ub,ub,ub,ub,ub,ub,ub,ux,ux,ux,ux,ux,ux,ux,ux,ux,ub
ur,ur,ur,ur,ur,ur,ur,ur,ur,ur,ur,ur,ur,ur,ur,ur,cb,ub,ub,ub,ub,ub,ub