cb,cb,cb,cr,ur,ur,ur,ur,cg,ug,ug,ur,ur,ur,ur,ur,ur,ur,ur,ur,ur,ur,cb
ux,ur,ur,ur,ur,ur,ur,ur,cr,ur,ur,ur,ur,ur,ur,ug,ug,ug,ur,ur,ur,ur,ur
ur,ur,ur,ur,ur,ur,cb,ur,ur,ur,ur,cr,cr,ur,ur,cg,ur,ug,ug,ug,ur,ur,ur
ur,ur,ur,ur,ur,ur,ub,cr,ur,ur,ug,ux,ux,ux,ug,ur,ur,ur,ux,ug,ur,ur,ur
ur,ur,ur,ur,ub,cr,ur,ur,ur,ur,ur,ur,ur,ur,ur,ur,ur,ur,ug,ug,ur,ur,ur
ur,ur,ur,ur,ub,ub,ub,ur,ur,ug,ug,ug,ux,ux,ux,ug,ug,ug,ug,ux,ug,ur,ur
ur,ur,ur,ur,ub,ub,ur,cb,cr,ug,ug,ug,ug,ug,ug,ug,ug,ug,ug,ur,ur,ur,ur
cb,ur,ur,ur,ur,ur,ur,ub,ur,ur,ur,ur,ur,ur,ur,ur,cg,ug,ug,ur,ur,ur,ur
ur,ur,ur,ur,ux,ur,ur,ub,ub,ub,ub,ub,ub,ub,ub,ub,ub,ub,ub,ub,ub,ub,ur
ur,ur,ur,ur,ur,ur,ug,ux,ux,ux,ux,ub,ub,ug,ug,ug,ug,ug,ur,ur,ug,ub,ux
ub,ub,ub,ux,ug,ux,ub,ux,ux,ux,ug,ub,ub,ug,ug,ug,ug,ug,ur,ur,ug,ub,ux
ux,ub,ub,cb,ug,ug,ub,ub,ug,ug,ug,ug,ug,ug,ug,ug,ug,ug,ur,ur,ug,ub,ux
cb,ub,ub,ub,ub,ub,ub,ub,ux,ux,ug,ug,ub,ug,ug,ug,ug,ug,ux,ux,ux,ub,ux
ux,ub,ub,ub,ub,ug,ub,ub,ux,cg,ug,ug,ug,ug,ug,ub,ug,ub,ux,ux,ux,ub,ux
ux,ux,ux,ug,ug,ug,ug,ug,ug,ug,ug,ub,ub,ub,ub,ug,ug,ub,ux,ux,ux,ub,ux
ub,ub,ub,ub,cb,ug,ug,ug,ug,ug,ub,ub,ub,ub,ub,ub,ub,ux,ux,ux,ux,ub,ux
ub,ub,ub,ub,ub,ub,ub,ub,ug,cg,ub,ub,ub,ub,ub,cb,ug,ug,ug,ug,ux,ub,ux
cr,ux,ug,ug,ug,ug,ug,ug,ug,ug,ub,ub,ub,ub,ub,ug,ug,ug,ug,ug,ux,ub,ux
cg,ux,ug,ux,ug,ug,ug,ug,ug,ug,ub,ub,ub,ub,ug,ux,ux,ux,ux,ux,ux,ub,ub
cb,ux,ug,ux,ug,ub,ug,ug,ug,ug,ub,ub,ub,ub,ub,ub,ub,ub,ub,ub,ub,ub,ub
ux,ux,ug,ug,ug,ug,ug,ug,ug,ug,ub,ub,ub,ux,ux,ux,ux,ux,ux,ux,ux,ux,cr
cr,ux,ug,ug,ux,ub,ub,ug,ug,ug,ub,ub,ux,ux,ux,ux,ux,cb,cg,ux,cb,ux,cr
cg,cb,cg,cb,ux,ub,ub,ux,ub,ub,ub,ub,ux,ux,ux,cg,ux,ux,ux,cg,cg,ux,cr