ub,ub,cr,ur,cb,ur,ur,ur,ur,ur,ur,ur,ur,ur,ur,ur,ur,ur,ur,ur,ur,ur,ur
ub,ur,ur,ub,ub,ur,ur,ug,ur,ur,ux,ur,ur,ur,ur,ur,ur,ur,ur,ur,ur,ur,ur
cb,ur,ur,ub,ub,cr,ur,ug,ur,ur,ur,ur,ux,ux,ux,ur,ur,ur,ur,ux,ur,ur,ur
ur,ur,ur,ur,ur,ur,ur,ug,ug,ur,ur,ur,ur,ur,ur,ur,ur,ur,ux,ux,ur,ur,ur
ur,ur,ur,ur,ur,ur,ur,ur,ug,ug,ur,ur,ur,ur,ur,ur,ur,ur,ur,ur,ur,ur,ur
ur,ur,ur,ur,ur,ur,ur,ur,ur,ug,ur,ur,ur,ur,ur,ur,ur,ur,ur,ur,ur,ur,ur
ur,ur,ur,ur,ur,ur,ur,ur,ur,ug,ur,ur,ur,ug,cr,ur,ur,ur,ur,ur,ur,ub,ub
ur,ur,ur,ur,ur,ur,cg,ug,ur,ug,ur,ur,ur,ug,ug,ug,ug,ug,ux,ux,ub,ub,ub
cg,ur,ur,ur,ur,ur,ur,ug,ux,ug,ub,ub,ub,ub,ug,ug,ug,ug,ug,ug,ub,ub,ub
ur,ur,ur,ur,cr,cr,ur,ug,ub,ug,ub,ub,ub,ub,ug,ub,ug,ug,ug,ug,ub,ub,ub
ur,ur,ur,ux,ug,ug,ub,ug,ug,ug,ug,ub,ub,ub,ug,ug,ug,ug,cg,ug,ub,ub,ub
ux,ux,ug,ux,ug,ug,ub,ux,ug,ub,ug,ub,ub,ug,ug,ug,ug,ug,ux,ug,ub,ub,ub
ux,ux,ug,ux,ug,ug,ub,ub,ug,ug,ug,ub,ub,ug,ug,ug,ug,ug,ug,ug,ub,ux,ub
ux,ux,ug,ux,ug,ug,ub,cb,ub,ub,ux,ux,cb,ug,ug,ub,ub,ub,ub,ux,ub,ux,ub
cg,ux,ug,ux,ug,ug,ub,ub,ub,ub,ub,ub,ub,ub,ub,ub,ub,ux,ux,ux,ub,ub,ub
ug,ug,ug,ug,ug,ug,ug,ug,ug,ug,ug,ug,ug,ug,ub,ub,ub,ub,ub,ub,ug,ug,ug
ug,ux,ug,ux,ux,ug,ux,ux,ux,ux,ux,ux,ux,ux,ub,ub,ub,ub,ux,ub,ux,ux,ur
ug,ux,ug,ux,ux,ug,ux,ux,ux,ux,ux,ux,ux,ux,ub,ub,ub,cb,ub,ub,ux,ux,ur
ug,ux,ug,ux,ux,ug,ux,ux,ux,ux,ux,ux,ux,ux,ux,ub,ub,ub,ux,ux,ux,ux,ur
ug,ux,ug,ux,ux,ug,ux,ux,ux,ux,ux,ux,ux,ux,ux,ux,ux,ub,ux,ux,ux,ux,ur
ub,ub,ug,ug,ug,cg,ur,ur,ur,ur,ur,ur,ur,ur,ur,ur,ur,ub,ur,ur,ur,ur,ur
ub,ux,ux,ux,ux,ux,ux,ux,ub,ub,ub,cb,ur,cr,ub,ub,ub,ub,ub,ub,ub,ur,ur
ub,ub,ub,ub,ub,ub,ub,ub,ub,cg,ub,ub,ub,ub,ub,ub,ub,ub,ub,ub,ub,ur,ur