ur,ur,ur,ur,ur,ur,ur,ur,ur,ur,ur,ur,ur,ur,cr,ur,ur,ub,ub,ub,ub,ub,ub
ur,ur,ur,ur,ur,ur,ur,ur,ur,ur,ur,ur,ur,ur,ur,cr,cr,ur,ux,ux,ub,ux,ub
ur,ur,ur,ur,ur,ur,ur,ur,ur,ur,ur,ur,ur,ur,ur,ur,ub,ub,ux,ux,ub,cb,ub
ur,ur,ur,ug,cg,ur,ur,ur,ur,ur,ur,ug,ux,ux,ug,ub,ub,ug,ux,ux,ux,ub,ux
ur,ur,ur,ug,ug,ur,ur,ur,ur,ub,ub,ug,ux,ux,cb,ub,ub,ug,ux,ux,ux,ux,ux
ur,ur,ur,ur,cr,ur,cr,ug,ug,cg,ub,ub,ub,ub,ub,ub,ub,ub,ub,ub,ub,ub,ub
ur,ur,ur,ur,ur,ur,ur,ur,ug,ug,ub,ug,ux,ug,ug,ux,ux,ug,ux,ux,ux,ux,ub
ur,ur,ur,ur,ur,ur,cb,ug,ux,ux,ug,ug,ux,ub,ug,ux,ux,ug,ux,ux,ux,ux,ub
cg,ug,ur,ur,ur,ur,ub,ug,ug,ug,ub,ub,ub,ub,ug,ux,ux,ug,ux,ux,ux,ux,ub
cr,ur,ur,ur,ur,ug,ub,ug,ug,ux,ub,ub,ub,ux,ux,ux,ux,ug,ux,ux,ux,ux,ub
ur,ug,ur,ux,ur,ug,ub,ug,ug,ug,ub,ub,ub,ux,ug,ug,ug,ug,ux,ux,ux,ux,ub
ur,ug,ux,ur,ur,ug,ub,ug,ug,ug,ug,ug,ub,ub,ug,ug,ug,ug,ux,ux,ux,ux,ub
ur,ug,ux,ur,ur,ug,ub,ux,ub,ug,ub,ub,ub,ub,ug,ug,ug,ug,ux,ux,ux,ux,ub
ur,ug,ux,ur,ur,ug,ub,ub,ub,ug,ub,ub,ub,cb,ug,ug,ug,ug,ug,ux,ux,ux,ub
ur,ug,ux,ur,ur,ug,ub,ub,ub,ug,ub,ub,ub,ux,ub,ug,ux,ub,ug,ux,ux,ux,ub
ur,ug,ux,ur,ur,ug,ub,ub,ub,ug,cb,ub,ug,ub,ub,ub,ug,ug,ug,ux,ux,ux,ub
ur,ug,ux,ur,ur,ug,ub,ub,ub,ub,ub,ub,ug,ug,ub,ub,ug,ug,ug,ux,ux,ux,ub
ur,ug,ux,ur,ur,ug,ub,ub,ug,ug,ub,ub,ub,ug,ug,ug,ug,ug,ug,ux,ux,ux,ub
ur,ug,ux,ur,ub,ub,ub,ub,ug,ug,ug,ug,ug,ub,ub,ub,ub,ub,ub,ux,ux,ux,ub
ur,ug,ux,ur,ub,ux,ub,ux,ux,ux,ux,ux,ux,ub,ub,ux,ux,ux,ux,ux,ux,ux,ub
ur,ug,ux,ur,ub,ux,ub,ux,ux,ux,ux,ux,ux,ux,ux,ux,ux,ux,ux,ux,ux,ux,ub
ur,ug,ux,ur,ub,ux,ub,ux,ux,ux,ux,ub,ub,ux,ux,ux,ux,ux,ub,ub,ub,ux,ub
ur,ug,ug,ug,ug,ug,ug,ug,ug,ug,ug,cb,ug,ug,cg,ub,ub,ub,ub,ux,ub,ub,ub