ug,ug,cb,ur,ur,ur,ur,ur,cr,ug,ug,ug,ug,ug,ug,ug,ug,ug,cg,ur,ub,ur,ux
ug,ug,ur,cr,ug,ur,ug,ug,ur,ur,ug,ug,ug,ur,ur,ur,ur,ur,ur,cr,ub,ur,ug
ug,ug,ur,ur,ug,ux,ug,ug,ug,ur,ug,ur,ug,ug,ug,ug,ub,ug,ub,ur,ur,ur,ug
ug,ub,ur,ug,ug,ux,ux,ug,ug,ur,cg,ug,ug,ur,ug,ug,ug,ug,ur,ur,ub,ur,ug
ug,ug,ug,ug,ug,ug,ug,ug,ug,ur,ug,ug,ur,ug,ug,ug,ug,ug,ug,ug,ub,ub,ub
ub,ug,ub,ug,ug,ug,ug,ug,ug,ug,ug,ug,ug,ug,ug,ug,ug,ug,ug,ug,ub,ub,ub
ux,ux,ub,ug,ug,ug,ur,ug,ub,ug,ug,ug,ug,ug,ug,ug,ug,ug,ug,ug,ub,ub,ub
ux,ux,ub,ux,ug,ux,cb,ub,ub,ub,ug,ug,ug,ug,ux,ug,ug,ug,ug,ug,ur,ub,ub
ux,ux,ub,ux,ug,ux,ux,cg,ug,ug,ug,ux,ub,ub,ug,ug,ug,ub,ub,ub,ub,ub,ub
ux,ux,ub,ux,ug,ux,ux,ux,ug,ug,ub,ub,ub,ug,ub,ug,ug,ub,ub,ub,ub,ub,ur
ux,ux,ub,ux,ug,ux,ux,ux,ug,ug,ub,ub,ub,ub,ug,ug,ug,ub,ug,ur,ug,ur,cb
ux,ux,ub,ux,ug,ug,ug,ug,ug,ub,ub,ub,ub,ug,ug,ub,ub,ub,ug,ur,ug,ur,ur
ux,ux,ub,ux,ux,ux,ug,ug,ug,ub,ub,ug,ub,ub,ug,ug,ug,cb,ub,ub,ug,ur,ur
ux,ux,ub,ux,ux,ux,ug,ug,cg,ug,ug,ug,ug,ub,ub,ug,ug,ug,ub,ub,ug,ur,ur
ux,ux,ub,ux,ux,ux,ug,ug,ug,ug,ug,ug,ug,ub,ug,ug,ug,ug,ur,ub,ur,ur,ur
cg,ux,ub,ux,ux,ub,ub,ux,ug,ux,ux,ug,ug,ux,ug,ug,ug,ug,ug,ub,ur,ur,ur
ub,ub,ub,ub,ub,ub,cb,ur,ur,cr,ug,ug,ug,ug,ug,ug,ux,ux,ug,ub,ur,ur,ur
ub,ux,ub,ub,ub,ub,ub,ux,ux,ux,ux,ug,ug,ug,ug,ug,ux,ux,ug,ub,ur,ur,ur
ub,ux,ub,ux,ux,ux,ub,ux,ux,ux,ux,ux,ux,ux,ux,ux,ux,ux,ug,ub,ur,ur,ur
ub,ub,cb,ug,ug,cg,ub,ub,ub,ur,ur,ur,ur,ur,ub,cb,ub,ur,ur,ur,ur,ur,ur
cr,ub,ub,ub,ug,ug,ug,ux,ub,ub,ub,ub,ub,ub,ub,ub,ub,ux,ug,ur,ur,cr,ur
cg,ub,ub,ub,ub,ub,ub,ub,ub,ub,ub,ug,ub,ub,ug,ub,ub,ug,ug,ur,ur,cb,cr
cr,ub,cr,ub,ub,ug,ub,ub,ug,ub,ub,ux,ub,ub,ur,ub,ub,ur,ur,cg,cb,ux,cr