ur,ur,ur,ur,ur,ur,ur,ur,ur,cg,ur,ur,ur,ur,ur,ux,ux,cb,ux,ux,ux,ur,ur
cr,ur,cr,ur,ur,ur,ur,ur,ur,ur,ur,ux,ux,ux,ur,ux,ux,ux,ux,ux,ux,ur,ur
ur,cb,cg,ur,ur,cr,ur,ur,ug,ur,ur,ur,ub,ub,ub,ub,cg,ub,ub,ub,ub,ur,ur
ub,ub,ub,ur,ug,ug,ur,ug,ug,ur,ur,ur,ub,ub,ub,ux,ug,ux,ux,ux,ug,ur,ur
ur,ur,cr,ur,ur,cg,ur,ur,ur,ur,ur,ur,ub,ub,ub,cb,ug,ux,ux,ux,ug,ur,ur
ur,ur,cr,ug,ur,cb,ub,ug,ug,ur,ur,ur,ub,ub,ub,ub,ub,ux,ux,ux,ug,ur,ur
ub,ub,ur,ur,ur,ub,ub,ug,ug,ug,ux,ux,ux,ux,ub,ub,ub,ux,ux,ub,ub,ur,ur
ub,ux,ub,ux,ug,ub,ub,ub,ub,ug,ub,ub,ub,ux,cg,ug,ug,ug,ug,ug,ux,ur,ur
ub,ux,ub,ug,ub,ub,ub,ug,ub,ug,ug,ug,ub,ux,ug,ug,ug,ug,ug,ug,ux,ur,ur
ub,ux,ub,ub,ub,ub,ub,ug,ub,ug,ug,ug,ub,ub,ug,ug,ug,ug,ub,ug,ux,ur,ur
ub,ub,ub,ub,ub,ub,ub,ub,ub,ub,ug,ug,ub,ub,ub,ub,ub,ug,ub,ug,ug,ur,ur
ub,ub,ub,ub,ub,ub,ub,ub,ub,ub,ub,ub,ub,cb,ub,ug,ug,ug,ux,ug,ug,ur,ur
ub,ub,ub,ub,ub,ub,ub,ux,ug,ub,ub,ub,ub,ub,ug,ug,ug,ub,ub,ug,ux,ur,ur
ub,ub,ub,ub,ub,ub,cb,ub,ub,ub,ub,ub,ub,ub,ug,ug,ug,ub,ub,ug,ux,ur,ur
ub,ux,ub,ub,ub,ub,ub,ug,ug,ug,ug,ub,ub,ub,ug,ug,ug,ug,ub,ug,ux,ur,ur
ub,cb,ub,ub,ub,ug,ux,ug,ug,ug,ug,ug,ub,ub,ug,ug,ug,ug,ub,ug,ux,ur,ur
ub,ub,ub,ug,ub,ub,cg,ub,ug,ug,ug,ug,ub,ub,ug,ug,ub,ug,ux,ug,ux,ur,ur
ux,ux,ux,ug,ug,ug,ug,ub,ug,ug,ub,ug,ub,ub,ug,ug,ug,ug,ux,ug,ux,ur,ur
ux,ux,ux,ug,ug,ug,ug,ug,ub,ug,ug,ug,ux,ux,ug,ug,ub,ub,ux,ug,ux,ur,ur
ux,ux,ux,ub,ux,ub,ug,ug,ug,ug,ux,ux,ux,ub,ub,ub,ub,ub,ux,ug,ux,ur,ur
ux,ux,ub,ub,ub,ub,ux,ux,ub,ux,ux,cr,ur,ur,ur,ur,ur,ur,ur,ur,ur,ur,ur
cr,ux,ub,ub,ub,ub,ub,ub,ub,ux,ux,ux,ux,ux,ur,ub,ub,ub,ug,ug,ub,ur,cb
cg,ux,ub,ub,ub,ub,ub,ub,ub,ub,ub,ub,ub,ub,ur,ur,ur,ur,ur,ur,ur,ur,ur