ur,ur,ur,ur,cr,ug,ur,ur,ur,ur,ur,ur,ur,ur,ur,ur,ur,ur,ur,ur,ur,ur,cb
ur,ur,ur,ur,ur,ug,ug,ug,ug,ug,ug,ug,ug,cg,ur,ur,ur,ur,ur,ur,ur,ur,ur
ur,ub,ub,ub,cr,ur,ur,ur,ur,ur,ur,ur,ur,ur,ur,ur,ur,cr,ur,ur,ur,ur,ur
cb,ub,ur,ub,ur,ur,ur,ur,ur,ur,ur,ur,ur,ur,ur,ur,ur,ur,ur,ur,ur,ur,ur
ug,ug,ur,cr,ur,ur,ur,ur,ur,ub,ur,ur,ur,ur,ur,ur,ux,ur,ur,ur,ur,ur,ur
ur,ur,ur,ur,ur,ur,ur,ur,ur,ur,ur,ur,ur,ur,ur,ur,ur,ur,ur,ur,ur,ur,ur
ur,ur,ur,ur,ur,cg,ur,ur,ur,ug,ug,ur,ur,ur,ur,ur,ur,ur,ur,ur,ur,ur,ur
ur,ur,ur,ur,ub,ug,ub,ub,ub,ub,cb,cr,ur,ur,ur,ur,ur,ur,ux,ux,ux,ux,ub
cg,ur,ur,ur,ub,ug,ub,ub,ug,ug,ug,ug,ug,ug,ug,ug,ug,ug,ux,ux,ux,ux,ub
ur,ub,ub,ug,ub,ug,ub,ub,ug,ug,ug,ub,ug,ug,ug,ug,ug,ug,ug,ug,ux,ux,ub
ur,ub,ux,ur,ur,ug,ug,ug,ug,ug,ug,ub,ug,ub,ug,ug,ur,ug,ug,ug,ub,ub,ub
ur,ub,ur,ur,ub,ug,ug,ug,ug,ug,cg,ub,ub,ub,ub,ug,ur,ur,ur,ug,ux,ux,ub
ux,ub,ux,ux,ux,ug,ug,ug,ug,ug,ub,ub,ub,ub,ub,ug,ug,ux,ux,ug,ux,ux,ub
ux,ub,ux,ux,ux,ug,ug,ug,ux,ub,ub,ub,ub,ux,ug,ug,ug,ux,ux,ug,ux,ux,ub
ux,ub,cr,ux,ux,ug,ug,ug,ub,ub,ub,ub,ux,ug,ug,ug,ug,ug,ug,ug,ux,ux,ub
cb,ub,ur,ux,ux,ug,ug,ub,cb,ub,ub,ux,ux,ug,ug,ug,ug,ux,ug,ug,ux,ux,ub
ub,ub,ur,ux,ux,ux,ug,ux,ux,ux,ux,ux,ux,ux,ug,ug,ug,ug,ug,ug,ux,ux,ub
ub,ub,cb,ux,ux,ux,ug,ug,ux,ux,ux,ux,ux,ux,ux,ux,ux,ux,ux,ug,ux,ux,ub
ub,ub,ub,ux,ux,ux,ux,ug,ug,ug,ug,ug,ug,ug,ug,ug,ug,ug,ug,ug,ux,ux,ub
ub,ub,ub,ux,ux,ux,ux,ux,ux,ux,ux,ux,ux,ux,ux,ux,ux,ux,ux,ub,ux,ux,ub
ub,ub,ub,ux,ux,ux,ux,ux,ux,ux,ux,ux,ux,ux,ux,ux,ux,ux,ux,ub,ux,ux,ub
ub,ub,ub,ux,ux,ux,ux,ux,ux,ux,ux,ux,ux,ux,ux,ux,ux,ux,ux,ub,ux,ux,ub
ub,ub,ub,ub,ub,ub,ub,ub,ub,ub,ub,ub,ub,ub,ub,ub,ub,ub,ub,ub,ub,ub,ub