ug,ug,cb,ur,ur,ur,ur,ur,ur,ur,ur,ur,ur,ur,ur,ur,cg,ug,ug,ub,ub,ur,ur
ug,ug,ur,ur,ur,ur,ur,ur,ur,ur,ur,ur,ur,ur,ur,ur,ur,ur,cr,ug,ub,ur,ug
ug,ug,ur,ur,ur,ur,ux,ur,ur,ur,ur,ur,ur,ur,ur,ur,ub,ug,ub,cr,ub,ur,ug
ug,ub,ur,cg,ur,ur,ur,ur,ur,ur,ux,ux,ur,ug,ug,ub,ug,ug,ur,ur,cb,ur,ug
ug,ug,ug,ug,ur,ur,ur,ur,cg,ur,ux,ur,cr,ug,ug,ug,ug,ug,ug,ug,ug,ur,ur
ub,ug,ub,ug,ur,ug,ug,ug,ug,ug,ug,ug,ug,ug,ug,ub,ux,ux,ur,ug,ug,ug,ug
ux,ux,ub,ug,ug,ug,ur,ug,ug,ug,ur,ux,ug,ug,ug,ug,ug,ug,cg,ug,ub,ub,ug
ux,ux,ub,ux,ux,ux,ux,ug,ug,ug,ug,ug,ug,ug,ug,ug,ug,ug,ug,ug,ur,ug,ug
ux,ux,ub,ux,ux,ux,ux,ux,ug,ug,ux,ux,ub,ub,ug,ug,ug,ug,ug,ur,ug,ug,ub
ux,ux,ub,ux,ux,ux,ux,ux,ug,ug,ug,ug,ub,ug,ub,ug,ug,ug,ug,ur,ug,ur,ur
ux,ux,ub,ux,ux,ux,ux,ux,ug,ug,ug,ub,ub,ub,ug,ug,ug,ug,ug,ur,ug,ur,cb
ux,ux,ub,ug,ug,ug,ux,ug,ug,ub,ub,ub,ub,ug,ug,ub,ub,ug,ug,ur,ug,ur,ur
ux,ux,ub,ug,ug,ug,ux,ug,ug,cb,ug,ug,ub,ub,ug,ug,ug,ug,ub,ub,ug,ur,ur
ux,ux,cb,ug,ug,ug,ux,ux,ug,ug,ug,ug,ug,ub,ub,ug,ug,ug,ub,ub,ug,ur,ur
ux,ux,ur,ux,ux,ug,ug,ug,ug,ug,ug,ug,ug,ub,ug,ug,ug,ug,ur,ub,ur,ur,ur
cg,ux,cr,ux,ux,ux,ux,ug,ug,ux,ug,ug,ug,ux,ug,ug,ug,ug,ug,ub,ur,ur,ur
ux,ux,ub,ux,ux,ux,ux,ug,ug,ug,ug,ug,ug,ug,ug,ug,ux,ux,ug,ub,ur,ur,ur
ux,ux,ub,ub,ub,ub,cg,ug,ug,ug,ug,ug,ug,ug,ug,ug,ux,ux,ug,ub,ur,ur,ur
ux,ux,ux,ux,ux,ux,ug,ug,ug,ux,ux,ux,ux,ux,ux,ux,ux,ux,ug,ub,ur,ur,ur
ux,ux,ux,ub,ub,ub,ug,cb,ub,ub,ub,cr,ur,ur,ur,ur,ur,ur,ur,ur,ur,ur,ur
cr,ug,ug,ub,ug,ug,ug,ug,ub,cb,ug,ug,ug,ug,ug,ug,ug,ug,ug,ur,ur,cr,ur
cg,ug,ux,ub,ub,ub,ub,ub,ub,ug,ug,ug,ug,ug,ug,ug,ug,ug,ug,ur,ur,cb,cr
cr,ug,ug,ub,ub,ug,ub,ub,ug,ug,ur,ur,ur,ur,ur,ur,ur,ur,ur,cg,cb,ux,cr