ur,cb,cb,cr,ur,ur,ur,ur,ur,ur,ur,ux,ux,ur,ur,ur,ur,ur,ur,ur,ur,ur,cb
ur,ur,cb,ur,ur,ur,ur,ur,ur,ur,ub,ub,ub,ur,ur,ur,ur,ux,ux,ux,ux,ur,cg
ur,ur,ur,ur,ur,ur,ur,cg,ug,cb,ub,cr,ub,ub,ub,ub,ub,ug,ug,ug,ur,ur,ug
ur,ur,ur,ub,ur,ur,ur,ur,ur,ub,ur,ur,ub,ub,ub,ub,ub,ug,ug,ug,ux,ux,ug
ur,cr,cr,cr,ur,ur,ur,ur,ur,ur,ur,ug,ug,ug,ug,ug,ug,ug,ug,ur,ur,ur,ur
ur,ub,ur,ub,ur,ur,ur,ur,ur,ux,ur,ug,ug,ur,ug,ug,ug,ur,ug,ug,ug,ux,ur
ur,cr,ub,ub,cb,ur,ur,ur,ur,ur,ur,ug,ug,cg,ug,ug,ug,ug,cg,ug,cb,ux,ur
cb,ur,ux,ur,ur,ur,ur,ur,ur,ur,ur,ur,ug,ug,ur,ur,ur,ug,ur,ug,ub,ur,ur
ux,ur,ur,ur,ur,ur,ug,ub,ux,ux,ux,ug,ug,ug,ug,ug,ug,ug,ug,ug,ub,ux,ur
ub,ub,ug,ug,ub,ur,ug,ub,ux,ux,ux,ux,ug,ug,ug,ug,ug,ur,ug,ug,ub,ub,ub
ub,ug,ug,ug,ug,ur,ug,ug,ug,ux,ux,ux,ug,ug,ug,ux,ux,ur,ub,ub,ub,ub,ub
ub,ug,ug,ug,ug,ur,ug,ub,ug,ux,ux,ux,ug,ug,ux,ux,ux,ur,ux,ux,ux,cg,ub
cb,ug,ug,ug,ug,ur,ug,ug,ug,ux,ux,ux,ux,ug,ux,ux,ux,ur,ub,ub,ub,ug,ub
ub,ub,ug,ug,ug,cr,ub,ub,ux,ug,ux,ux,ux,ug,ug,ux,ux,ur,ub,ub,ub,ug,ub
ub,ub,ug,ug,ug,ug,ug,ux,ux,ug,ux,ux,ux,ux,ug,ug,ug,ur,ub,ux,ug,ug,ub
ub,ub,ug,ug,ug,ug,ug,ug,ug,ug,ug,ug,ug,ug,ug,ug,ug,ug,ug,ug,ug,ub,ub
ub,ub,ug,ug,ug,ug,ug,ug,ug,ug,ug,ug,ug,ug,ub,ug,ug,ub,ub,ub,ub,ub,ub
ub,cg,ug,cb,ug,ug,ux,ug,ug,ug,ug,ug,ug,ux,ub,ux,ug,ub,ub,ub,ub,ub,ub
ub,ub,ub,ub,ub,ug,ug,ug,ug,ug,ug,ug,ux,ug,ub,ug,ur,ub,ur,ug,ug,ug,ur
ub,ub,cb,ub,ub,ux,ug,ug,ux,ug,ux,ug,ug,ug,ub,ub,ug,ub,ug,ug,ur,ur,cb
cr,ub,ux,ub,ub,ux,ux,ug,ux,ug,ux,ug,ux,ux,ux,ub,ub,ub,ug,ur,ur,ur,cr
cg,ub,ub,ub,ub,ug,ug,ug,ux,ug,ux,ug,ug,ux,ux,ur,ub,ub,ur,cb,cb,ur,cr
cr,cg,cg,cb,ux,ux,ux,ux,ux,ug,ug,ug,ug,ux,ux,cg,ub,ub,ur,cg,cg,ur,cr