ur,ur,ur,ug,ug,ug,ug,ug,ug,ug,ug,ug,ug,ug,ug,ug,ug,ug,ur,ur,ur,ur,ur
ur,ur,cb,ub,ur,ur,ur,ur,ur,ur,ur,ub,ub,ub,ub,ur,ur,ug,ug,ur,ug,cr,ur
ur,ub,ub,ub,ur,ur,ur,ur,ur,ug,ug,ug,ug,ug,ug,ug,ug,ug,ug,ur,ug,ug,ur
cr,ub,ub,ub,ur,ur,ur,ur,ur,ur,ur,ub,ub,ug,ug,ug,ug,ug,ug,ur,ug,ug,ur
ur,ur,ur,ur,ur,ur,ur,ur,ur,ur,cr,ur,ub,ux,ug,ux,ug,ug,ug,ur,ug,ug,ub
ur,ur,ur,ur,ur,ur,ur,ur,ux,ux,ug,ur,ub,ug,ug,ub,ug,ub,ub,ur,ug,ug,ub
ur,ur,ur,cr,ug,ug,cg,ur,ur,ux,ug,ug,ub,ug,ug,ug,ug,ux,ub,ur,ug,ug,ub
ur,ur,ur,ur,ur,ub,ub,ur,ur,ug,ug,ub,ub,ux,ux,ub,ux,ux,ub,ur,ug,ug,ub
cr,ur,ur,ur,ub,cr,ub,ux,ux,ug,ug,ub,ug,ux,ux,ub,ub,ub,ux,ur,ug,ug,ub
ub,ub,ub,ur,ur,ur,ub,ub,ub,ub,ub,ub,ug,ub,ub,ub,ub,ub,ux,ur,ug,ug,ub
ub,ub,ub,ur,ur,ux,ux,ug,ug,ug,ug,ug,ub,ub,ub,ug,ug,ug,ug,cb,ug,ug,ub
ub,cb,ur,ur,ub,ux,ux,ug,ub,ub,ub,cb,ub,ub,ub,ub,ux,ux,ug,ub,ug,ug,ub
ur,ur,ur,ub,ub,ux,ux,ug,ub,ub,ub,ub,ub,ub,ub,ub,ug,ug,ug,ub,ug,ug,ux
ur,ur,ur,ub,ub,ux,ub,ug,ug,ub,ub,ug,cg,ub,ub,ug,ug,ug,ug,ub,ug,ug,ub
ub,ux,ux,ux,ux,ux,ux,ub,cb,ub,ub,ug,ub,ub,ub,ug,ug,ug,ug,ub,ug,ug,ub
ub,ux,ux,ux,ux,ux,ux,ub,ug,ug,ub,ug,ub,ub,ug,ug,ug,ug,ug,ub,ub,ug,ub
ub,ux,ux,ux,ux,ux,ux,ux,ux,ux,ub,ux,ub,ub,ug,ub,ug,ug,ub,ub,ug,ug,ub
ub,ux,ux,ux,ux,ux,ux,ux,ux,ux,ub,ub,ub,ub,ug,ub,ug,ux,ux,ug,ug,ux,ub
ub,ux,ux,ux,ux,ux,ux,ux,ux,ux,ub,ub,ux,ub,ub,ub,ug,ux,ux,ug,ux,ux,ub
ub,ub,ub,ub,ub,ub,ub,ub,ub,ub,ub,ub,ub,ub,ub,ub,ub,cg,ug,ug,ux,ux,ub
ub,ub,ub,ub,ub,ux,ux,ux,ux,ux,ub,ux,ux,ub,ux,ux,ux,ux,ux,ub,ub,ub,ub
ub,ux,ux,ux,ub,ux,ux,ux,ux,ux,ub,ux,ux,ux,ux,ux,ux,ux,ux,ub,ur,ur,ur
cb,ur,ur,ur,ub,ub,ub,ub,ub,ub,ub,ub,ub,ub,ub,ub,ub,ub,ub,ub,ur,ur,ur