ur,ur,cb,ur,ur,ur,ur,ub,ub,ub,ub,ub,ub,ub,cb,ur,ur,ur,ur,cg,ug,ug,ug
ur,ur,cr,ur,ux,cr,ur,cr,ur,ur,ur,ur,ur,ur,ur,ur,ur,ur,ur,ur,ur,ug,ur
ur,ur,ur,ur,ux,ux,ur,ur,ur,ur,ur,ug,ug,ug,ug,ur,ur,ur,ur,ur,ur,ur,cr
ur,ur,ur,ux,ur,ur,ur,ur,ur,ur,ur,cg,ur,ur,ug,ur,ur,ur,ur,ub,ur,ug,ug
ur,ur,ur,ur,ur,ux,ur,ur,ur,ur,ur,ur,ur,ug,ug,ub,ub,ub,ub,ux,ur,ur,ug
ur,ur,ur,ur,ur,ur,ur,ur,ur,ur,ur,ur,ur,ug,ur,ub,ux,ub,ux,ux,ur,ur,ug
ur,ur,ur,ur,ur,ur,ur,ur,ur,ur,ur,ur,ug,ug,ur,ub,ux,ux,ux,ux,ur,ur,ug
ur,ur,ur,ur,ur,ur,ur,ur,cr,ur,ug,ur,ug,ur,ub,ub,ug,ux,ux,ux,ur,ug,ug
ur,ur,ur,ur,ur,ur,ur,cg,ug,ug,ug,ub,ub,ug,ug,ub,ub,ub,ub,ux,ur,ur,ug
ur,ur,ux,ux,ux,ux,ux,ug,ug,ug,ug,ub,ub,ub,ug,ub,ub,ub,ub,ux,ur,ur,ug
ux,ug,ux,ux,ux,ux,ux,ug,ug,ug,ug,ub,ub,ub,ub,ub,ub,ub,ub,ub,ur,ub,ub
ux,ug,ug,ux,ux,ux,ux,ug,ug,ub,ug,ub,ub,ub,ub,ub,ub,ub,ux,ug,ur,ug,ub
cg,ux,ug,ux,ux,ux,ux,ug,ug,ux,ub,ug,ub,cb,ub,cg,ub,ub,ub,ug,ur,ug,ub
ux,ux,ug,ux,ux,ux,ux,ux,ux,ub,ub,ub,ub,ub,ux,ug,ub,ux,ux,ub,ur,ug,ub
ux,ux,ug,ux,ux,ux,ux,ux,ux,ug,ub,ub,ub,ub,ub,ug,ub,ug,ug,ub,ur,ug,ub
ux,ux,ug,ux,ux,ux,ux,ux,ux,ug,ux,ub,ub,ug,ug,ug,ub,ub,ub,ub,ur,ug,ub
ux,ux,ug,ux,ux,ux,ug,ux,ux,ux,ux,ub,ub,ug,ub,ub,ub,cb,ug,ug,cr,ug,ub
cg,ux,ug,ux,ux,ux,ug,ux,ux,ux,ux,ub,ub,ug,ub,ug,ub,ub,ug,ug,ub,ug,ub
ux,ux,ug,ux,ux,ux,ug,ug,ug,ug,ug,ub,ub,ug,ub,ug,ug,ub,ug,ug,ug,ug,ub
ux,ux,ug,ux,ux,ux,ux,ux,ux,ux,ug,ug,cb,ug,ub,ub,ug,ug,ub,ub,cb,ug,ub
cr,ux,ug,ux,ux,ux,ux,ux,ux,ux,ug,ux,ub,ug,ug,ub,ug,ug,ub,ub,ub,ub,ub
cg,cb,ug,ug,ug,ug,ug,ug,ug,ug,ug,ux,ub,ub,ub,ub,ub,ub,ub,ub,ux,cb,cr
cr,ux,ux,ux,ux,ux,cg,ug,ug,ug,ug,ug,ug,ug,ug,ug,ub,ub,ub,ub,cb,ux,cr