ux,ug,ug,ur,ur,ur,ur,ur,ur,cg,ur,ur,ur,ur,ur,ur,ur,cb,ur,ur,ur,ur,ur
ub,ug,ub,ub,ur,ur,ur,ug,cr,ur,ur,ur,ur,ub,ur,ur,ur,ur,ur,ur,ux,ux,ur
ub,cr,ur,cb,ur,ur,cr,ur,ub,ub,ur,ur,ur,ub,ur,ur,ur,ur,ub,ub,ub,ux,cr
ub,cg,ub,ur,ur,ug,ug,ur,ub,ub,ur,ub,ur,ub,ub,ub,ug,ug,ub,ub,ub,ux,ux
ur,ug,ug,ug,ug,ug,ur,cb,ub,ur,ur,ur,ur,ug,ug,ug,ug,ug,ug,ug,ux,ux,ux
ur,ur,ub,ur,ub,ub,ur,ur,ur,ub,ub,ub,ub,ub,ux,ug,ug,ug,ug,ug,ux,ux,ux
ur,ur,ub,ub,ub,ur,ur,ur,ur,ub,ub,ub,ub,ug,ug,ug,ug,ug,ug,ug,ux,ux,ux
ur,ur,ub,ub,ub,ur,ur,ur,ur,ub,ub,cb,ub,ub,ux,ug,ug,ug,ug,ug,ux,ux,ux
ur,ur,ur,ug,ug,ug,ug,ug,ug,ug,ub,ub,ub,ux,ux,ux,ux,ug,ug,ug,ux,ux,ux
ur,ur,ur,ug,ur,ur,ur,ux,cb,ug,cg,ub,ub,ug,ug,ux,ug,ug,ug,ug,ux,ux,ux
ur,ur,ur,ug,cr,ur,ux,ux,ub,ub,ub,ub,ub,ug,ug,ux,ug,ug,ug,ug,ux,ux,ux
ur,ur,ur,ur,ur,ux,ub,ub,ub,ub,ub,ub,ub,ug,ug,ux,ug,ug,ug,ug,ux,ux,ux
ur,ur,ur,ug,ur,ur,ub,ub,ug,ug,ub,ug,ug,ug,ug,ux,ub,ub,ug,ug,ux,ux,cg
ux,ux,ug,ug,ug,ug,ub,ub,ur,ur,ur,ug,ug,ub,ub,ub,ub,ub,ur,ur,ur,ur,ur
ux,ux,ub,ub,ub,ug,ub,ub,ub,ug,ub,ug,ug,ub,ub,ug,ug,ug,ug,ug,cg,ux,ur
ux,ub,ub,ub,ub,ug,ub,ub,ub,ug,ub,ub,ub,ub,cb,ub,ub,ub,ub,ux,cr,ux,ur
ux,ux,ug,ux,ux,cg,ub,ub,ux,ug,ub,ug,ug,ug,ub,ug,ub,ug,ub,ux,ur,ux,ur
cg,ux,ug,ux,ux,ur,ux,ub,ub,ug,ux,ug,ub,ub,ub,ug,ug,ug,ux,ux,ur,ux,ur
ub,ux,ug,ux,ux,ur,ux,ux,ux,ub,ub,ug,ux,ux,ub,ug,ug,ug,ux,ux,ur,ux,ur
ub,ug,ug,ub,ug,ur,ug,ug,ug,ug,ub,cb,ug,ug,ug,ug,ug,ug,ux,ux,ur,ur,ur
ub,ub,ub,ub,ub,ur,ux,ux,ub,ub,ub,ux,ux,ux,ux,ux,ug,ug,ux,ux,ur,ur,ur
cr,ug,ub,ub,ub,ur,ug,ub,ub,ug,ug,ug,ug,ug,ug,ug,ug,ug,ux,ux,ur,ux,cb
cg,ug,ug,ug,ub,ub,ub,ub,ur,ur,ur,ur,ur,ur,ur,ur,ur,ur,ur,ur,ur,ur,ur