ur,ur,ur,ur,ur,ur,ub,ux,ur,ur,ur,ur,ur,ur,ur,ur,ur,ur,ub,cg,ur,ur,ur
ur,ur,ur,ur,ur,ur,ur,ur,ur,ur,ur,ur,ur,ur,ur,ur,ur,ur,ur,ur,ur,ur,ur
ur,cr,ur,ur,ur,ur,ur,ur,ur,ur,ur,ur,ur,ug,ur,ur,ur,ur,ur,ur,ur,ur,ur
cr,ub,cb,ur,ur,ur,ur,ur,ur,ur,ur,ur,ur,ur,cr,ur,ur,ur,ur,ur,ur,ug,ur
ub,ub,ub,ur,ur,ur,ur,ur,ur,ur,ur,ur,ur,ur,ur,ur,ur,ur,ur,ur,ug,ug,ug
ur,ub,ub,cr,ur,ur,ur,ur,ur,ur,ur,ug,ug,ug,ug,ur,ur,ux,ux,ux,ub,ur,ug
ur,cb,ub,ub,ub,cr,ub,ub,ub,ug,ug,ug,ug,ug,ug,ux,ur,ur,ux,ux,ub,ur,ug
ur,ur,ur,ub,ub,ub,ub,ub,ub,ug,ug,ug,ug,ub,ux,ux,ux,ux,ux,ux,ub,ur,ug
ur,ub,ur,ub,ub,ug,ur,cg,ub,ug,ug,ug,ub,ub,ux,ux,ux,ux,ux,ux,ub,ur,ug
ur,ur,ur,ub,ub,ub,ub,ug,ub,ug,ug,ug,ub,ub,ub,ub,ub,ub,ub,ub,ub,ur,ug
ux,ub,ub,ub,ub,ub,ub,ug,ug,ug,ug,ug,ub,ub,ub,ub,ub,ux,ux,ux,ux,ug,ug
ux,ux,ub,ub,ub,ux,ux,ux,ub,ub,cb,ub,ub,ub,ug,ug,ug,ug,ug,ug,ux,ug,ur
ur,ur,ur,ur,ur,ur,ur,ur,ug,ug,ug,ug,ug,ug,ug,ug,ug,ug,ug,ug,ur,ug,cg
ur,ux,ug,ub,ub,ub,ub,ub,ug,ub,ub,ub,ub,ub,ug,ub,ug,ug,ug,cg,ug,ug,ug
ur,ux,ug,ux,ug,ub,ub,ub,ug,ug,ug,ub,cb,ug,ug,ub,ug,ug,ug,ug,ub,ug,ug
ur,ux,ug,ux,ug,ub,cg,ub,ug,ub,ub,ub,ub,ug,ub,ub,ug,ug,ug,ug,ub,ug,ug
ur,ur,ur,ur,ur,ur,ug,ug,ug,ub,ur,cg,ur,ug,ur,ur,ur,ur,ur,ur,ur,ur,cr
cg,ux,ug,ux,ug,ux,ub,ub,ub,cb,ub,ug,ug,ug,ug,ub,ug,ug,ug,ux,ug,ub,ug
ub,ub,ug,ub,ug,ug,ub,ug,ub,cb,ub,ug,ug,ug,ug,ub,ug,ug,ug,ux,ux,ug,ug
ub,ub,ug,ux,ug,ug,ub,ug,ub,ub,ub,ug,ur,ug,ug,ub,ux,ug,ux,ug,ug,ug,ub
cr,ux,ug,ux,ug,ug,ub,cb,ub,ub,ug,ug,ug,ug,ug,ug,ug,ug,ug,ug,ub,ub,ub
cg,ux,ug,ux,ux,ux,ub,ub,ub,ub,ug,ug,ur,ux,ux,ux,ux,ux,ug,ur,ur,cb,cr
cr,ux,ug,ug,ug,ug,ub,ub,ub,ub,ux,ug,ug,ug,ug,ug,ug,ug,ug,ur,cb,ux,cr