ur,ur,ub,cr,ur,ur,ur,ur,ur,ur,ur,ur,ur,ur,ur,ur,ur,cb,ur,ur,cb,ub,ub
ub,ub,ub,cr,ur,ur,ur,ur,ur,ur,ur,ur,ur,ur,ur,ur,ur,ur,ur,ur,ur,ur,ub
ub,cb,ur,ur,ur,ur,ur,ur,ur,ur,ur,ur,ur,ur,ur,ur,ur,ur,ur,ur,ur,ur,ub
ur,ur,ur,cr,ur,ur,ur,ur,ur,ur,ur,ur,ur,ur,ur,ur,ur,ur,ur,ur,ur,ur,ub
cb,ur,ur,ug,ur,ur,ur,ur,ur,ur,ur,cr,ug,ug,ug,ug,cg,ub,ur,ur,ur,ur,ub
ur,ur,ub,cb,ug,ur,ur,ur,ur,ur,ur,ub,ub,ub,ux,ub,ub,ub,ur,ur,ur,ur,ub
ur,ur,ub,ub,ug,ug,cg,ub,ur,ur,ug,cb,ub,ub,ub,ub,ub,ub,ur,cr,ur,ur,ub
ur,ur,ub,ub,ub,ub,ub,ug,ug,ug,ug,ux,ub,ur,ug,ub,ub,ub,ur,cr,ur,ur,ub
ug,ug,ug,ug,ug,ub,ub,ub,ug,ub,ug,ug,ub,ug,ug,ub,ug,ur,ur,ur,ur,ur,ub
ug,ug,ug,ug,ug,ub,ub,ub,ug,ub,ug,ur,ub,ug,ug,ub,ub,ub,ub,ub,ub,ub,ub
ug,ug,ug,ug,ug,ub,ub,ub,ub,ug,ug,ug,ub,ux,ux,ux,ux,ux,ux,ux,ux,ur,ur
ug,ux,ux,ug,ug,ug,ug,ug,ug,ug,ug,ug,ug,cg,ux,ux,ux,ux,ux,ux,ux,ur,ur
ug,ux,ux,ux,ug,ub,ub,ug,ub,ub,ub,ub,ug,ug,ug,ug,ug,ug,ux,ux,ux,ur,cg
ug,ug,ug,ug,ug,ub,ub,ux,ug,ug,ug,ug,ug,ug,ug,ug,ug,ug,ux,ur,ur,ur,ub
ur,ur,ur,ur,ur,ub,ub,ub,ug,ug,ug,ug,ux,ux,cg,ug,ug,ug,ux,ur,ur,ur,ur
ux,ux,ux,ux,ub,ub,ux,ub,ub,ug,ug,ug,ug,ug,ug,ug,ug,ug,ux,ur,ur,ur,ur
ux,ux,ux,ux,ub,ub,ub,ub,ub,ug,ug,ug,ug,ug,ug,ug,ug,ug,ux,ur,ur,ur,ur
cg,ux,ux,ux,ux,ux,ub,ub,ux,ug,ug,ug,ug,ug,ug,ug,ug,ug,ux,ur,ur,ur,ur
ux,ux,ux,ux,ux,ux,ub,ub,ux,ug,ug,ux,ux,ux,ux,ux,ux,ux,ux,ur,ur,ur,ur
ux,ux,ux,ux,ux,ux,ux,ux,ux,ux,ux,ux,ux,ux,ux,ux,ux,ux,ux,ur,ur,ur,ur
ux,ux,ux,ux,ux,ux,ux,ux,ux,ux,ub,ub,ub,ub,ub,ub,ub,ub,ub,ur,ur,ur,ur
cr,ux,ux,ux,ux,ux,ux,ux,ux,ub,ub,ub,ux,ux,ux,ux,ux,ux,ux,ur,ur,cb,cr
cg,ux,ux,ux,ux,ux,ux,ux,ub,ub,ub,ub,ux,cb,ux,ux,ux,ux,ux,cg,cb,ux,cr