ur,ux,ux,ur,ur,ur,ur,ur,ur,ur,ur,ur,ur,ur,ur,ur,ur,ur,ur,ur,ur,ur,ur
ur,ur,ur,ur,ur,ur,ur,ur,ur,ur,ur,ur,ur,ur,ur,ur,ur,ux,ur,ur,ur,ur,ur
ur,ur,ur,ur,ur,ur,ur,ur,ur,ur,ur,ur,ur,ur,ur,ur,ur,ur,ur,ur,ur,ur,ur
ur,ux,ur,ur,ur,ur,ur,ur,ur,ur,ur,ur,ur,ug,ur,ur,ur,ux,ur,ur,ur,ur,ur
ur,ur,ur,ur,ur,cr,ur,ur,ur,ur,ur,ur,ur,ur,ur,ur,ur,ur,ur,ur,ur,ur,ur
ur,ur,ur,ur,ur,ug,ur,ur,ur,ur,ur,ur,ur,ur,ug,ug,cr,cr,ur,ur,ur,ur,ur
ur,ur,ur,ur,ub,ug,ug,ug,cg,ur,cr,ub,ur,ur,ug,ur,ur,ur,ur,ur,ur,ur,ur
ur,ur,ur,ub,ub,ur,ug,ug,ur,ur,ub,ub,ub,ub,cg,ug,ug,ur,ur,ur,ur,ur,ur
cg,ur,ur,ub,ur,ur,ur,ur,ur,ur,cb,ug,ug,ug,ub,ug,ub,ur,ur,ur,ur,ur,ug
ur,ur,ur,cr,ur,cb,ub,ub,ub,ur,ur,ub,ug,ug,ub,ug,ub,ub,ub,ug,ux,ux,ug
ur,ur,ur,ur,ur,ux,ux,ub,ub,ur,ur,ub,ug,ux,ub,ug,ug,ug,ug,ug,ux,ux,ug
ux,ux,ux,ux,ux,ux,ux,ub,ub,ub,ub,ug,ug,ux,ub,ug,ug,ug,ug,ug,ug,ux,ug
ux,ux,ux,ux,ux,ux,ub,ub,ub,ub,ub,ug,ux,ux,ux,ug,ux,ug,ug,ug,ug,ux,ug
ux,ux,ux,ux,ux,ux,ub,ub,ug,ub,ub,ug,ux,ux,ug,ug,ub,ug,ug,ux,ux,ux,ug
cg,ux,ux,ux,ux,ux,ub,ub,ug,ub,ub,ug,ug,ug,ug,ur,ub,ub,ub,ub,ub,ub,ub
ux,ux,ux,ux,ux,ux,ux,ug,ug,ub,cb,ub,ub,ub,ub,ub,ub,cb,ub,ub,ux,ub,ub
ux,ux,ux,ux,ux,ux,ux,ug,ug,ug,ug,ub,ub,ub,ub,ub,ub,ub,ub,ub,ux,ub,ub
ub,ub,ub,ub,ub,ub,ub,ub,ub,ub,ug,ug,ug,ug,ug,ug,ug,ug,ug,cg,ux,ub,ub
ub,ux,ux,ux,ub,ub,ub,ub,ub,ug,ug,ub,ux,ux,ux,ux,ub,ub,ux,ux,ux,ub,ub
ub,ux,ub,ub,ub,ux,ux,ux,ux,ug,cr,ub,ub,ub,ub,ub,ub,ub,ub,ub,ub,ub,ub
ub,ux,ux,ux,ux,ux,ux,ux,ux,ux,ur,ux,ux,ux,ux,ux,ux,ux,ux,ux,ux,ux,ub
ub,ux,ux,ux,ub,ub,ux,ux,ux,ux,ur,ub,ub,ub,ub,ub,ub,ux,ub,ub,ub,ux,ub
ub,ub,ub,ub,ub,ub,cb,ux,ux,cg,ur,ur,ur,cb,ub,ub,ub,ub,ub,ub,ub,ub,ub