ur,ux,ux,ux,ux,ur,ur,ur,ur,ur,ur,ur,ub,ub,ub,ub,ub,ub,ub,cg,ug,ug,ug
ur,ux,ur,ur,ur,ur,ur,ur,ur,ur,ur,ur,cr,ub,ub,ub,ub,ub,ub,ub,ub,ub,ug
ur,ur,ur,ur,cr,cb,cr,ur,cb,ub,ur,ur,ur,ur,ur,ur,ub,ub,ur,ur,ur,ur,ug
ur,ur,ur,ur,ur,ub,ub,ub,ub,ub,ur,ur,ur,ub,ub,ur,ub,ub,ur,ur,ur,ur,ug
ur,ur,ur,ur,ur,ux,ux,ug,ub,ub,ub,ub,ub,cg,ub,ub,ub,ur,ur,ur,ur,ur,ug
ur,ur,ur,ur,ur,ur,ux,ug,ug,ug,ug,ub,ub,ug,ug,ug,cb,ug,ub,ur,ur,ur,ug
ur,ur,ur,ur,ur,ur,ur,ur,ur,ug,ug,ug,ux,ug,ug,ug,ug,ug,ub,ub,ur,ur,ug
ur,ur,cr,ur,cr,ur,ur,ur,ur,ur,cg,ug,ur,ur,ur,ur,ur,ur,ur,ur,ur,ur,ug
cg,ur,ur,ur,ur,ur,ur,ur,ur,ur,ux,ug,ug,ug,ug,ug,ux,ux,ub,ub,ub,ub,ug
ur,ur,ur,ur,ur,ur,ur,ur,ur,ub,ub,ug,ug,ub,ug,ug,ux,ub,ub,ub,ub,ub,ug
ur,ur,ur,ur,ur,ur,ux,ux,ub,ub,ub,ub,ub,cb,ug,ug,ub,ub,ub,ub,ub,ub,ug
ux,ux,ub,ux,ur,ur,ux,ux,ub,ur,ub,ub,ub,ub,ug,ug,ug,ux,ub,ub,ub,ub,ug
ux,ux,ub,ux,ux,ux,ub,ub,ub,ur,ub,ug,ug,ug,ug,ub,ug,ux,ux,ub,ub,ub,ug
ux,ux,ub,ux,ux,ub,ub,ub,ug,ur,ug,ug,ub,ub,ub,ub,ug,ug,ug,ug,ug,ub,ug
ug,ux,ub,ux,ux,ux,ub,ub,ug,ur,ub,ub,ub,ub,ub,ub,ug,ug,ug,ur,ug,ub,ug
ux,ux,ub,ux,ux,ub,ub,ug,ug,ur,ug,ub,ub,ub,ub,ub,ub,ub,ug,ug,ug,ug,ug
ux,ux,ub,ux,ux,ux,ub,ug,ug,ur,ug,ub,ub,ub,ux,ug,ux,ux,ux,ug,ub,ug,ug
ux,ux,ub,ux,ux,ux,ub,ug,ug,ur,ug,ub,cb,ub,ux,ug,ug,ug,ux,ug,ux,ug,ug
ux,ux,ub,ur,ux,ux,ux,ug,ug,ur,ug,ub,ub,ub,ux,ux,ug,ug,ux,ug,ux,ux,ug
ux,ux,cb,ur,ux,ux,ux,ug,ug,ur,ux,ux,ub,ub,ux,ux,ug,ug,ux,ug,ux,ux,ug
ux,ux,ux,ur,ux,ux,ux,ug,ug,ur,ux,ux,ux,ux,ux,ux,ux,ux,ux,ug,ux,ux,ug
ux,ux,ux,ur,ux,ux,ux,ux,ur,ur,ux,ux,ux,ux,ux,ux,ux,ux,ux,ug,ux,ux,ug
ux,ux,ux,ur,ur,ur,ur,ur,ur,ur,ur,ur,ur,ur,cr,ux,ux,ux,ux,ug,ug,ug,ug