ur,cb,cb,cr,ur,ur,ur,ur,ur,ur,ur,ur,ur,ur,ur,ur,ur,ub,ub,ub,ub,ur,cb
ur,ur,cb,ux,ur,ur,ub,ur,ur,ur,ur,ur,ur,ur,ur,ur,cb,ub,ur,ur,ub,ur,ux
ur,ur,ur,ur,ur,ug,cr,ur,ur,ur,ur,ur,ug,ug,cg,ur,ub,ub,ub,ub,ub,ur,ux
ur,cr,ug,ug,ug,ub,ux,ur,ub,ub,ug,ug,ug,ur,ux,ur,ur,ur,ur,ur,ur,ur,ux
ug,ug,ur,ur,ug,ug,ur,ur,ur,ur,ur,ur,ur,ur,ur,ur,ur,ur,ur,ur,ur,ur,ur
ur,ur,ur,ur,ur,ug,ur,ug,ur,ur,ur,ur,ur,cg,ug,ug,ug,ug,ug,ug,ur,ur,ur
ur,ur,ur,ur,ug,ug,ug,ug,ur,ur,ur,ur,ur,ur,ur,ur,ur,ur,ur,ug,ur,ur,ur
cb,cb,ub,ug,ug,ug,ur,ur,ur,ur,cr,ur,ur,ur,cg,ur,ur,ug,ug,ug,ur,ur,ur
ur,ur,ub,ug,ur,cr,ur,ur,ur,ur,ug,ug,ug,ug,cb,ug,ug,ug,ug,ug,ug,ug,ux
cr,ub,ub,ug,ug,ub,ux,ug,ux,ux,ug,ug,ug,ug,ub,ub,ug,ux,ug,ug,ug,ug,ux
ub,ub,ub,ub,ug,ub,ub,ug,ux,ux,ub,ug,ug,ub,ub,cg,ug,ug,ug,ug,ug,ug,ux
ux,ub,ub,ub,ug,ug,ug,ug,ux,ug,ug,ug,ug,ub,ug,ug,ux,ug,ug,ug,ug,ug,ux
cb,ub,ub,ux,ux,ug,ug,ug,ug,ub,ug,ug,ub,ug,ug,ug,ux,ug,ug,ug,ug,ug,ux
ub,ub,ub,ug,cr,ug,ug,ug,ug,ux,ub,ub,ub,ug,ug,ug,ug,ug,ug,ug,ug,ug,ux
cb,ub,ug,ug,ur,ug,ug,ug,ug,ug,ug,ug,ub,ug,ug,ug,ug,ug,ug,ug,ug,ug,ux
ux,ux,ug,ug,ur,ug,ug,ux,ux,ux,ux,ub,ug,ug,ug,ug,ug,ug,ug,ug,ug,ug,ux
ux,ux,ug,ug,ur,ug,ug,ug,ug,ux,ub,ug,ug,ug,ug,ug,ux,ux,ux,ug,ug,ug,ux
ur,ug,ug,ug,ur,ug,ug,ug,ug,ug,ug,ug,ug,ug,ug,ur,ur,ur,ur,ur,ur,ur,ur
ur,ug,ug,ug,ur,ub,cg,ug,ub,ux,ux,ux,ug,ug,ug,ug,ug,ux,ux,ug,ug,ug,ur
cr,ub,ub,ub,ub,ub,ug,ub,ub,cb,ur,cg,ug,ug,ug,ur,ug,ur,ur,ur,ur,ur,ur
cg,ub,ub,ub,ub,ub,ug,ug,ub,ub,ub,ux,ug,ug,ug,ug,ug,ux,ug,ug,ug,ug,cr
cr,ub,ub,ub,ub,ub,cb,ug,ub,ub,ub,ur,ug,ur,ux,ux,ux,ub,ub,cb,cb,ug,cr
cg,ur,cg,cb,ux,ug,ug,ug,ux,ux,ug,ug,ug,ur,ur,cg,ux,ux,ux,cg,cg,ug,cr