ux,ux,cb,ur,ur,ur,ur,ur,cr,ux,ux,ur,ur,ur,ur,ur,ur,ur,ur,cg,ur,cb,ur
ux,ur,ur,ur,ur,ur,ur,ur,ur,ur,ur,ur,ur,ur,ur,ur,ur,ur,ur,ug,ur,ub,ur
ux,ur,ur,ur,ur,ur,ur,ur,ur,ur,ur,ur,ur,ur,ug,ur,ur,ur,ur,ug,ur,ub,ur
ux,ur,ur,ur,ur,ur,ur,ur,ur,ur,ur,ug,ug,ur,ur,ur,ur,ub,cr,ur,ur,ub,ur
ux,ur,ur,ug,ur,ur,ur,ur,cr,ur,ug,ug,ug,ug,ug,cg,ur,ur,ur,ug,ur,ub,ur
ux,ur,ur,ug,ur,ur,ur,ur,ur,cr,ur,ur,ur,ur,ur,ur,ur,ur,ur,ug,ur,ub,ub
ux,ur,ur,ur,ur,ur,ur,ur,ur,ur,ur,ur,ur,ur,ur,ug,ug,ub,ub,ug,ug,ub,ux
ux,ux,ur,ur,ur,ug,ux,ux,cr,ur,ur,ur,ur,ug,ug,ub,ug,ug,ux,ug,ux,ub,ub
ux,ux,ur,ug,ub,ub,ub,ub,ub,ub,ub,ub,ub,ub,ub,ub,ub,ub,cb,ur,ur,ur,ub
ux,ux,ur,ug,ub,ug,ux,ug,ug,ug,ug,ug,ux,ug,ug,ug,ug,ub,ux,ug,ux,cr,ub
ux,ux,ux,ug,ub,ug,ux,ug,ux,ug,ux,cg,ux,ug,ux,ug,ug,ub,ux,ug,ux,ub,cb
ux,ux,ux,ug,ub,ub,ub,ub,ux,ub,ug,ug,ux,cb,cg,ug,ug,ub,ux,ug,ux,ub,ur
ux,ux,ux,ug,cg,ug,ug,ug,ug,ug,ug,ug,ug,ub,ub,ug,ug,ub,ux,ug,ug,ub,ub
ux,ux,ux,ug,ub,ub,ub,ug,ub,ub,ub,ug,ub,ub,ug,ug,ug,ub,ux,ug,ug,ug,ub
ux,ux,ub,ug,ur,ug,ub,ug,ub,ug,ug,ug,ub,ub,ux,ux,ug,ub,ux,ug,ug,ug,ub
cg,ug,ug,ug,ug,ug,ux,ub,ub,ug,ug,ug,ug,ug,ug,ux,ug,ub,ux,ug,ug,ug,ub
ub,ug,ub,ug,ub,ug,ux,ug,ub,ug,ux,ux,ub,ux,ug,ug,ug,ub,ux,ug,ug,ug,ub
ub,ug,ub,ug,ug,ug,ub,ug,ug,ug,ug,ug,ug,ur,ur,ur,ur,ub,ur,ug,ur,ur,ub
ub,ug,ug,ug,ug,ug,ur,ur,ug,ur,ug,ur,ug,ub,ur,ub,ur,ub,ub,ug,ur,ur,ub
ub,ug,cb,ub,ub,ug,ug,ug,ug,ux,ug,ug,ub,ub,ub,ub,ub,ub,ub,ub,ub,ub,ub
cr,cg,ub,ub,ub,ub,ub,ux,ux,ux,ux,ub,ub,ux,ub,ux,ub,ux,ub,ug,ur,ur,ur
cg,ux,ug,ub,ub,ub,ub,ux,ux,ux,ub,ub,ux,ux,ux,cb,ub,ub,ub,ug,ur,cb,cr
cr,ux,ux,ub,ub,ub,ub,ux,ux,ux,ux,ub,ub,ux,ux,ux,ux,ux,ux,ug,cb,ux,cr