ur,ur,cb,ur,ur,ur,ur,ur,ur,ur,ur,ur,ur,ur,ur,ur,ur,ur,ur,cg,ur,ur,ur
ur,ur,ur,ur,ur,ur,ur,ur,ur,ur,ur,cr,ur,ur,ur,ur,ur,ur,ur,ur,ur,ur,ur
ur,ur,ur,cb,ub,ur,ur,ur,ur,ur,ur,cg,ug,ur,ur,ur,ur,ur,ur,ur,ur,ur,ur
ur,ur,ur,ur,ub,ur,ur,ur,ur,ur,ur,ur,ug,ug,ur,ur,ur,ur,ur,ur,ur,cr,ur
ub,ub,cr,ub,ub,ur,ur,ur,ur,ur,ur,ur,ur,ur,ur,ur,ux,ur,ur,ur,ur,ur,ur
ub,ux,ux,ux,ub,ur,ur,ur,ur,ur,cg,ur,ur,ur,ur,ur,cg,ug,ug,ug,cr,ur,cr
ub,ux,ux,ux,ub,ub,ub,ur,ur,ur,ug,ur,ur,ur,ur,ug,ux,ux,ux,ub,ub,ug,ug
ub,ux,ux,ux,ub,ub,ub,ub,ug,ug,ug,ug,ur,ur,ur,ub,cb,ub,ub,ub,ug,ur,ug
ub,ub,ub,ub,ub,ub,ub,ug,ug,ug,ug,ug,ug,ug,ur,ub,ub,ub,ux,ub,ub,ub,ug
ur,ur,ur,ur,ur,ur,ur,ur,ub,ub,ug,ug,ub,ug,ub,ub,ur,ur,ur,ur,ur,ub,ub
ur,ux,ub,ux,ug,ub,ug,ub,ub,ub,ug,ug,ug,ug,ub,ug,ug,ug,ux,ux,ub,ub,ub
ur,ur,ur,ur,ur,ur,cb,ub,ug,ub,ug,ug,ug,ug,ub,ub,ux,ug,ux,ub,ub,ug,ug
cg,ux,ux,ux,ub,ug,ub,ub,ug,ug,ux,ug,ub,ug,ub,ub,ug,ug,ux,ub,ug,ug,ug
ux,ux,ux,ux,ux,ux,ur,ub,ub,cb,ux,ub,ub,ub,ub,ug,ug,ux,ux,cb,ug,ug,ug
ux,ux,ux,ux,ux,ux,ur,ub,ub,ub,ug,ub,ub,ug,ug,ug,ub,ux,ux,ux,ug,ug,ug
ux,ux,ux,ub,ub,ub,ur,ub,ux,ux,ug,ug,ug,ug,ub,ug,ug,ug,ug,ug,ug,ug,ug
ux,ub,ub,ug,ug,ub,ur,ub,ug,ug,ug,ux,ux,ux,ux,ub,ug,ux,ux,ux,ux,ug,ug
cg,ub,ub,ug,ub,ub,ur,ux,ub,ux,ux,ux,ux,ux,ux,ub,ug,ux,ux,ux,ux,ug,ug
ub,ub,ub,ug,ug,ub,cr,ub,ug,ug,ug,ug,ug,ug,ug,ug,ug,ur,ur,ug,ug,ug,ug
ub,ub,ux,ub,ug,ub,ub,ub,ub,ug,ug,ux,ug,ug,ug,ug,ug,ug,ug,ug,ug,ug,ug
cr,ub,ub,ub,ug,ub,ub,ub,ub,ub,ub,ux,ug,ug,ug,ug,ug,ug,ug,ug,ug,ug,ux
cg,cb,ux,ub,ug,cg,ub,ub,ux,ux,ux,ux,ux,ux,ux,ux,ux,ux,ux,ux,ux,cb,cr
cr,ux,ux,ub,ub,ux,ux,ux,ux,ux,ux,ux,ux,ux,ux,ux,ux,ux,ux,ux,cb,ux,cr