ub,cb,cb,cr,cr,ub,ub,ub,ub,ub,ub,ub,ux,ub,ub,ur,ub,ub,ub,ub,ux,ux,cb
ur,ur,cb,ur,ur,ur,cb,ur,ur,ur,ur,ub,ux,ub,ub,ub,ub,ur,ur,ub,ur,ur,ur
ur,ur,ur,ur,ur,ur,ur,ur,ux,ur,ur,ub,ub,ub,ub,ub,ur,ur,ur,ur,ur,ur,ur
ur,ur,ur,ur,ur,ur,ur,ur,ur,ur,ur,ur,ur,ur,ur,ur,ur,ur,ur,ur,ur,ur,ur
ur,ur,ur,ur,ur,ur,ur,ur,ur,ur,cr,ug,ug,ub,ub,ur,ur,ur,ur,cr,ug,ug,ux
ur,ur,ur,ur,ur,ur,ur,ur,ur,ur,ur,ur,ug,ub,ug,ug,ug,ub,ub,ug,ug,ug,ux
ur,ur,ur,ur,ug,ug,cg,ur,ur,ur,ur,ub,ug,ur,ug,ur,ub,ug,ug,ug,ug,ug,ub
cb,ur,ur,ug,ug,ur,ur,ur,ur,ur,cr,ur,ug,ug,ug,ug,ug,ug,ug,ug,ug,ug,ub
ub,cr,cb,ug,ur,ur,ur,ur,ur,ur,ur,ug,ug,ug,ug,ur,ug,ug,ub,ug,ug,ug,ub
ub,ub,ub,ug,ug,ub,ug,ug,ur,ur,ub,ug,ug,ug,ux,ur,cg,ug,ub,ub,ug,ug,ub
ub,ub,ub,ub,ug,ub,ub,ug,ub,ub,ub,ug,ug,ug,cg,ug,ug,ux,ub,ub,ug,ug,ub
ux,ub,ub,ub,ug,ug,ug,ug,ub,ug,ug,ug,ug,ug,ug,ug,ux,ux,ub,ub,ug,ug,ub
cb,ub,ub,ub,ub,ug,ug,ug,ug,ub,ug,ug,ub,ug,ug,ug,ux,ux,ub,ub,ug,ug,ux
cb,ub,ug,ug,ub,ug,ug,ug,ug,ug,ub,ub,ub,ub,ug,ur,ub,ux,ub,ub,ug,ug,ux
ux,ux,ug,ug,ug,ug,ug,ug,ug,ug,ug,ug,cb,ub,ug,ur,ub,ux,ub,ub,ug,ug,ub
ux,ux,ug,ug,ug,ug,ug,ux,ug,ux,ux,ux,ub,ub,ug,ur,ub,ub,ub,cg,ug,ug,ub
ux,ux,ug,ug,ub,ug,cg,ub,ub,ux,ux,ux,ug,ur,ug,ur,ub,ub,ub,ug,ug,ug,ub
cr,ug,ug,ug,ux,ux,ux,cr,ub,ux,ux,ux,ug,ug,ug,ug,ug,ub,ub,ug,ug,ug,ub
cg,ug,ug,ug,ux,ux,ug,ur,ub,ux,ux,ux,ux,ur,ug,ug,ug,ug,ug,ug,ug,ug,ux
cb,ur,ug,ug,ug,ug,ug,ur,ub,ug,ug,ug,ug,ug,ug,ug,ug,ug,ug,ug,ug,ug,ux
ux,ur,ur,ur,ur,ur,ur,ur,cg,ug,ug,ug,ug,ur,ug,ug,ug,ug,ug,ug,ug,ug,cr
cr,ur,ur,ur,ur,ur,ur,ur,ub,ub,cb,ur,ug,ur,ug,ug,ug,ub,ub,cb,cb,ug,cr
cg,ur,cg,cb,ux,ux,ux,ux,ux,ur,ug,ug,ug,ur,ur,cg,ux,ux,ux,cg,cg,ug,cr