ur,ur,ur,ux,ur,ur,ur,ur,ur,cg,ur,ur,ur,ur,ur,ur,ur,cb,ux,ub,ub,ux,ux
ur,ur,ur,ux,ur,ur,ur,ur,ur,ur,ug,ug,ug,ur,ur,ur,ur,ux,ux,ub,ub,ux,ux
ur,ub,cr,ur,ur,ur,ub,ur,ur,ug,ug,ur,ug,ur,ur,ur,ur,ug,ug,ug,ub,ux,ux
ur,cr,ur,ur,ur,ur,ub,cr,ur,ug,ur,ub,ug,ur,cr,ub,cr,ur,ub,ug,ub,ux,ux
ur,ur,ub,ub,ub,ur,ub,ub,ub,ub,ub,ub,ug,ub,ur,ur,ug,ug,ug,ug,ub,ux,ux
ub,ub,ub,ub,ur,ur,ux,ur,ub,ub,ub,ub,ug,ug,ux,ug,ug,ug,ug,ug,ug,ux,ux
ub,ub,ur,ur,ur,ug,ug,ug,ug,ub,ub,ug,ug,ux,ux,ux,ux,ux,ub,ux,ug,ug,ux
ux,ub,ux,ur,ur,ub,ub,ug,ub,ub,ub,ug,ug,ug,ug,ug,ug,ug,ug,ug,ub,ug,ur
ur,ur,ur,ur,ur,ur,ur,ur,ub,cb,ur,ug,ub,ub,ux,ug,ug,ug,ub,ug,ub,ug,ur
ur,ub,ub,ub,ug,ug,ug,ug,ub,cb,ug,ur,cg,ug,ug,ug,ub,ug,ub,ug,ub,ug,ur
ur,ug,ux,cg,ux,ug,ug,ub,ub,ub,cg,ug,ub,ug,ur,ub,ug,cb,ug,ug,ub,ug,ub
ur,ug,ux,ug,ug,ug,ub,ub,ub,ub,ub,ug,ug,ug,ur,ug,ug,ub,ug,cg,ux,ug,ug
ur,ug,ux,ub,ug,ug,ug,ub,ug,ub,ub,ub,ub,ub,ur,ug,ug,ub,ug,ub,ub,ux,ug
ur,ug,ug,ux,ug,ub,ug,cb,ug,ug,ug,ug,ug,ug,cr,ug,ug,ub,ub,ub,ub,ub,ug
ur,ux,ug,ux,ug,ug,ug,ug,ug,ug,ug,ub,ub,ub,ub,ug,ug,ub,ub,ub,ub,ux,ug
ur,ux,ug,ug,ux,ux,ug,ug,ug,ux,ug,ub,ub,ub,ub,ub,ub,ub,ub,ub,ub,ug,ug
ur,ux,ux,ug,ux,ux,ub,ug,ug,ux,ux,ub,ub,ub,ux,ug,ug,ub,ug,ub,ug,ug,ub
ur,ux,ux,ug,ux,ux,ux,ub,ub,ux,ux,ub,ux,ug,ug,ug,ug,ux,ug,ub,ub,ub,ub
ur,ux,ux,ug,ux,ux,ux,ux,ub,ux,ux,ub,ux,ug,ux,ux,ux,ub,cb,ub,ub,ub,ub
ur,ux,cg,ug,ux,ux,ux,ux,ub,ub,ub,ub,ux,ux,ux,ux,ux,ub,ub,ub,ub,ub,ub
ur,ur,ug,ug,ug,ug,ug,ug,ug,ug,ug,ug,ug,ug,ug,ug,ug,ub,ub,ub,ub,ub,ub
cr,ux,ux,ug,ux,ux,ux,ux,ux,ux,ux,ux,ub,ub,ub,ux,ux,ux,ux,ux,ux,ux,cb
cg,ux,ux,ux,ux,ux,ux,ux,ux,ux,ux,cb,ub,ub,ub,ux,ux,ux,ux,ux,ux,ux,ux