ug,ug,ug,ug,ug,ur,ur,ur,ur,ur,ur,ur,ur,ur,ur,cr,ur,ur,ur,ur,ur,ur,ur
ug,ug,ug,ug,ug,ur,ur,ur,ur,ur,ur,ur,ur,ur,ur,ub,cb,cr,ur,ur,ur,ur,ur
ug,ug,ug,ug,ug,ur,ur,ur,ur,ur,ur,ur,ux,ur,ur,ur,ur,ur,ur,ur,ur,ur,ur
ug,ug,ug,ug,ug,ur,ur,ur,ur,ur,ur,ur,ur,ur,ur,ur,ur,ur,ur,ur,ur,ur,ur
ux,ux,ur,ug,ug,cg,ur,ur,ur,ur,ur,ur,ur,ur,ur,ur,ur,ur,ur,ur,ur,ur,ur
ur,ur,ur,ur,ur,ug,ur,ur,ur,ur,ur,ur,ur,ur,ur,ur,ur,ur,ur,ur,ur,ur,ur
ur,ur,ur,ur,ur,cr,ur,ur,ur,ur,ur,ur,ur,ur,ur,ur,ur,ur,ur,cr,ux,ug,ur
ur,ur,ur,ur,ur,ur,ur,ur,ur,ur,ur,ug,ug,ur,ur,ur,ur,ur,ur,ur,ur,ug,ur
cg,ur,ur,ur,ur,ug,ur,ug,ug,ug,ug,cr,cg,ur,ur,ur,ur,ur,ur,ur,ux,ug,ur
ur,ur,ur,ur,ur,ug,ug,ug,ug,ug,ug,ur,ur,ug,ug,ug,ug,ug,ug,ug,ux,ug,ur
ur,ur,ur,ur,ur,ug,ug,ug,ub,ug,ub,ub,ug,ug,ug,ug,ug,ug,ug,ug,ug,ug,ur
ug,ug,ug,ug,ug,ug,ug,ug,ub,ub,ub,ub,ux,ub,ub,ub,ub,ux,ux,ux,ux,ux,ur
ug,ur,ur,ur,ur,ub,ub,ub,ub,cb,ub,ub,ug,ug,ug,ub,ub,ub,ub,ux,ux,ux,ur
ug,ug,ub,cb,ux,ub,ub,ub,ub,ub,ug,ug,ub,ub,ub,ub,ub,ub,ub,ub,ux,ux,ur
ug,ug,ub,ub,ux,ug,ub,ub,ub,ub,ub,ub,ub,ub,ub,ub,ub,ub,ux,ub,ux,ux,ur
ux,ug,ub,ub,ub,ub,ub,ub,ub,ub,ub,ub,ub,ub,ub,ub,ux,ux,ux,ub,ux,ux,ur
ux,ug,ub,ub,ub,ug,ug,ub,ux,ub,ub,ub,ub,ub,ub,ub,ub,ub,ub,ub,ux,ub,ub
ux,ug,ub,ux,ub,ug,ug,ub,ub,ub,ub,ub,ub,ub,ub,ub,ub,ub,ux,ux,ux,ub,ub
ux,ug,ub,ux,ub,ub,ub,ub,ub,ub,ux,ub,ub,ub,cb,ub,ux,ux,ux,ux,ux,ub,ub
ux,ug,ub,ux,ux,ux,ub,ug,ub,ub,ux,ux,ux,ux,ub,ub,ub,ub,ub,ub,ub,ub,ub
ux,ug,ug,ug,ug,ug,ug,ug,cb,cg,ub,ub,ub,ub,ub,ux,ux,ux,ux,ub,ub,ub,ub
ux,ux,ub,ub,ub,ub,ub,ub,ub,ub,ux,ux,ux,ux,ux,ux,ux,ux,ux,ub,ub,ub,ub
ux,ux,ux,ux,ux,ux,ux,ux,ux,ub,ub,ub,ub,ub,ub,ub,cr,ur,ur,cb,ub,ub,ub