ur,ur,ur,ur,ur,ur,ur,ur,ur,ur,ur,ur,ur,ur,ur,ur,ur,ur,ur,ur,ur,ur,ur
ur,ur,ur,ur,ur,ur,ur,ur,ur,ur,ur,ur,ur,ur,ur,ur,ur,cr,ur,ur,ur,ur,ur
ur,ur,ur,ur,ur,ur,ur,ur,ur,ur,ur,ur,ur,ur,cr,ug,ug,ub,ug,ug,ug,ur,ur
ur,ur,ur,ur,ur,ur,ur,ur,ur,ur,ur,ur,ur,ur,ur,ur,ub,cr,ur,ur,ug,ug,ur
ur,ur,ur,ur,ur,cg,ug,ug,ug,ug,ug,ug,ug,ur,ub,ur,ub,ur,ug,ur,ur,ug,ur
ur,ur,ur,ux,cg,ug,ur,ur,ur,ur,ur,ur,ur,ur,ub,ur,cb,ur,ug,ur,ur,ug,ur
ur,ur,ur,ur,cr,ur,ur,ur,ur,ur,ur,ur,ur,ur,ub,ur,ug,ug,ug,ur,ux,ug,ur
ur,ur,ur,ur,ur,ur,ur,ur,ux,ux,ux,ur,ur,ur,ub,ur,ug,ug,ug,ux,ux,ug,ux
ur,ur,ur,ur,ur,ur,ur,ur,ux,ux,ux,ur,ur,ur,ub,cb,ug,ug,ug,ur,ur,ug,ux
ur,ur,ur,ur,ur,ur,ur,ur,ur,ur,ur,ur,ur,ur,ur,ug,ug,ug,ug,ux,ux,ug,ur
ur,ur,ur,ur,ur,ur,ur,ur,ur,ur,ur,ub,ur,ug,ug,ug,ug,ug,ug,ux,ur,ug,ur
ur,ur,ur,ur,ur,ur,ux,ux,ux,ub,ub,ub,ub,ur,ux,ug,ug,ug,ug,ug,ur,ug,ur
ur,ur,ur,ur,ur,cr,ux,ux,ux,ux,ug,ub,ub,ur,ur,ug,ug,ug,ug,ug,ur,ug,ur
ub,ub,ub,ub,ub,cb,ux,ux,ux,ux,ug,cb,ub,ur,ur,ug,ur,ur,ur,ur,ur,ug,ur
ub,ux,ux,ux,ux,ux,ux,ux,ux,ux,ug,ug,ug,ug,cr,ug,ur,ur,ur,ur,ur,ug,ur
ub,ux,ux,ux,ux,ux,ux,ux,ux,ub,ug,ug,cg,ug,ur,ur,ur,ux,ur,ux,ux,ug,ur
ub,ux,ux,ux,ux,ux,ux,ux,ux,ub,ug,ug,ug,ug,ur,ur,ur,ur,ur,ux,ux,ug,ur
ub,ug,ug,ux,ux,ux,ux,ux,ux,ux,ug,ub,ur,ur,ur,ur,ux,ux,ur,ux,ux,ug,ur
ub,ux,ug,ug,ug,ug,ug,ug,ug,ug,ug,ux,ur,ur,ur,ur,ur,ur,ux,ux,ux,ug,ur
ub,ux,ux,ux,ux,ux,ux,ux,ux,ux,ux,ux,ur,ur,ur,ur,ur,ur,ux,ux,ux,ug,ur
ub,ub,ux,ux,ux,ux,ux,ux,ux,ux,ux,ux,ur,ur,ur,ur,ur,ur,ug,ug,ug,ug,ur
ub,ub,ub,ub,ub,ub,ub,ux,ux,ux,ux,ux,ur,ur,ur,ur,ur,ug,ug,ux,ur,ur,ur
ub,ub,ub,cb,ub,ub,ub,ux,ux,ux,ux,ux,ur,ur,ur,ur,ur,ur,ur,ur,ur,cb,ur