ur,ur,ur,ur,ur,ur,ur,ur,ur,ur,ur,ur,ur,ur,ur,ur,cr,ub,cb,ur,ur,ur,ur
ur,ur,ur,ur,ur,ur,ur,ur,ur,ur,ur,ur,ur,ur,ur,ur,ur,ur,ur,ur,ur,ur,ur
ur,ur,ur,ur,ur,ur,ur,ur,cb,ub,ub,ub,ub,ur,ur,ur,ur,ur,ur,ur,ur,ur,ur
ur,ur,ur,ur,ur,ur,ur,ur,ur,ur,ur,ur,ub,ub,ur,ur,ur,ur,ur,ur,ux,ur,ux
ur,ur,cr,ur,ub,cr,ur,ur,cg,ur,cg,ub,ub,ub,ur,ur,ur,ur,ur,ur,ux,ur,ur
ur,ur,ug,cb,ub,ug,ug,ug,ug,ub,ug,ug,ug,ug,cr,ub,ub,ur,ur,ur,ur,ur,ur
ug,ug,ux,ux,ub,ub,ug,ub,ub,ub,ur,ub,ub,ub,ur,ur,cb,ur,ur,ur,ux,ux,ux
ub,ug,ux,ub,ub,ug,ug,ug,ug,ug,ur,ub,ub,cb,ub,ub,cr,ug,ug,ug,ug,ux,ux
cg,ug,ub,ub,ug,ug,ug,ug,ug,ug,ur,ub,ub,ub,ub,ur,ug,ug,ug,ug,ug,ux,ux
ux,ug,ux,ur,ug,ur,ub,ug,ug,ug,ug,ug,ub,ub,ub,ug,ug,ug,ug,cg,ug,ux,ux
ug,ug,ux,ur,ug,ug,ug,ug,ug,ug,ug,ug,ub,ub,ug,ug,ub,ug,ug,ux,ux,ux,ux
ug,ur,ur,ur,ug,ug,ub,ub,ug,ug,ub,ub,ug,ug,ug,ub,ub,ug,ug,ux,ux,ux,ux
ug,ug,ug,ug,ug,ug,ur,ug,ur,ug,ub,ub,ug,ug,ug,ub,ux,ux,ux,ux,ux,ux,ux
ux,ux,ux,ux,ug,ug,ug,ug,ur,ug,ug,ug,ug,ub,ub,ux,ux,ux,ux,ux,ux,ux,ux
cg,ux,ux,ux,ug,ux,ug,ug,ur,ur,ur,ur,ur,cr,ug,ug,ug,ug,ug,ug,ub,ub,ub
ux,ux,ux,ux,ug,ux,ux,ug,ur,ux,ub,ux,ux,ux,ug,ug,ug,ug,ug,ug,ug,ux,ub
ux,ux,ux,ux,ug,ux,ux,ug,ur,ux,ub,ux,ux,ux,ug,ug,ug,ug,ug,ug,ug,ux,ub
ux,ux,ux,ux,ug,ux,ux,ug,ur,ux,ub,ux,ux,ux,ug,ug,ug,ub,ux,ug,ug,ux,ub
ux,ux,ux,ug,ub,cb,ug,ug,ur,ux,ub,ux,ux,ux,ux,ux,ug,ug,ux,ug,ug,ux,ub
ux,ub,ub,ub,ub,ux,ux,ux,ur,ux,ub,ux,ux,ux,ux,ux,ux,ug,ug,ug,ug,ux,ub
ub,ub,ub,ub,ub,ub,ub,ub,ur,ub,ub,ub,ub,ub,ub,ub,ub,ub,ub,ub,ub,ub,ub
ub,ub,ub,ub,ub,ub,ub,ux,ur,ux,ub,ub,ub,ub,ub,ub,ub,ub,ub,ub,ub,ux,ux
ub,ub,ub,ub,ub,ub,ub,ur,ur,cg,ub,ub,ub,ub,ub,ub,ub,ub,ub,ub,ub,ux,ux