cb,cb,cb,cr,ur,ur,ur,ur,ur,ur,ur,ur,ur,ur,ur,ur,ub,ub,cg,ug,ub,ur,cb
ur,ur,ur,cr,ug,ur,ur,ur,ur,ur,ur,ur,ur,ur,ur,ur,ub,ur,ur,cr,ug,ug,ug
ur,cr,ur,ur,cg,ur,ur,ur,ur,ur,ur,ur,ur,ur,ur,ur,cb,ur,ur,ur,ub,ug,ug
ur,ur,ur,ur,ug,ur,ur,ub,ub,ur,ur,ur,ur,ur,cg,ug,ur,ur,ur,ub,ug,ug,ur
ur,ur,ur,ur,ug,ug,ur,cr,ub,ub,cb,ur,ur,ur,ur,cr,ur,ur,ug,ux,ug,ur,ur
ur,ur,ur,ur,ug,ub,ub,ur,ur,ur,ur,ur,ur,ur,ur,ur,ug,ug,ug,ug,ug,ur,ur
ur,ub,ub,cb,ug,ub,ub,ub,ur,ur,ur,ur,ur,ur,ux,ur,ug,ug,ur,ug,ug,ur,ur
cb,ub,ub,ub,ug,ub,ub,ub,ub,ur,ur,ur,ur,ug,ug,ug,ug,ug,ug,ug,ug,ux,ug
ur,ub,ub,ub,ub,ur,ur,ur,ur,ur,ur,ur,cr,ug,ug,ug,ug,ug,ux,ux,ug,ux,ug
ub,ub,ur,ub,ur,ur,ur,ur,ur,ur,ur,ur,ug,ug,ug,ug,ur,ug,ug,ub,ug,ug,ug
ur,ub,ur,ub,ur,ur,ur,ur,ur,ur,ug,ug,ug,ug,ug,ug,ur,ug,ug,ug,ug,ug,ux
ub,ub,ub,ub,ug,ug,ub,ub,ub,ug,ug,ug,ug,ug,ug,ug,ur,ug,ug,ug,ux,ug,ux
cb,ub,ub,ug,ug,ux,ux,ug,ub,ug,ug,ug,ub,ug,ug,cg,ug,ug,ug,ub,ux,ug,ux
ux,ux,ux,ug,ug,ug,ux,ug,ub,ub,ub,cb,ub,ug,ug,ug,ug,ug,ug,ub,ux,ug,ux
ux,ux,ux,ug,ug,ug,ux,ug,ub,cb,ub,ub,ub,ub,cg,ug,ug,ug,ug,ub,ug,ug,ux
ug,ug,ug,ug,ug,ug,ug,ug,ub,ub,ub,ub,ub,ub,ub,ub,ur,ux,ug,ub,ux,ux,ux
ug,ug,ug,ug,ug,ux,ug,ug,ug,ug,ug,ux,ux,ug,ux,ux,ur,ux,ug,ug,ux,ux,ux
cr,ux,ux,ux,ug,ux,ug,ug,ug,ug,ug,ux,ux,ug,ux,ux,ur,ux,ug,ug,ub,ub,ub
cg,ux,ux,ux,ug,ug,ug,ug,ug,ug,ug,ub,ub,ug,ub,ub,ur,ub,ug,ug,ub,ub,ub
cb,ux,ux,ux,ug,ux,ux,ux,ug,ug,ug,ux,ux,ug,ug,ug,ug,ug,ug,ug,ux,ux,ux
ux,ux,ux,ux,ux,ux,ux,ux,ug,ug,ug,ug,ug,ug,ug,ug,ug,ug,ug,ug,ux,ux,cr
cr,ux,ux,ux,ux,ux,ux,ux,ux,ux,ux,ux,ux,ux,ux,ux,ur,cb,cg,ux,cb,ux,cr
cg,cb,cg,cb,ux,ux,ux,ux,ux,ux,ux,ux,ux,ux,ux,cg,ur,ur,ur,cg,cg,ux,cr