cb,ub,ur,ur,ur,ur,ur,ur,ur,cr,ur,ur,ur,ur,ur,ur,ur,ur,ur,ur,ur,ur,ur
ur,cr,ur,ur,ur,ur,ur,ur,ur,ur,ur,cr,ub,ur,ur,ur,ur,ur,ur,cr,ux,ur,ur
ur,ur,ur,ur,ur,ur,ur,ur,ur,ur,ur,ub,ub,ur,ur,ur,ur,ur,ur,ur,ur,ur,ur
ur,ur,ur,ur,ur,ur,ur,ur,ur,ur,ur,ub,ub,ur,ur,ur,ur,ur,ur,ur,ur,ur,cb
ur,ur,ur,ur,ur,ur,ur,ux,ur,ug,ug,ug,ug,ug,cg,ur,ur,ur,ur,ur,ur,ux,ux
ur,ur,ur,ur,ur,ur,ur,ug,ug,ug,ug,cb,ub,ur,ur,ur,ur,ur,ur,ur,ur,ur,ux
ur,ur,ur,ur,ur,ur,ur,ug,ug,ug,ug,ub,ub,ur,ur,ur,ug,ug,ux,ur,ur,ur,ux
ur,ur,ur,ur,ur,ur,ur,ug,ug,ug,ug,ub,cr,ur,ur,ur,ug,ug,ur,ur,ur,ur,ux
cg,ur,ur,ur,ur,ur,ur,ug,ug,ug,ug,ug,ur,ur,ur,ur,ug,ug,ux,ux,ux,ur,ux
ur,ur,ur,ur,ur,ur,ur,ug,ug,ug,ug,ug,ug,ug,ug,cg,ug,ug,ur,ur,ux,ur,ux
ur,ur,ur,ur,ur,ur,ur,ur,ug,ug,ug,ug,ug,ux,ux,ux,ux,ug,ux,ur,ur,ur,ux
ur,ur,ur,ur,ur,ur,ur,ur,ur,ub,ur,ub,ug,ug,ug,ug,ug,ug,ug,ux,ux,ux,ux
ur,ur,ur,ur,ur,ur,ur,ug,ub,ub,ub,ub,ub,ub,ub,ub,ub,ub,ub,ub,ub,ub,ub
ur,ur,ur,ur,ur,ur,ur,ug,ug,ug,cg,ub,ub,ub,ub,cb,ub,ub,ub,ub,ub,ub,ub
cg,ur,ur,ur,ur,ur,ur,ux,ug,ub,ub,ug,ug,ug,ub,ub,ub,ub,ub,ux,ux,ux,ub
ug,ug,ug,ug,ug,ux,ux,ux,ug,ub,ug,ug,ub,ub,ub,ug,ug,ub,ux,ux,ux,ux,ub
ug,ux,ux,ug,ug,ug,ug,ug,ug,ux,ug,ux,ub,ub,ub,ub,ub,cb,ux,ux,ux,ux,ub
ug,ux,ux,ug,ux,ug,ug,ug,ug,ug,ug,ux,ub,ub,ub,ub,ub,ub,ux,ux,ux,ux,ub
ug,ux,ux,ug,ug,ug,ug,ux,ug,ux,ux,ux,ux,ux,ub,ub,ug,ub,ux,ux,ux,ux,cb
ug,ux,ux,ug,ug,ug,ug,ux,ug,ux,ux,ux,ux,ux,ux,ub,ux,ux,ux,ux,ux,ux,ur
ub,ub,ub,ub,ub,ub,ub,ub,ug,ug,ug,ub,ub,ub,ub,ug,ub,ub,ub,ub,ub,ub,cr
ub,ux,ux,ug,ug,ug,ug,ux,ub,ux,ug,ug,ug,ug,ug,ug,ux,ux,ux,ux,ux,ux,cb
ub,ub,ub,ub,ub,ub,ub,ub,ub,cg,ux,ux,ux,ux,ux,ux,ux,ux,ux,ux,ux,ux,ux