ur,ur,ur,ur,ur,ur,ur,ur,ur,ur,ur,ur,ur,ur,ur,cr,ux,ux,ux,ux,ur,ur,ur
ur,ur,ur,ur,ur,ur,ux,ux,ur,ur,ur,ur,ur,ur,ur,ur,ur,ur,ur,ur,ur,ur,ur
ur,ur,ur,ur,ur,ur,ur,ur,ur,ur,ur,ur,ur,ur,ur,ur,ur,ur,ur,ur,ur,ur,ur
ur,ur,ur,ug,ug,cg,ur,ur,ur,ur,ur,ur,ur,ur,ur,ur,ur,ur,ur,ur,ur,ux,cb
ur,ur,ur,ug,ug,ug,ur,ur,ur,ur,ur,ur,ur,ur,ur,ur,cg,ur,ur,ur,ur,ur,ur
ur,ur,ur,ur,ur,cr,ur,ur,ur,ur,ur,ur,ur,cr,ub,ub,ug,ub,ub,ub,ux,ux,ur
ur,ur,ur,ur,ur,ur,ug,ug,ur,ur,ur,ur,ub,ur,ux,ug,ug,ur,ur,ub,ux,ux,ur
ur,ur,ur,ur,ur,ur,cr,ug,cr,ur,cb,ub,ub,ur,ur,ur,ug,ur,ur,ub,ux,ux,ur
cg,ur,ur,ur,ur,ug,ug,ug,ub,ub,ub,ub,ur,ur,ur,ur,ug,ub,ub,ub,ux,ux,ur
ur,ur,ur,ur,ug,ug,ug,ug,ub,cb,ub,ub,ub,ub,ub,ug,ug,ub,ug,ub,ux,ux,ur
ur,ur,ur,ur,ur,ur,ur,ug,ug,ub,ub,ub,ub,ub,ub,ub,cb,ub,ug,ub,ux,ux,ur
ur,ur,ur,ur,ur,ur,ur,ug,ug,ug,ub,ub,ub,ub,ub,ub,ub,ub,ug,ub,ux,ux,ur
ur,ur,ur,ur,ur,ur,ux,ux,ug,ug,ur,ur,ub,ur,ub,ub,ub,ub,ug,ug,ux,ux,ur
ur,ur,ur,ub,ub,ur,ux,ur,ur,ug,ug,ug,ug,ug,ug,ug,ug,ux,ur,ug,ux,ux,ur
cg,ur,ug,ub,ub,ur,ur,ur,ur,ug,ug,ug,ug,ug,ug,ug,ug,ug,ur,ug,ux,ux,ur
ub,cr,ug,ug,ub,ur,ub,ub,cb,ug,ug,ug,ug,ug,ug,ug,ug,ug,ur,ug,ux,ux,ur
ub,ub,ub,ug,ug,ug,ub,ur,ur,ur,ug,ug,ub,ub,ub,ub,ur,ug,ur,ug,ux,ux,ur
ub,ub,ub,ux,ub,ug,ub,ux,ux,ux,ug,ug,ub,ub,ub,ub,ur,ux,ur,ug,ux,ux,ur
ub,ub,ub,ux,ub,cg,ub,ux,ux,ux,ux,ux,ub,ux,ug,ub,ur,ug,ur,ug,cb,ux,ur
ub,ub,ub,ux,ub,ub,ux,ux,ux,ux,ux,ux,ux,ux,ug,ub,ur,ug,ur,ux,ub,ux,ur
ub,ux,ub,ux,ub,ub,ux,ux,ux,ux,ux,ux,ux,ub,ug,ub,ur,ug,ur,ub,ub,ur,ur
ub,ub,ub,ux,ub,ub,ux,ux,ux,ux,ux,ux,ub,ub,ug,ug,ug,ug,ub,ub,ur,ur,cb
ub,ub,ux,ux,ub,ub,ux,ux,ux,cg,ux,ux,ux,ux,ux,ub,ub,ub,ub,ur,ur,ur,ur