ur,ur,ur,ur,ur,ur,ur,ur,ur,ur,ur,ur,ur,cg,ur,ur,ur,ur,ur,ur,ur,ur,ur
ur,ur,cg,ug,ug,ug,cb,ub,cr,cr,ur,ur,ur,ug,ur,ur,ur,ur,ur,ur,ur,ur,ur
ur,ur,ur,ug,ug,ug,ur,ur,ur,ur,ur,ur,ur,ug,ur,ux,ur,ur,ur,ur,cr,cr,ux
ur,ur,ug,ug,ug,ug,ur,ur,ur,ur,ug,ug,ug,ug,ur,ur,ur,ur,ur,ur,ub,ur,cb
ux,ur,ug,ug,ug,ur,ur,ur,ur,ur,ur,ur,ug,ug,ug,ug,ug,cb,ub,ub,ub,ug,ug
ux,ur,ux,ug,ur,ur,ur,ur,ur,ur,ur,ur,ur,ur,ur,ur,ur,ur,ug,ur,ux,ur,ug
ur,ur,ur,ug,ug,ug,ur,ur,ur,ur,ur,ur,ur,ur,ur,ur,ur,ur,ux,ux,ux,ux,ug
ur,ur,ux,ug,ug,ug,ur,cr,ub,ub,ur,ur,ub,ur,ur,ur,ur,ur,ux,ux,ux,ux,ug
cg,ux,ux,ug,ug,ug,ur,ub,ub,ub,ug,ug,cg,ug,ug,ug,ug,ug,ux,ux,ux,ux,ug
ux,ux,ux,ug,ug,ug,ur,ug,ub,ub,ub,ug,ug,ug,ug,ug,ux,ug,ux,ux,ux,ux,ug
ux,ux,ux,ug,ug,ug,ur,ub,ub,ub,cb,ug,ub,ug,ug,ug,ug,ug,ur,ux,ux,ux,ug
ux,ux,ux,ug,ug,ug,ug,ub,ub,ub,ux,ub,ub,ub,ug,ug,ug,ug,ur,ur,ur,ur,ug
ux,ux,ux,ug,ug,ux,ug,ux,ub,cb,ub,ub,ub,ub,ub,ub,ub,ub,ub,ub,ub,ub,ug
ux,ux,ux,ux,ux,ux,ug,ux,ub,cr,ug,ub,ub,ub,cb,ub,ub,ub,ub,ux,ux,ux,ug
cg,ux,ux,ux,ux,ux,ug,ux,ub,ug,ug,ug,ug,ub,ub,ub,ub,ub,ub,ux,ux,ux,ug
ux,ux,ux,ux,ux,ux,ug,ug,ub,ux,ux,ux,ub,ub,ub,ub,ub,ux,ux,ux,ux,ux,ug
ux,ux,ux,ux,ux,ux,ux,ux,ub,ux,ux,ux,ub,ub,ub,ug,ub,ub,ub,ub,ux,ux,ug
ux,ux,ux,ux,ux,ux,ux,ux,ub,ux,ub,ub,ub,ux,ub,ug,ub,ub,ux,ux,ux,ux,ug
ux,ux,ux,ux,ux,ux,ux,ux,ub,ub,ub,ux,ux,ux,ub,ug,ug,ub,ux,ux,ux,ux,ug
ux,ux,ux,ux,ux,ux,ux,ux,ub,ux,ux,ux,ux,ux,ux,ug,ux,ux,ux,ux,ux,ux,ug
ub,ub,ub,ub,ub,ub,ub,ub,ub,ub,ub,ub,ub,ub,ub,ug,ug,ug,ug,ug,ug,ug,ug
ub,ux,ux,ux,ux,ux,ux,ux,ub,ux,ug,ug,ug,ug,ug,ug,ux,ux,ux,ux,ux,ux,cb
ub,ub,ub,ub,ub,ub,ub,ub,ub,cg,ux,ux,ux,ux,ux,ux,ux,ux,ux,ux,ux,ux,ux