ur,cb,cb,cr,ur,ur,ur,ur,ur,ur,ur,ur,ur,ur,ub,ub,ur,ub,ub,ub,ub,ur,cb
ur,ur,cb,ux,ur,ur,ur,ur,ur,ur,ur,ur,ur,ur,ub,ub,ub,ub,ur,ur,ub,ur,ux
ur,ur,ur,ur,cr,ur,ur,ur,ur,ur,ur,ur,ug,cb,ub,ug,ug,ug,ug,ug,cg,ur,ux
ur,ur,ur,ur,ur,ur,ur,cr,ub,ub,ug,ug,ug,ur,ux,ur,ur,ur,ur,ur,ur,ur,ux
ug,ug,ur,ur,ur,ur,ur,ur,ur,ur,ur,ur,ur,ur,ur,ur,ur,ur,ur,ur,ur,ur,ur
ur,ur,ur,ur,cr,ur,ur,ug,ur,ur,ug,ug,ug,ug,ug,ug,ug,ug,ug,ug,ur,ur,ur
ur,ur,ur,ur,ug,ur,ug,ug,ur,ur,ug,ug,cg,ur,ur,ur,ur,ur,ur,ug,ur,ur,ur
cb,ur,ur,ug,ug,ur,ur,ur,ur,ur,ur,ur,ur,ug,ug,ur,ur,ug,ug,ug,ur,ur,ur
ub,cr,cb,ug,ur,ur,ur,ur,ur,ur,ur,cr,ug,cg,ub,ub,ug,ux,ug,ug,ug,ug,ux
ub,ub,ub,ug,ur,ur,cr,ug,ux,ux,ug,ug,ug,ug,ub,cb,ub,ux,ug,ug,ug,ug,ux
ub,ub,ub,ub,ur,ub,ub,ug,ux,ux,ub,ug,ug,cg,ug,ug,ug,ug,ug,ug,ug,ug,ux
ux,ub,ub,ux,ur,ug,ug,ug,ux,ug,ug,ug,ux,ub,ug,ug,ux,ug,ug,ug,ug,ug,ux
cb,ub,cb,ux,ur,ug,ug,ug,ug,ub,ug,ug,ub,ug,ug,ug,ux,ug,ug,ug,ug,ug,ux
ub,ub,ub,ug,ur,ug,ug,ug,ug,ux,ub,ub,ub,ug,ug,ug,ug,ug,ug,ug,ug,ug,ux
ub,ub,ug,ug,ur,ug,ug,ug,ug,ug,ug,ug,ub,ug,ug,ug,ug,ug,ug,ug,ug,ug,ux
ux,ux,ug,ug,ur,ug,ug,ux,ux,ux,ux,ub,ug,ug,ug,ug,ug,ug,ug,ug,ux,ug,ux
ux,ux,ug,ug,ur,ug,ug,ug,ug,ux,ub,ug,ug,ug,ug,ug,ux,ux,ux,ug,ux,ug,ux
ur,ug,ug,ug,ur,ug,ug,ug,ug,ug,ug,ug,ug,ug,ug,ur,ur,ur,ur,ur,ur,ur,ur
ur,ug,ug,ug,ub,ub,ub,ug,ub,ux,ux,ux,ug,ug,ug,ug,ug,ux,ux,ug,ux,ug,ur
cr,ub,ub,ub,cb,ug,ug,ub,ub,ub,ub,ub,ub,cb,ug,ur,ug,ur,ur,ur,ur,ur,ur
cg,ub,ub,ub,ub,ub,cg,ug,ub,ub,ug,ux,ug,ug,ug,ug,ug,ux,ug,ug,ug,ug,cr
cr,ub,ub,ub,ub,ub,ub,ug,cg,ug,ug,ur,ug,ur,ux,ux,ux,ub,ub,cb,cb,ug,cr
cg,ur,cg,cb,ux,ug,ug,ug,ux,ux,ug,ug,ug,ur,ur,cg,ux,ux,ux,cg,cg,ug,cr