ur,ur,ur,ur,ur,cr,ub,ub,ub,ur,ur,ur,ur,ur,ur,ur,ur,ur,ur,ur,ur,ur,ur
ur,ur,ur,ur,ur,ur,ub,ur,ub,ub,ub,ub,ub,ub,cb,ur,ur,cb,ur,ur,ur,ur,ur
ur,ur,ur,ur,ur,ub,ub,ur,ur,ur,ur,ur,ur,ur,ur,ur,ur,ub,ur,ur,ur,ub,cr
ur,ur,ur,ur,ug,ug,cg,ur,ur,ur,ur,ur,ur,ur,ur,ur,ur,ub,ur,ur,ur,ub,ur
ur,ur,ur,ur,ug,ur,ur,ur,ur,ur,ur,ur,ur,ur,ur,ur,ur,ub,ur,ur,ur,ub,ub
ur,ur,ur,ur,ug,ur,ur,ur,ur,ur,ur,ur,ur,ur,ur,ug,ug,ub,ub,ub,ub,ub,ub
ur,ur,ur,ur,cr,ur,ur,ur,ur,ur,ur,ur,ur,ug,ug,ug,ug,ug,ug,ur,ur,ux,ub
ur,ur,ur,ur,ur,ur,ur,ub,ub,cr,ur,ur,cr,ug,ug,ug,ug,ug,ug,ug,ug,ux,ub
cg,ur,ur,ur,ur,ur,ur,ur,ub,cb,ug,ur,ur,ur,ur,ur,ug,ug,ug,ug,ug,ux,ub
ur,ur,ur,ur,ur,ur,ur,ur,ub,ug,ub,ub,ub,ub,ug,ux,ub,ub,cb,ug,ug,ux,ub
ur,ur,ur,ur,ur,ur,ur,ur,ur,ug,cb,ub,ub,ub,ug,ug,ub,ug,ug,ug,ub,ux,ub
ur,ur,ur,ur,ur,ur,ur,ur,ur,cg,ub,ub,ub,ub,ub,ub,ub,ug,ug,ug,ub,ux,ub
ur,ur,ur,ur,ur,ur,ur,ug,ur,ur,ub,ub,ub,ub,ub,ub,ug,ug,ug,ug,ub,ux,ub
ux,ux,ug,ux,ug,ux,ub,ug,ur,ur,ur,ub,ub,ub,ub,ux,ub,ub,ub,ux,ub,ux,ub
cg,ux,ug,ux,ug,ux,ub,ug,ub,ub,ub,ub,ub,ub,ub,ub,ub,ub,ub,ub,ub,ub,ub
ux,ux,ug,ux,ug,ux,ux,ug,ux,ux,ub,ux,ux,ux,cg,ug,ug,ug,ug,ug,ug,ux,ub
ux,ux,ug,ux,ug,ux,ux,ug,ux,ux,ub,ux,ux,ux,ug,ug,ug,ug,ug,ug,ug,ux,cb
ux,ux,ug,ux,ug,ux,ux,ug,ux,ux,ub,ux,ux,ux,ug,ug,ug,ub,ub,ug,ug,ux,ur
ux,ux,ug,ug,ug,ug,ug,ug,ux,ux,ub,ux,ux,ux,ux,ub,ug,ug,ux,ug,ug,ux,cr
ux,ux,ug,ug,ug,ux,ux,ux,ux,ux,ub,ux,ux,ux,ux,ux,ux,ug,ug,ug,ug,ux,ux
ub,ub,ug,ug,ug,ug,ug,ug,ug,ug,ub,ug,ug,ug,ug,ug,ug,ug,ug,ug,ug,ux,ux
ub,ux,ux,ux,ux,ux,ux,ux,ub,ub,ub,ub,ub,ub,ub,ub,ub,ub,ub,ub,ub,ur,ur
ub,ub,ub,ub,ub,ub,ub,ub,ub,cg,ub,ub,ub,ub,ub,ub,ub,ub,ub,ub,ub,ur,ur