ur,cb,cb,cr,ur,ur,ur,ur,ur,ur,ur,ur,ur,ur,ug,ur,ur,ur,ur,cr,ur,ux,cb
ur,ur,cb,ur,ur,ur,ur,ur,ur,ur,ur,ur,ur,ur,cr,ur,ub,ub,ub,ug,ur,ur,ux
ur,ur,ur,ur,ur,ur,ur,ur,ur,ur,ur,ur,ur,ur,ur,ur,cr,ug,ug,ug,ux,ux,ux
ur,ur,ur,ur,ur,ur,ur,ur,ur,ur,ur,ur,ur,cr,ur,ug,ug,ug,ug,ug,ux,ux,ux
ub,ur,ur,ur,ur,ur,ur,ur,ur,ur,cr,ur,ug,ur,ur,ug,ub,ub,ub,ug,ub,ux,ux
ub,ub,ur,ur,ur,ur,ur,ur,ur,ur,ug,ur,ur,ub,ur,ug,ub,ug,ug,cb,ux,ux,ux
ub,cb,ur,ur,ur,ur,ur,ub,cb,ug,cg,ur,ur,ur,ur,cg,ub,ug,ug,ub,ub,ux,ux
cb,ub,ur,ur,ur,ur,ub,ub,ub,ub,ub,ub,ub,ub,ux,ug,ug,ug,ug,ub,ub,ub,cb
ur,ub,ub,ur,ur,ur,ub,ub,ux,ub,ub,ub,ub,ub,ux,ug,ug,ug,ux,ub,ux,ux,ub
ub,ub,ub,ur,ur,ur,ux,ux,ux,ux,ug,ug,ug,ug,ug,ug,ug,ug,ug,ub,ub,ub,ub
ug,ug,ub,ug,ur,ux,ux,ux,ux,ux,ug,ug,ub,ug,ug,ug,ug,ug,ux,ub,ub,ub,ub
ug,ug,ug,ug,ug,ug,ug,ur,ur,ur,ub,ug,ub,ug,ug,ug,ub,ub,ub,ub,ub,ub,ub
cb,ub,ug,ug,ug,ug,ug,ub,ug,ug,ug,ug,ub,ub,ub,ub,ub,ub,ub,ur,ub,ub,cg
ur,ur,ug,ur,ug,ug,ug,cb,ub,ub,ug,ur,ub,ub,ub,ub,ub,ub,ur,ub,ub,ub,ub
ug,ug,ug,ug,ug,ug,ug,ug,ug,ub,ug,ug,ux,ux,ub,ux,ux,ux,ux,ub,ub,ub,ub
ug,ub,ug,ug,ub,ub,ub,ug,ug,ub,ub,ux,ux,ux,ub,ub,ub,ub,ub,ub,ub,ub,ub
ug,ub,ug,ug,ug,ug,ux,ug,ug,ub,ub,ux,ux,ux,ux,ux,ux,ux,ux,ub,ub,ub,ub
ug,ug,ug,ug,ug,ug,ug,ug,ug,ub,ub,ub,ub,ub,ub,ub,ub,ub,ux,ub,ug,ug,ug
ug,ug,ug,ug,ug,ug,ug,ug,ug,ub,ug,ug,ug,ug,ug,ug,ug,ug,ug,ug,ug,ux,ux
ug,ug,ug,cg,ug,ug,cg,ug,ub,ub,ur,ur,ur,ur,ur,ur,ur,ur,ur,ur,ur,cr,cb
cr,ug,ug,ug,ub,ug,ux,ug,ux,ux,cg,ux,ux,ux,ux,ux,ux,ux,ux,ux,ux,ux,cr
cg,ug,ug,ug,ug,ug,ux,ug,ug,ug,ug,ux,ux,ux,ux,ux,ux,ux,ux,cb,cb,ux,cr
cr,cg,cg,cb,ug,ug,ux,ux,ux,ux,ux,ux,ux,ux,ux,cg,ux,ux,ux,cg,cg,ux,cr