ur,ur,ur,ur,ur,ur,ur,ur,ur,ur,ur,ur,ur,ur,ur,ur,ur,ur,ur,ur,ur,ur,ur
ur,ur,ur,ur,ur,ur,ur,ur,ur,ur,ur,ur,ur,ur,ur,ur,ur,ur,ux,ux,ur,ur,ur
ur,ur,ur,ur,ur,ur,ur,cb,ub,ub,ur,ur,ur,ur,ur,ur,ur,ur,cr,ur,ur,ur,ur
ur,ur,ur,ur,ur,ur,ur,ur,ur,ub,cr,ur,ur,ug,ur,ur,ur,ur,ur,ur,ur,ur,ur
ur,ur,ur,cg,ug,ur,ur,ur,ur,ur,ur,ur,ur,ur,ur,ur,ur,ur,ur,ux,ur,ur,ur
ur,ur,ur,ur,ug,ug,ur,ur,ur,ur,ur,ur,ur,ur,ur,ur,ur,ur,ur,ux,ur,ur,ur
ur,ur,ur,ur,ub,ub,ur,ur,ur,ur,ur,ur,ur,ur,ur,ur,ur,ur,cr,ux,ur,ur,ur
ur,ur,ur,ub,ub,cr,ur,ur,ur,ur,ur,ur,ub,ub,ub,ub,ur,ur,ur,ur,ur,ur,ur
cg,ur,ur,cb,ur,ur,ur,ur,ur,ur,ur,ug,ug,ug,ub,ur,ub,ur,ur,ur,ur,ur,ug
ur,ur,ur,ur,ur,ur,cr,ux,ux,ux,ur,ub,ug,ug,ub,ur,ub,ub,ub,ug,ux,ux,ug
ur,ur,ur,ur,ur,ux,ux,ux,ux,ub,ur,ub,ug,ux,ub,ur,ug,ug,ug,ug,ux,ux,ug
ux,ux,ux,ux,ux,ux,ux,ub,ub,ub,ub,ug,ug,ug,ub,cg,ug,ug,ug,ug,ug,ux,ug
ux,ux,ux,ux,ux,ux,ub,ub,ub,ub,ub,ug,ug,ug,ug,ug,ux,ug,ug,ug,ug,ux,ug
ux,ux,ux,ux,ux,ux,ub,ub,ug,ug,ub,ug,ug,ux,ug,ug,ub,ug,ug,ux,ux,ux,ug
cg,ux,ux,ux,ux,ux,ub,ub,ug,ug,cb,ug,ug,ug,ug,ur,ub,ub,ub,ub,ub,ub,ub
ux,ux,ux,ux,ux,ux,ux,ug,ug,ug,ug,ub,ub,ub,ub,ub,ub,ub,ub,ub,ux,ub,ub
ux,ux,ux,ux,ux,ux,ux,ug,ug,ug,ug,ub,ux,cb,ub,ub,ub,ub,ub,ub,ux,ub,ub
ub,ub,ub,ub,ub,ub,ub,ub,ub,ub,ub,ub,ux,ux,ux,ub,ub,ub,ub,ux,ux,ub,ub
ub,ux,ux,ux,ub,ub,ub,ub,ub,ug,ub,ub,ux,ux,ux,ux,ub,ub,ux,ux,ux,ub,ub
cb,ub,ub,ub,ub,ux,ux,ux,ur,ug,cg,ub,ub,ub,ub,ub,ub,ub,ub,ub,ub,ub,ub
ux,ub,ux,ux,ux,ux,ux,ux,ur,ux,ug,ux,ux,ux,ux,ux,ux,ux,ux,ux,ux,ux,cb
ux,ub,ub,ub,ub,ub,ub,ux,ur,ux,ug,ub,ub,ub,ub,ub,ub,ux,ub,ub,ub,ux,ur
ux,ux,ux,ux,ub,ub,ub,ur,ur,cg,ug,ug,ug,ug,ug,ug,ug,ug,cr,ur,ur,ur,ur