ur,ur,ur,ur,ux,ux,ux,ux,ux,ux,ux,ux,ux,ux,ux,ur,ur,cb,ux,ux,ux,ux,ux
ur,ur,ur,ur,ux,ux,ux,ux,ux,ux,ux,ur,ur,ur,ur,ur,ur,ur,ux,ux,ux,ux,ux
ur,ur,ur,ur,ur,ur,ur,ur,ur,ur,ur,ur,ur,ur,ur,ur,ur,ur,ur,ur,ux,ux,ux
ur,ur,ur,ur,ur,ur,ur,ur,ur,ur,ur,ur,ur,ug,ug,ug,ug,ug,ug,ux,ux,ur,ur
cb,ur,ur,ur,ur,ur,ur,ur,ur,ur,ur,cg,ug,ug,ur,ur,ur,ux,ug,ur,ur,ur,ur
ur,ur,ur,ur,ur,cr,ur,ug,cg,ur,ur,ug,ug,ug,ug,ug,ug,ug,ug,ur,ur,ur,ur
ur,ur,ur,ur,ur,ur,ur,ug,ur,ur,ur,ug,ug,ug,ug,ug,ug,ug,ug,ur,ur,ur,ur
ur,ur,ur,ur,ur,ur,ur,ur,ur,cr,ur,ug,ug,ug,ug,ug,ug,ug,ug,ur,ur,ur,ur
ur,ur,ur,ur,ur,ur,cr,ur,ur,ur,ur,ug,ur,ur,ur,ur,ug,ug,ur,ur,ur,ur,ur
ur,ur,ur,ur,ur,ur,ur,ur,ur,ur,ug,ug,ug,ur,ub,ug,ug,ug,ur,ur,ux,ux,ux
ur,ur,ur,ur,ur,ur,cr,ur,ur,ux,ur,ub,ug,ub,ub,ur,ur,ug,ur,ux,ux,ux,ux
ub,ub,ub,ub,ug,ug,cr,ug,ug,ub,ur,ub,ub,ub,ub,ub,ub,cb,ub,ub,ug,ux,ux
ub,ux,ux,ux,ug,ux,ux,ux,ug,ub,ub,ub,ub,ux,ug,ug,ub,ub,ub,ub,ug,ux,cg
ub,ux,ux,ux,ug,ux,ux,ux,ug,ug,ug,ug,ug,ug,ug,ug,ug,ug,ug,ub,ug,ug,ug
ub,ux,ux,ux,ug,ux,ux,ux,ub,ux,ux,ux,ug,ux,ug,ub,cb,ub,ug,ub,ug,ug,ug
ub,ux,ux,ux,ug,ux,ux,ux,ub,ux,ux,ux,ug,ub,ub,cg,ug,ub,ub,ub,ux,ug,ug
ub,ub,ub,ub,ug,ug,ug,ug,ug,ub,ug,ug,ug,ug,ug,ug,ub,ub,ub,ub,ub,ub,ub
cg,ux,ux,ux,ux,ux,ux,ux,ub,ug,ug,ux,ub,ub,ub,ug,ug,ug,ug,ug,ug,ug,ub
ur,ur,ur,cg,ug,ug,ug,ug,ug,ug,ub,ub,ub,ub,ub,ub,ub,ub,ub,ub,ub,ub,cb
ur,ux,ux,ux,ug,ug,ug,ub,ub,ub,ug,ug,ug,ub,ub,ub,ug,ug,ug,ub,cr,ur,ur
ur,ur,ub,ub,ub,ub,ub,ub,ub,ub,ub,ub,ub,ub,ub,ug,ug,ur,ur,ur,ur,ur,ur
cr,ux,ub,ub,ub,ub,ub,ub,ub,ub,cb,ug,ug,ug,ug,ub,ux,ub,ux,ux,ux,cb,cr
cg,ux,ub,ub,ux,ub,ub,ub,ub,ux,ub,ub,ux,cb,ub,ub,ux,ux,ux,cg,cb,ux,cr