cb,ub,ur,cr,ur,ur,ur,ur,ur,ur,ur,ur,ur,ur,ur,ur,ur,ur,ur,ur,ur,ur,ur
ur,cr,ur,ur,ur,ur,ur,ur,ur,ur,ur,ur,ur,ur,ur,ur,ur,ur,ur,ur,ur,ur,ur
ur,ur,ur,ur,ur,ur,ur,ur,ur,ur,ur,ur,ur,ur,ur,ur,ur,ur,ur,ub,ur,ur,ur
ur,ur,ur,ur,ur,ur,ur,ur,ur,ur,ur,ur,ur,ur,ur,ur,ur,ur,ur,ux,ur,ur,cb
ur,ur,ur,ur,ur,ur,ur,ur,ur,ur,ur,ur,ur,ur,ur,ur,ur,ur,cr,ug,ur,ur,ur
ur,ur,ur,ur,ur,ur,ur,ur,ur,ur,cr,ug,cg,ur,ur,ur,ur,ur,ur,ug,ur,ux,ur
ur,ur,ur,ur,ur,ur,ur,ur,ur,cr,ub,ug,ur,ur,ur,cg,ur,ug,ug,ug,ur,ur,ur
ur,ur,ur,ur,ur,ur,ur,ur,ub,ur,ub,ug,ug,ug,ug,ug,ur,ur,ur,ur,ux,ux,ux
cg,ur,ur,ur,ur,ur,cb,ub,ub,ug,ug,ug,ub,ug,ug,ug,cg,ub,ub,ux,ux,ux,ux
ur,ur,ur,ur,ur,ur,ur,ug,ug,ug,ub,ub,ub,ug,ux,ux,ux,ug,ub,ux,ux,ux,ux
ur,ur,ur,ub,ux,ux,ub,ub,ub,ug,ub,ub,ub,ug,ub,ub,ub,ub,ub,ux,ux,ux,ux
ux,ub,ub,ub,ux,ub,ub,ub,ub,ug,ub,ub,ub,ug,ub,ux,ug,ub,ub,ux,ux,ux,ux
ux,ub,ub,ub,ub,ub,cb,ub,ub,ug,ug,ug,cb,ug,ug,ug,ug,ux,ux,ux,ux,ux,ux
ux,ub,ub,ub,ub,ub,ub,ub,ub,ug,ug,ub,ub,ub,ug,ux,ux,ux,ux,ux,ux,ux,ux
cg,ub,ub,ub,ux,ux,ux,ux,ub,ub,ug,ub,ub,ug,ug,ux,ux,ux,ux,ux,ux,ux,ux
ux,ub,ub,ub,ub,ux,ux,ub,ub,ub,ug,ur,ur,ur,ur,ur,ur,ur,ur,ur,ur,ur,ur
ux,ux,ux,ub,ub,ux,ux,ub,ub,ug,ug,ug,ug,ug,ug,ux,ux,ux,ux,ux,ux,ux,ur
ux,ux,ux,ub,ub,ux,ux,ux,ux,ug,ug,ug,ug,ux,ux,ux,ux,ux,ux,ux,ux,ux,ur
ux,ux,ux,ub,ub,ux,ux,ux,ux,ug,ug,ug,ug,ug,ux,ux,ux,ux,ux,ux,ux,ux,ur
ux,ux,ux,ub,ub,ux,ux,ux,ux,ug,ug,ux,ux,ux,ux,ux,ux,ux,ux,ux,ux,ux,ur
ux,ux,ux,ub,ub,ux,cr,ur,ur,ur,ur,ur,ur,ur,ur,ur,ur,ur,ur,ur,ur,ur,ur
ux,ux,ux,ub,ub,ux,ux,ux,cb,ug,ug,ug,ug,ug,ug,ug,ug,ug,ug,ug,ug,ug,cb
ux,ux,ux,ux,ub,ub,ub,ub,ub,cg,ug,ug,ug,ug,ug,ug,ug,ug,ug,ug,ug,ug,ur