ur,ur,cr,ub,ur,ur,ur,ur,ur,ur,ur,ur,ur,ur,ur,ur,ur,cb,ur,ur,ur,ur,ur
ur,ur,cr,cb,ur,ur,ur,ur,ur,ur,ur,ur,ur,ur,ur,ur,ur,ur,ur,ur,ur,ur,cr
ur,ur,ub,ub,ur,cr,ur,ur,ur,ur,ur,ur,ur,ur,ur,ur,ur,ur,ur,ur,cb,ub,ub
cg,ug,cb,ub,ur,ug,cg,ur,ur,ur,ur,ur,ur,ur,ur,ur,ur,ur,ur,ur,ur,ur,ur
cr,ur,ur,ur,ur,ur,ur,ur,ur,ur,ur,ur,ur,ur,ug,ug,ub,ug,ub,ug,ur,ub,ug
ub,ub,ub,ug,ug,ug,ug,ug,ub,ub,ub,ur,ur,ux,ub,ug,ub,ug,ug,ug,ux,ub,ug
ub,ub,ub,ug,ug,ux,ux,ux,ub,ub,ug,ug,ug,ug,ug,ug,ub,ub,ub,ub,ub,ub,ug
ub,ub,ux,ux,ux,ux,ux,ux,ux,ub,ub,ub,ub,ug,ug,ug,ug,ub,ug,ux,ub,ug,ug
ug,ug,ug,ug,ug,ug,ug,ug,ug,ug,ug,ug,ug,cg,ug,ub,ub,ub,ug,ur,ub,ug,ub
ug,ux,ux,ux,ux,ux,ux,ub,ug,ub,ub,ug,ub,ub,ug,ux,ux,ux,ug,ug,ug,ug,ur
cb,ub,ub,ub,ub,ub,ub,ub,ub,ub,ub,ug,ub,ub,ug,ug,ug,ug,ug,ug,ux,ux,ur
ug,ug,ug,ug,ug,ug,ug,ug,ug,ub,ub,ug,ub,ub,ub,ug,ug,ug,ug,ug,ur,ur,ur
ug,ug,ug,ug,ug,ug,ug,ug,ug,ug,ug,ug,ug,ug,ug,ug,ug,cg,ug,ug,ux,ur,ur
ux,ux,ux,ux,ux,ux,ux,ux,ux,ub,ub,ug,ug,ub,ub,ug,ug,ug,ug,ug,ux,ur,ur
ux,ux,ux,ux,ux,ux,ux,ux,ux,ux,ub,ug,ux,ub,ub,ug,ug,ug,ux,ux,ux,ur,ur
ux,ux,ux,ux,ux,ux,ux,ux,ux,ux,ub,ug,ux,ub,ub,ub,ug,ug,ux,ux,ux,ur,ur
ux,ux,ux,ux,ux,ux,ux,ux,ux,ux,ux,ug,ub,ub,ug,ub,ug,ug,ux,ux,ux,ur,ur
cg,ux,ux,ux,ux,ux,ux,ux,ux,ux,ux,ug,ux,ug,ug,ub,cb,ux,ux,ux,ux,ur,ur
ux,ux,ux,ux,ux,ux,ux,ux,ux,ux,ux,ug,ux,ux,ug,ub,ub,ux,ux,ux,ux,ur,ur
ur,ur,ur,ur,ur,ur,ur,ur,ur,ur,ur,ug,ur,ur,ur,ur,ur,ur,ur,ur,ur,ur,ur
ur,ur,ur,cr,ux,ux,ux,ug,ug,ug,ug,ug,ug,ug,ug,ux,ux,ux,ux,ux,ux,ux,ux
cr,ux,ux,ux,ux,ux,ux,ux,ux,ux,ux,cg,ux,ux,ux,ux,ux,ux,ux,ux,ux,cb,cr
cg,ux,ux,ux,ux,ux,ux,ux,ux,ux,ux,ux,ux,cb,ux,ux,ux,ux,ux,cg,cb,ux,cr