ur,ur,ur,ur,ur,ur,ur,ur,ur,ur,cr,ur,cr,ur,ug,cr,ur,ur,ur,ur,ur,ub,ub
ur,ur,ur,ur,ur,ur,ur,ur,ur,ur,ur,ur,ur,ur,ur,ur,ug,ug,ug,ug,ug,ug,ug
ur,ur,ur,ur,ur,ur,ur,ur,ur,ur,ur,ur,ur,ur,ur,ur,ur,ur,ur,ur,ur,ub,ug
ur,ur,ur,ur,ur,ur,ur,ur,ur,ur,ur,ur,ur,cr,ur,ur,ug,ug,ug,ub,ub,ub,ug
ur,ur,ur,ur,ur,ur,ur,ur,ur,ur,ur,ur,ur,ur,ug,ur,cr,ux,ug,ub,ux,ux,ug
ur,ur,ur,ur,ur,ur,ur,ur,ur,ur,ur,ur,ug,ug,ug,ux,ux,ux,ug,ub,ub,ub,ug
ur,ur,ur,ur,ur,ux,ug,ug,ur,ur,ux,ux,ux,ux,ux,ux,ux,ux,ub,ub,ub,ub,ug
ur,ur,ur,ur,ur,ug,cg,ug,ux,ub,ub,ub,ux,ux,ux,ug,ug,ug,ub,ub,ub,ux,ug
cg,ux,ur,ur,ux,ug,cb,ug,ub,ub,ub,ub,ug,ug,ug,ug,ug,ug,ub,ux,ub,ub,ug
ub,ub,ub,ub,ur,ur,ub,ug,ub,ug,ux,ub,ux,ux,ux,ux,ug,ug,ub,ux,ux,ux,ug
ub,ux,ux,ub,ux,ux,ub,ug,ub,ub,ub,ub,ub,ub,ub,ug,ug,ux,ub,ux,ux,ux,ug
ub,ux,ux,ub,ub,ux,ub,ub,ub,ub,ub,cb,ug,ug,ub,ug,ux,ux,ub,ux,cg,ug,cr
ub,ux,ux,ub,ub,ub,ub,ub,ub,ub,ub,ub,ub,ub,ub,ug,ug,ug,cb,ux,ux,ux,ur
ub,ux,ux,ub,ub,ub,ub,ux,ub,ub,ub,ub,ub,ub,ug,ug,ux,ux,ux,ux,ux,ux,ur
ub,ux,ux,ub,ux,ug,ug,ux,ux,ub,ub,ub,ub,ub,cb,ug,ub,ux,ux,ux,ux,ux,ur
ub,ux,ux,ub,ux,ug,ug,ug,ux,ub,ub,ug,ub,ub,ub,ug,ub,ux,ux,ux,ux,ux,ur
ub,ux,ux,ub,ux,ux,ub,ug,ug,ub,ub,ub,cb,ug,ub,ug,ub,ux,ux,ux,ux,ux,ur
ub,ux,ux,ub,ux,ux,ux,ug,ug,ug,ug,ub,ux,ug,ub,ub,ub,ux,ux,ux,ux,ux,ur
ub,ux,ux,ub,ux,cg,ug,ug,ug,ug,ug,ug,ug,ug,ub,ug,ux,ux,ux,ux,ux,ux,ur
ub,ux,ux,ub,ux,ux,ux,ux,ux,ux,ub,ub,ub,ub,ub,ub,ux,ux,ux,ux,ux,ux,ur
ub,ux,ux,ub,ux,ux,ux,ux,ux,ux,ub,ub,ub,ub,ub,ub,ux,ux,ux,ux,ux,ux,ur
ub,ux,ux,ub,ux,ux,ux,ux,ux,ux,ub,ub,ux,ux,ux,ux,ux,ux,ux,ux,ux,ux,ur
ub,ub,ub,ub,ub,ub,ub,ub,ub,cb,ur,ur,ur,ur,ur,ur,ur,ur,ur,ur,ur,ur,ur