ur,ur,ur,ur,ur,ux,ux,ur,ur,ur,cb,ub,ub,ub,ub,ub,ub,ub,ub,ub,ub,ub,ub
ur,ur,ur,ur,cb,ub,ub,ub,ub,cr,ur,ub,ub,ub,ub,ub,ub,ub,ub,ub,ub,ub,ub
ur,ur,ur,ur,ur,ur,cr,ub,ur,ur,cb,ub,ur,ur,ur,ur,ub,ub,ur,ur,ur,ur,ur
ur,ur,ur,ur,ur,ur,ur,cb,cg,ug,cr,ub,ur,ur,ur,ur,ub,ub,ur,ur,ur,ur,ur
ur,ur,ur,ur,ur,ur,ur,ur,ur,ur,ur,ub,ur,ur,ur,ur,ur,ur,ur,ur,ur,ur,ur
ux,ux,ux,ur,ur,ur,ur,ur,ur,ur,ur,cr,ur,ur,ur,ub,ub,ub,ub,ur,ur,ur,ur
ux,ur,ur,ur,ur,ur,ur,ur,ur,ug,ug,ug,ux,ub,ub,ub,ub,ur,ub,ub,ur,ur,ur
ux,ur,ur,ur,ur,ur,ur,ur,ur,cr,ur,ur,ur,ur,ur,ur,ur,ur,ur,ur,ur,ur,ur
cg,ur,ur,ur,ug,ux,ug,ux,ug,ug,ub,ug,ub,ub,ub,ux,ux,ux,ub,ub,ub,ub,ur
ur,ur,cr,ux,ug,ux,ug,ux,ug,ug,ug,ug,ug,ug,ug,ux,ux,ub,ub,ub,ub,ub,ur
ur,ur,ur,ur,ug,ug,ug,ur,ur,ub,ub,ug,ub,ur,ug,ur,ub,ub,ub,ub,ub,ub,ur
ux,ux,ux,ur,ux,ux,ux,ux,ub,ux,ub,ug,ub,ub,ub,ub,ug,ug,ub,ub,ub,ub,ur
ux,ux,ux,ur,ux,ux,ub,ub,ub,ub,ub,ub,ub,cb,ub,ub,ug,ux,ux,ub,ub,ub,ur
ux,ux,ux,ur,ux,ub,ub,ub,ug,ug,ub,ub,cb,ur,ub,ub,ug,ug,ug,ug,ug,ub,ur
cg,ux,ux,ur,ux,ux,ub,ub,ug,ub,ub,ub,ub,ub,ug,ug,ug,ug,ug,ur,ug,ub,ur
ux,ux,ux,ur,ux,ub,ub,ug,ug,ug,ug,ub,ub,ub,ub,ub,ub,ub,ug,ug,ug,ug,ur
ux,ux,ux,ur,ux,ux,ub,ug,ug,cg,ug,ub,ub,ug,ug,ug,ug,ug,ug,ug,ub,ug,ur
ux,ux,ux,ur,ux,ux,ub,ug,ug,ug,ug,ub,ub,ub,ug,ug,ug,ug,ug,ug,ux,ug,cg
ux,ux,ux,ur,ux,ux,ux,ug,ug,ug,ug,ub,ub,ub,ux,ux,ug,ug,ux,ug,ux,ux,ug
ux,ux,ux,ur,ux,ux,ux,ug,ug,ux,ux,ux,ub,ub,ux,ux,ug,ug,ux,ug,ux,ux,ug
ux,ux,ux,ur,ux,ux,ux,ug,ug,ux,ux,ux,ux,ux,ux,ux,ux,ux,ux,ug,ub,ux,ug
ux,ux,ux,ur,ux,ux,ux,ux,ur,ux,ux,ux,ux,ux,ux,ux,ux,ux,ux,ug,ub,ub,ug
ux,ux,ux,ur,ur,ur,ur,ur,ur,ug,ux,ux,ux,ux,ux,ux,ux,ux,ux,ug,ug,ug,ug