ux,ur,ur,ur,ur,ur,ur,ur,ur,ur,ur,ur,ur,ur,ur,ur,ur,ur,ur,ur,ur,ur,ur
ux,ug,ug,ug,ug,ur,ur,ur,ur,ur,ur,ur,ur,ur,ur,ur,ur,ur,ur,ur,ur,ur,ur
ux,ug,ug,ug,ug,ur,ur,ur,ur,ur,ur,ur,ur,ur,ur,ur,ur,ur,ur,ur,ur,ur,ur
ux,ux,ur,ug,ug,ug,ug,ug,ug,ug,ug,ug,ug,ur,ur,ur,ur,ur,ur,ur,ur,ur,ur
ux,ux,ur,ug,ug,ug,ug,ug,ug,ug,ug,ug,ug,ur,ur,ur,ur,ur,ur,ur,ux,ur,cr
ur,ur,ur,ur,ur,cg,ur,ur,ur,ur,ur,ur,ur,ur,ur,ur,ur,ur,ur,ur,ux,ur,ux
ur,ur,ur,ur,ur,ur,ur,ur,ur,ur,ur,ur,ur,ug,ug,cg,ur,ur,ur,ur,ur,ur,ux
ur,ur,ur,ur,ur,ur,ur,ur,ur,ur,ur,ur,ur,ug,ur,ur,ur,ur,ur,ur,ur,ur,ur
ur,ur,ur,ur,ur,ur,ur,ur,ur,ux,ur,ur,ug,ug,ur,ur,ur,ur,ur,ux,ux,cb,ub
ur,ur,ur,ur,ur,ur,ur,cr,ur,ur,ur,ur,ug,ur,ur,ur,ur,ur,ur,ur,ur,ub,ub
ur,ur,ur,ur,ur,ur,ur,ur,ur,ur,ur,ur,ug,ug,ug,ub,ur,ur,ur,ur,ur,cr,ub
ur,ur,ur,ur,ur,ur,cr,ur,ur,ur,ur,ur,ug,cb,cg,ub,ur,ur,ug,ub,ux,ug,ub
ur,ur,ur,ur,ur,ur,ug,ug,ug,ug,ug,ug,ug,ug,ub,ub,ur,ur,ug,ub,ux,ug,ub
ub,ub,ub,ub,ub,ub,ug,ug,ug,ug,ug,ug,ug,ub,ub,ur,ur,ur,ug,ur,ux,ug,ub
ub,ux,ux,ux,ux,ux,ux,ux,ux,ux,ug,ub,ub,ub,ub,ur,ur,ur,ug,ux,ux,ug,ub
ub,ux,ux,ux,ux,ux,ux,ux,ux,ux,ug,ub,ub,ub,cr,ur,ur,ur,ug,ub,ub,ub,ub
ub,ux,ux,ux,ux,cb,ux,ux,ux,ux,ug,ug,ug,ub,ur,ux,ur,ur,ug,ux,ux,ug,ub
ub,ux,ux,ux,ux,ub,ub,ub,ub,ub,ub,ub,ub,ub,ur,ux,ux,ux,ug,ux,ux,ug,ub
ub,ux,ux,ux,ux,ux,ux,ux,ux,ux,ux,ux,ur,ur,ur,ux,ux,ux,cg,ux,ux,ug,cb
ub,ux,ux,ux,ux,ux,ux,ux,ux,ux,ux,ux,ur,ur,ur,ur,ux,ux,ub,ub,ux,ug,ur
ub,ux,ux,ux,ux,ux,ux,ux,ux,ux,ux,ux,ur,ur,ur,ur,ur,ux,ug,ub,ub,ub,cr
ub,ux,ub,ub,ub,ub,ub,ux,ux,ux,ux,ux,ur,ur,ur,ur,ur,ug,ug,ux,ux,ux,ux
ub,ux,ux,cb,ub,ub,ub,ux,ux,ux,ux,ux,ur,ur,ur,ur,ur,ux,ux,ux,ux,cb,ux