ur,cb,cb,cr,ur,ur,ur,ur,cb,ur,ur,ur,ub,cb,ur,ur,ur,ur,ur,ur,ur,ur,cb
ur,cb,cb,ur,ur,ur,ur,ur,ub,cr,ur,ur,ub,ur,ur,ur,ur,ur,cg,ug,ug,ur,ux
ur,ur,ur,ur,ur,ur,ur,ur,ur,ur,ur,ur,ub,ur,ur,ur,ur,ur,ur,ur,ug,ub,ub
ur,ur,ur,ur,ur,cr,ur,ur,cr,ur,cg,ur,ub,ur,ug,ur,ur,ur,ur,ur,ug,ub,ub
ur,ur,ur,ur,ur,cr,ug,ug,ug,ug,ug,ub,ub,ug,ug,ur,cr,ur,ur,ur,ug,ur,ur
ur,ur,ur,ur,ur,ub,ub,ub,ug,ug,ug,ur,ug,ug,ub,ur,ug,ub,ub,ur,ug,ur,ur
ur,ur,ur,ur,ur,ug,ug,ug,ub,ub,ub,ub,cg,ub,ub,ub,ub,ub,ur,ur,ur,ur,ur
cb,ux,ux,ug,ug,ug,ug,ug,ub,ug,ug,ub,ug,ug,ub,ub,ub,ur,ub,cr,ug,ur,ur
ux,ux,ux,ug,ug,ug,ug,ug,ub,ug,ug,ub,ub,ub,cb,ug,ub,ur,ub,ub,ug,ur,ur
ux,ux,ux,ug,ug,ug,ug,ug,ub,ub,ub,ub,ub,ub,ub,ug,ub,ur,ub,ub,ug,ur,ux
ux,ux,ux,ug,ug,ug,ug,ug,ug,ug,ub,ub,ub,ub,ub,cg,ur,ur,ub,ub,ug,ur,ux
ux,ug,ug,ug,ug,ug,ug,ug,ug,ug,ub,ub,ub,ub,ub,ug,ur,ur,ug,ug,ug,ur,ux
cb,ug,ug,cg,ug,ug,ug,ug,ug,ug,ub,ub,ub,ub,ug,ug,ur,ur,ux,ug,ug,ur,cg
ug,ug,ug,ux,ug,ug,ug,ug,ug,ug,ug,ux,ub,ub,ug,ug,ug,ur,ug,ug,ug,ur,ux
ug,ug,ug,ux,ug,ug,ug,ug,ug,ug,ug,ug,ug,ub,ug,ug,ug,ur,ux,ux,ug,ur,ux
ug,ug,ux,ux,ug,ug,ug,ug,ug,ug,ug,ug,ug,cb,ug,ug,ug,ur,ux,ug,ug,ur,ux
ug,ug,ux,ux,ug,ug,ug,ug,ug,ug,ug,ux,ux,ux,ug,ur,ur,ur,ux,ug,ux,ur,cb
ug,ux,ux,ux,ug,ug,ug,ug,ug,ug,ug,ug,ux,ug,ug,ug,ug,ur,ux,ug,ux,ur,ux
ug,ux,ux,ux,ug,ug,ug,ug,ug,ug,ux,ug,ub,ug,ub,ug,ug,ug,ug,ug,ux,ur,ux
ug,ug,ux,ux,ug,ug,ug,ug,ug,ux,ug,ug,ug,ug,ux,ug,ug,ur,ux,ux,ux,ur,ux
cr,ug,ux,ux,ux,ux,ux,ux,ug,ug,ug,ug,ub,ug,ug,ug,ug,ur,ur,ur,ur,ur,cr
cg,ug,ug,ug,ug,ug,ug,ug,ug,ug,ub,ub,ub,ug,ug,ug,ug,ur,ur,cb,cb,ur,cr
cr,cg,cg,cb,ux,ux,ux,ux,ux,ug,ug,ug,ug,ug,ux,cg,ur,ur,ur,cg,cg,ur,cr