ux,ux,ux,ux,ur,ur,ur,ur,ur,cg,ur,ur,ur,ub,ub,ub,ub,cb,ux,ux,ux,ub,ub
ur,ur,ur,ur,cr,ur,ur,ur,ub,ub,ur,ur,ur,ub,ub,ub,ub,ug,ug,ug,ub,ub,ub
ur,ur,cr,ur,ug,ug,cb,ub,cg,ub,ur,cr,ug,ug,ug,ug,ug,ux,ux,ug,ug,ug,ug
ur,ur,ug,ur,ur,ur,ub,ub,ug,ub,ug,ug,ug,ug,ub,ug,ug,ux,ux,ug,ux,ux,ug
ur,ur,ur,ur,ur,ur,ub,ub,ug,ub,ug,ug,ug,ug,ug,ux,ug,ux,ux,ug,ux,ux,ug
ur,ur,ur,ur,ur,ur,ur,ur,ug,ug,ug,ug,ug,ub,ug,ug,cg,ub,ub,ug,cb,ux,ug
ur,ur,ur,ur,ur,cr,ur,ub,ub,ug,ub,ux,ug,ug,ug,ug,ub,ux,ux,ug,ub,ub,ub
ur,ur,ur,ug,ub,ug,ur,ur,ub,ub,ub,ug,ug,ub,ub,ub,ub,ux,ux,ug,ux,ux,ub
ur,ur,ur,cr,ub,ub,ub,ub,ub,ug,ub,ug,ug,ug,cb,ub,ub,ux,ux,ug,ux,ux,ub
ur,ur,ub,ub,ug,ug,ub,ub,ub,ub,ub,ub,cg,ub,ub,ug,ug,ux,ux,ug,ux,ux,ub
ur,ur,ux,ux,ug,ug,ub,ub,ub,ub,ub,ub,ub,ub,cb,cb,ug,ux,ux,ug,ux,ux,ub
ub,ub,ux,ux,ug,ug,ub,ub,ub,ub,ub,ub,ub,ub,ub,ub,ux,ux,ux,ug,ub,ub,ub
ub,ub,ux,ux,ug,ub,ub,ub,ub,ub,ux,ug,ub,ub,ub,ub,ug,ug,ug,ug,ub,ub,ug
ub,ub,ug,ug,ug,ub,ub,cg,ub,ub,ub,ug,ub,ub,ub,ub,ux,ux,ux,ux,ub,ub,ug
ub,ux,ux,ux,ug,ub,ub,ug,ug,ug,ub,ub,ug,ug,ug,ug,ux,ux,ux,ux,ub,ub,ug
ub,ux,ux,ux,ub,ub,ub,ub,ux,ug,ub,ub,ub,ux,ug,ux,ux,ux,ux,ux,ub,ub,ug
ub,ub,ub,ub,ub,ug,ug,ug,ux,ug,ug,ub,ub,ug,ug,ux,ux,ux,ux,ux,ub,ub,ug
ug,ux,ux,ux,ux,cr,ur,ur,ur,ur,ur,ur,cb,ur,ur,ur,ur,ur,ur,ur,ur,ur,ug
ux,ux,ux,ux,ux,ux,ug,ug,ub,ux,ug,ub,ub,ux,ug,ux,ux,ux,ux,ux,ur,ur,ug
ux,ux,ux,ux,ux,ub,ub,ub,ub,ub,ug,ub,ug,ug,ug,ux,ux,ux,ux,ux,ur,ur,ug
ux,ux,ux,ux,ub,ub,ub,ub,ux,ub,ux,ub,ub,cg,ug,ug,ug,ug,ug,ug,ug,ug,ug
cr,ux,ux,ux,ub,ub,ub,ub,ux,ub,ub,ub,ub,ub,ub,ur,ur,ur,ur,ur,ur,ur,cb
cg,ux,ux,ux,ub,ub,ub,ub,ux,ux,ub,ub,ub,ub,ub,ur,ur,ur,ur,ur,ur,ur,ur