cr,ur,ur,ur,ur,ur,ur,ur,ur,ur,ur,ur,ur,ur,ur,ur,ur,ur,ur,ur,ur,ur,ur
ub,cb,ur,ur,ur,ur,ur,ur,ur,ur,ur,ur,ur,ur,ur,ur,ur,ur,ur,ur,ur,ur,ur
ur,ur,ur,ur,ur,ur,ur,ur,ur,ur,ur,ur,ur,ur,ur,ur,ur,ur,ux,ur,ur,ur,ur
ur,ur,ux,ur,ur,ur,ur,ur,ur,ur,ur,ur,ur,ur,ug,cg,ur,ur,ux,ur,ur,ur,ur
cb,ur,ur,ur,ur,ur,ur,ur,ur,cb,ur,ur,ur,ur,ug,ur,ur,ur,ug,ug,ur,ur,ur
ur,ur,ur,ur,ur,ur,ur,ur,ur,ub,ur,ur,ur,ur,cr,ur,ur,ur,ur,ug,ug,ur,ur
ur,ur,ur,ub,ub,cg,ug,ur,cr,ub,ur,ur,ur,ug,ug,ub,ub,ur,ur,ur,ug,ur,ur
ur,ur,ur,ur,ur,ub,ug,ur,ur,ug,cr,ur,ur,ug,ub,ub,ub,ur,ur,ur,ug,ur,ur
cg,ur,ur,ur,ub,ub,ug,ug,ur,ub,ug,ug,ug,ug,ub,ub,ub,cr,ur,ur,cg,ur,ur
ur,ur,ur,ur,ub,ub,ub,ub,ub,ub,cb,ug,ug,ug,ug,ub,ub,ur,ur,ur,ur,ur,ur
ur,ur,ur,ur,ur,ur,ur,ub,ur,ub,ub,ug,ub,ub,ub,cb,ug,ur,ur,ur,ur,ur,ub
ur,ur,ur,ur,ur,ur,ur,ub,ub,ub,cb,ur,cr,ub,ub,ug,ug,ub,ug,ux,ux,ug,ub
ur,ur,ur,ur,ur,ug,ux,ux,ub,ub,ub,ub,ub,ub,ub,ug,ug,ug,ug,ux,ux,ug,ub
ux,ux,ug,ux,ux,ug,ux,ux,ub,ub,ub,ub,ug,ug,ug,ub,ub,ug,ux,ux,ux,ug,ub
cg,ux,ug,ux,ux,ug,ux,ux,ub,ub,ub,ub,ug,ug,ug,ug,ug,ug,ux,ux,ux,ug,ub
ux,ux,ug,ux,ux,ug,ux,ux,ub,ux,ub,ub,ug,ug,ug,ug,ug,ug,ux,ux,ux,ug,ub
ux,ux,ug,ux,ux,ug,ux,ux,ub,ux,ux,ux,ux,ux,ux,ux,ux,ux,ux,ux,ux,ug,ub
ux,ug,ug,ux,ux,ug,ux,ux,ub,ux,ux,ux,ux,ux,ux,ux,ux,ux,ux,ux,ux,ug,ub
ux,ug,ux,ux,ux,ug,ux,ux,ub,ux,ux,ux,ux,ux,ux,ux,ux,ux,ux,ux,ux,ug,ub
ux,ug,ux,ug,ux,ug,ux,ux,ub,ux,ux,ux,ux,ux,ux,ux,ux,ux,ux,ux,ux,ug,ub
ub,ub,ub,ub,ub,ub,ub,ub,ub,ub,ub,ub,ub,ub,ub,ub,ub,ub,ub,ub,ub,ug,ub
ub,ug,ux,ug,ug,ug,ug,ug,ub,ug,ug,ug,ug,ug,ug,ug,ug,ug,ug,ug,ug,ug,cb
ub,ub,ub,ub,ub,ub,ub,ub,ub,cg,ux,ux,ux,ux,ux,ux,ux,ux,ux,ux,ux,ux,ux