cr,cr,ur,ub,ur,ur,ur,ur,ur,ur,ur,ub,ub,ub,cr,ur,ur,cb,ur,ur,ur,ub,ub
ub,ur,ur,ub,ur,ur,ur,ur,ur,ur,ur,ub,ur,ur,ur,ur,ur,ur,ur,ur,ub,ub,ub
ub,ub,ub,ur,ur,ur,cg,ug,ug,ur,ur,ub,cb,ur,ur,ur,ur,ur,ur,ur,ub,ur,ub
ur,ur,ub,cb,cr,ur,ur,ur,cr,ur,ur,ur,ur,ur,ur,ur,ug,ub,ub,ur,ub,ub,ub
ub,ub,ur,ur,ur,ur,ur,ur,ur,ur,ur,ur,ur,ur,ur,ug,ug,ub,ub,ur,ur,ub,ur
ur,ub,ur,ur,ux,ur,ur,ur,ur,ur,ur,ur,ur,ug,ub,ub,ug,ub,ub,ur,ur,ub,ub
ur,ub,ub,ub,ub,ug,ug,ur,cb,ur,ur,cg,ux,ug,ub,ub,ux,ub,ub,ub,ub,ub,ub
ur,ub,ub,ub,ub,ug,ur,ub,ub,ug,ug,ug,ug,ug,ux,ub,ub,ub,ub,ub,ux,ux,ux
ur,ur,ur,ur,ub,ur,ub,ub,ub,ub,ub,ug,ug,ug,ug,ug,ux,ug,ux,ux,ux,ux,ux
ux,ux,ux,ub,ub,ub,ub,ub,ub,ux,ug,ub,ug,ug,cb,ug,ux,ug,ux,ux,ux,ux,ux
ux,ux,ug,ug,ug,ug,ug,ug,ub,ux,ug,ug,ub,ub,ub,ub,ub,ub,ub,ux,ux,ux,ux
ux,ux,ug,ux,ux,ux,ux,ug,ux,ux,ub,ub,ub,ub,ub,ub,ub,ug,ux,ux,ux,ux,ux
ux,ux,ug,ux,ux,ux,ux,ug,ux,ux,ux,ub,ug,ub,ub,ub,ug,ug,ux,ux,ux,ux,cg
ur,ur,ug,ug,ug,ug,ug,ug,ug,ug,ug,ub,ug,ug,ug,ug,ug,ug,ur,ur,ur,ur,ur
ur,ux,ux,ux,ux,ux,ux,ug,ub,ug,ug,ug,ub,ub,ug,ub,ux,ux,ug,ux,ux,ur,ur
ur,ux,ux,ux,ux,ux,ux,ug,ub,ug,ug,ug,ug,cg,ug,ub,ux,ub,ug,ug,ux,ur,ur
ur,ur,ur,ur,ug,ug,ug,ug,ug,ur,ur,ug,ug,ug,ug,ug,ug,ug,ug,ug,ug,ug,ug
cg,ur,ur,ur,ur,ur,ur,ur,ur,ur,ug,ug,ug,ur,ur,ur,ur,ur,ur,ur,ur,ur,ug
ux,ur,ub,ug,ug,ug,ug,ug,ug,ug,ug,ub,ug,ux,ux,ub,ug,ug,ug,ug,ur,cg,ug
cb,ur,ub,ug,ug,ug,ug,ux,ux,ug,ug,ux,ug,ux,ux,ux,ux,ux,ux,ux,ux,ur,ur
ub,ub,ub,ub,ux,ux,ug,ux,ux,ux,ux,ug,ug,ug,ug,ug,ux,ux,ux,ux,ux,ur,ur
cr,ur,ub,ub,ux,ux,ug,ux,ux,ux,ux,ug,ug,ug,ug,ug,ug,ug,ux,ux,ux,cb,cr
cg,ur,ur,cr,ux,ux,ug,ug,ug,ug,ug,ug,ug,cb,ug,ug,ug,ug,ux,cg,cb,ux,cr