ub,cb,cb,ux,ux,ux,ur,ur,ur,ur,ur,ur,ur,ur,ur,ur,ur,ur,ur,cg,ur,cb,ur
cr,ur,ux,ux,ux,ux,ur,ur,ur,ur,ur,ur,ur,ur,ur,ur,ur,ur,ur,ur,ur,ub,ur
ur,ur,ux,ux,ux,ux,ur,ur,ur,ux,ur,ur,ur,ur,ur,ur,ur,ur,ur,ur,ur,cr,ur
ur,ur,ux,ux,ux,ux,ux,ur,ux,ux,ur,ur,ur,ur,ur,ur,ur,ur,ur,ur,ur,ur,ur
ur,ur,cr,ug,ux,ux,ux,ur,ur,ux,ur,ur,ur,ur,cr,ur,ur,ur,ur,ur,ur,ur,ur
ug,ug,ur,ug,ug,ug,ur,ux,ur,ur,ur,ur,ur,ur,ub,cb,ur,ur,ur,ur,ur,ur,ur
ug,cg,ux,ux,ux,ug,ug,ur,ur,ur,ur,ur,ug,cr,ub,ub,ur,ur,ur,ur,ur,ur,ur
ur,ur,ux,ux,ur,ur,ug,ug,ug,ug,ug,ug,ug,ug,cg,ub,ur,ur,ur,ur,ur,ur,ur
ur,ur,ur,ur,ug,ug,ur,ug,ug,ug,ug,ug,cg,ug,ub,ub,ur,ug,ur,ur,ug,ug,ux
ur,ux,ux,ux,ug,ur,ur,ug,ug,ub,ur,ur,ur,ur,ur,ur,ub,ux,ux,ux,ug,ug,ux
ur,ux,ux,ux,ug,ub,ur,ug,ug,ug,ug,ur,ur,ur,ur,ur,ur,ur,ur,ur,ur,ur,ur
ux,ux,ux,ux,ux,ub,ub,ub,ub,ub,ug,ub,ug,ub,ug,ug,ug,ug,ux,ug,ug,ug,cr
cg,ux,ux,ux,ux,ub,ub,ub,cb,ub,ug,ub,ug,ub,ux,ug,ug,ux,ux,ug,ug,ug,ux
ux,ux,ug,ug,ug,ug,ug,ux,ug,ub,ug,ug,ug,ug,ug,ug,ug,ug,ux,ug,ug,ux,ux
ux,ug,ub,ub,ug,ug,ub,ub,ug,ug,ug,ug,ug,ug,ug,ug,ug,ux,ux,ug,ug,ux,ux
ux,ug,ub,ub,ub,ub,ub,ub,ug,ug,ug,ug,ug,ug,ug,ug,ug,ug,ug,ug,ug,ux,ux
ux,ug,ub,ub,ub,ub,ub,ub,ug,ug,ug,ub,ug,ub,ug,ug,ug,ug,ug,ux,ug,ux,ux
cg,ug,ub,ub,ub,ub,cb,ub,ug,ug,ug,ug,ug,ub,ub,ub,ug,ux,ux,ux,ug,ux,ux
ux,ug,ug,ub,ug,ug,ub,ub,ug,ug,cg,ub,ub,ub,cb,ug,ug,ux,ug,ug,ug,ux,ux
ux,ux,ug,ub,ug,ug,ug,ub,ub,ug,ur,ub,ug,ug,ub,ub,ug,ux,ug,ug,ug,ux,ux
cr,ux,ug,ux,ug,ug,ug,ug,ug,ug,ur,ub,ub,ug,ug,ub,ug,ug,ug,ux,ur,ux,ux
cg,ur,ur,ur,ur,ur,ur,ur,ug,ug,ur,ub,ub,ub,ub,ub,ur,ur,ur,ur,ur,cb,cr
cr,ur,ur,ur,ur,ur,ur,ur,ur,ur,ur,ub,ub,ub,ux,ux,ux,ux,ux,ux,cb,ux,cr