ur,ur,ur,ur,ur,ur,ur,ur,ur,ur,ur,ur,ur,ur,ux,ux,ur,ur,ux,ub,ub,ur,ur
cr,ur,ur,ur,ur,ur,ur,ur,ur,ur,ur,ur,ur,ur,ur,ur,ur,cr,ub,ub,ub,ur,ur
ub,ur,ur,ur,ur,cb,ub,cr,ur,ur,ur,ur,ur,ur,ur,ur,ux,ur,ub,ub,ub,ur,ur
ub,ur,ug,ug,cr,cr,ur,ur,ur,ur,ur,ux,ug,ux,ur,ur,ur,ur,ub,ub,ub,ur,ur
ub,ub,cb,ug,ug,ur,ur,ur,ur,ur,ug,ur,ug,ur,ur,ur,ur,ur,ub,ur,ur,ur,ur
ur,ur,ur,ug,ug,ug,ur,ur,ur,ur,ug,ur,ug,ur,ur,ur,ub,ub,ub,cb,ur,ur,ur
ur,ur,ur,ug,ur,ug,ur,ur,ux,ur,ug,ur,ug,ur,ur,ur,ur,ur,cr,ur,ur,ur,ur
ur,ur,ur,ug,ur,ug,ur,ur,ux,ug,ug,ur,ug,ug,ug,ug,ug,ug,ug,ug,ug,cg,ur
ur,ub,ur,ur,ux,ug,ur,ur,ur,ug,ug,ur,ub,ub,ur,ug,ub,ug,ux,ux,ux,ux,ur
ur,ub,ur,ux,ub,cg,ug,ug,ug,ug,ug,ur,ub,ub,cb,ug,ug,ug,ux,ux,ux,ux,ur
ur,ub,ur,ur,ux,ug,cb,ub,ub,ub,ub,ub,ug,ub,ug,ug,ug,ug,ux,ux,ux,ux,ur
ur,ur,ur,ur,ur,ug,ub,ub,ub,ug,ug,ub,ug,ug,ug,ux,ug,ub,ux,ux,ux,ux,ur
ub,ub,ub,ur,ur,ug,ub,ug,ug,ug,ug,ug,ug,ub,ug,ug,ug,ub,ub,ux,ux,ux,ur
ub,ub,ub,ux,ux,ux,ub,ub,ub,ux,ub,ub,ub,ub,ug,ub,ux,ux,ux,ux,ux,ux,ur
ub,ug,ub,ux,ux,ux,ug,ug,ub,ub,ub,ux,ub,ub,ug,ug,ug,ug,ub,ux,ux,ux,ur
ub,ug,ub,ux,ux,ux,ug,ug,ux,ux,ux,ux,ux,ub,cg,ug,ug,ug,ub,ux,ux,ux,ur
ux,ug,ux,ux,ux,ux,ug,ug,ux,ux,ux,ux,ux,ub,ub,ub,ub,ub,ub,ux,ux,ux,ur
ux,ug,ux,ux,ux,ux,ug,ug,ux,ux,ux,ux,ux,ux,ux,ub,ub,ub,ux,ux,ux,ux,ur
ur,ug,ur,ur,ur,ur,ur,ug,ur,ur,ug,ug,ur,ug,ug,ub,ug,ug,ux,ux,ux,ux,ur
ur,ug,ug,ug,ug,ug,ug,ug,ug,ur,ur,ur,ur,ur,ur,ur,ur,ur,ur,ux,ux,ux,ur
ur,ur,ux,ux,ux,ux,ug,ug,ux,ur,ur,ug,ux,ug,ug,ug,ux,ux,ur,ug,ux,ux,ur
ur,ur,ur,ur,ur,ur,ur,ug,ur,ur,ur,ug,ug,ug,ug,ug,ug,ug,ur,ur,ur,ur,ur
ur,ur,ur,ur,ur,ur,ur,cg,ur,ur,ur,ug,ug,ug,ug,ux,ux,ux,ux,ux,ux,cb,ur