ub,ub,ur,ur,ur,ux,ux,ur,ur,ur,ur,ur,cr,ur,ur,ur,ur,ur,ur,ur,ur,ur,cb
ub,ub,ub,ub,ub,ub,ub,ub,ub,ub,ub,ub,ub,ur,ur,ur,ur,ur,ur,ur,ur,ur,ur
ub,ub,cb,ur,ur,ur,ur,ur,ur,ur,ur,ur,ur,ur,ur,ur,ur,ur,ur,ur,ur,ur,ur
ur,ur,ur,ur,ur,ur,ur,ur,ur,ur,ur,ur,ur,ur,ur,ur,ur,ur,ur,ur,ur,ur,ur
ur,ur,ur,ur,ur,ug,ug,ug,ug,ug,ug,ug,ur,ur,ur,ur,ur,ur,ur,ur,ur,ur,ub
ur,ur,ur,ur,ur,ug,ur,ur,ur,ur,ur,ug,ug,cr,ug,ug,cg,ur,ur,ur,ur,ur,cr
ur,ur,ur,ur,ur,ur,ur,ur,ur,ur,ur,ur,ur,ur,ur,ur,ur,ur,ur,ur,ur,ug,ux
ur,ur,cr,ur,ur,ur,ur,ur,ug,ug,ur,ur,ur,ur,ur,ur,ug,ug,ug,ub,ug,ug,ux
cg,ur,ug,ug,ur,ur,ur,ur,ur,ur,ur,ur,ug,ug,ug,ug,ug,ub,ub,ug,ug,ug,ux
ur,ur,ur,ug,ur,ur,ur,ur,ur,ur,ur,ug,ug,ug,ug,ug,ug,ug,ug,ug,ug,ug,ux
ur,ur,ur,ug,ur,ur,ur,ur,ur,cr,ug,ug,ug,ub,ub,ub,ub,ub,ub,ug,ug,ug,ux
ub,ub,ub,ug,ub,ub,ub,ub,ub,ug,ug,ug,ug,ub,ub,cb,ub,ub,ub,ug,ug,ur,ux
ub,ux,ux,ug,ux,ux,ux,ub,ug,ug,ug,ug,ug,ub,ub,ub,ub,ub,ub,ux,ug,ux,ux
ub,ux,ux,ug,ug,ug,ug,ub,ug,ug,cg,ub,ub,ub,cb,ub,ub,ux,ux,ux,ug,ux,ux
ub,ux,ux,ug,ug,ux,ub,ub,ub,ub,ub,ub,ub,ub,ub,ub,ub,ux,ux,ux,ug,ux,ux
ub,ux,ux,ug,ug,ux,ux,ux,ux,cb,ub,ub,ub,ug,ub,ub,ug,ug,ug,ux,ug,ux,ux
ub,ub,ub,cg,ub,ub,ub,ub,ub,ub,ub,ub,ub,ub,ub,ub,ub,ub,ub,ub,ub,ub,ub
ub,ux,ux,ux,ux,ux,ux,ux,ub,ub,ux,ub,ub,ux,ux,ux,ux,ux,ug,ux,ug,ux,ub
ub,ux,ux,ux,ux,ux,ux,ux,ub,ub,ux,ub,ub,ub,ub,ux,ux,ux,ug,ug,ug,ux,ub
ub,ux,ux,ux,ux,ux,ux,ux,ux,ux,ux,ub,ub,ub,ux,ux,ux,ux,ux,ux,ux,ux,ub
ub,ux,ux,ux,ux,ux,ux,ux,ux,ux,ux,ub,ux,ux,ux,ux,ux,ux,ux,ux,ux,ux,ub
ub,ux,ux,ux,ux,ux,ux,ux,ux,ux,ux,ub,ux,ux,ux,ux,ux,ux,ux,ux,ux,ux,ub
ub,ub,ub,cb,ur,ur,cr,ux,ux,ux,ux,ub,ub,ub,ub,ub,ub,ub,ub,ub,ub,ub,ub