ux,cb,cb,cr,ux,ub,cb,ur,ur,ur,ur,ur,ur,ur,ur,ur,ur,ur,ur,ur,ur,ub,cb
ur,ur,cb,ux,ur,ub,ux,ur,ur,ur,ur,ug,ug,ug,cr,ur,ur,ur,ur,ur,ur,ub,ub
ur,ur,ux,ux,ur,cr,ur,ur,ur,ur,cr,ur,ur,ur,ur,ur,ur,ub,ub,cr,ub,ub,ub
ub,ub,ub,ub,ub,ur,ur,ur,ur,ur,ub,ur,ub,ub,ur,ug,ur,ub,ub,ub,ub,ub,ub
ub,ub,ub,ub,ub,ur,ur,ur,ur,ur,ur,ub,ub,ub,ur,ur,ur,ub,ub,cb,ub,ub,ub
ur,ur,ur,ur,ur,ur,ug,ug,ug,ux,ux,ub,ux,ub,ub,ub,ub,cg,ug,ug,ub,ub,ur
ur,ur,ur,ur,ur,cg,ug,ur,ug,ux,ux,ub,ub,ux,ux,ur,ux,ub,ub,cb,ub,ub,ur
cb,ur,ur,ur,ug,ub,ug,ux,ug,ub,ub,ux,ub,ug,ug,ub,ub,ub,ux,ux,ub,ub,ur
ur,ur,ur,ur,ur,ug,ug,ug,ug,ug,ug,ug,ug,ug,ug,ub,ux,ux,ux,ux,ur,ur,ur
ur,ur,ur,ur,ur,cr,ug,ub,ub,ug,ug,ux,ug,ug,ug,ug,ug,ux,ux,ux,ur,ur,ur
ur,ur,ur,ur,ur,ug,ug,ub,ub,ug,ug,ub,ug,ug,ug,cg,ug,ux,ux,ux,ur,ur,ur
ur,ur,cg,ur,ur,ug,ug,ub,ub,ug,ub,ub,ug,ug,ug,ug,ug,ug,ug,ug,ug,ur,cr
cb,ur,ug,ur,ur,ux,ux,ux,ux,ug,ug,ux,ug,ux,ux,ur,ux,ux,ux,ux,ur,ur,cg
ur,ur,ug,ug,ug,ug,ug,ug,ug,ug,ug,ug,ug,ux,ux,ur,ux,ux,ux,ux,ur,ur,ug
ur,ur,cg,ug,ug,ug,ug,ug,ug,ug,ux,ug,ug,ux,ug,ug,ug,ug,ug,ug,ur,ur,ux
cb,ux,ug,ug,ug,ug,ug,ug,ug,ug,ux,ug,ug,ux,ug,ur,ux,ug,ug,ug,ur,ur,ux
ux,ux,ug,ug,ug,ug,ug,ug,ux,ug,ug,ug,ug,ux,ug,ur,ux,ug,ux,ug,ur,ur,ux
ux,ux,ug,ug,ug,cb,ug,ug,ux,ug,ug,ug,ug,ux,ug,ux,ux,ug,ux,ug,ur,ur,ux
ux,ux,ux,ux,ug,ug,ug,ug,ug,ug,ug,ug,ug,ux,ug,ux,ux,ug,ux,ug,ur,ur,ux
ux,ux,ux,ux,ug,ug,ug,ug,ug,ug,ug,ub,ug,ug,ug,ug,ug,ug,ug,ug,ur,ur,cb
cr,ux,ux,ux,ug,ug,ug,ug,ug,ug,ug,ug,ux,ux,ug,ux,ux,ux,ux,ux,ur,ur,cr
cg,ug,ug,ug,ug,ug,ug,ug,ug,ug,ug,ug,ux,ux,ug,ux,ux,ux,ux,cb,cb,ur,cr
cr,cg,cg,cb,ub,ug,ub,ub,ux,ux,ux,ug,ug,ug,ug,cg,ux,ux,ux,cg,cg,ur,cr