ur,ur,ur,ur,cr,ux,ux,ux,ux,ux,ux,ux,ux,ux,ux,ur,ur,cb,ur,ur,ur,ur,ur
ur,ur,ur,ur,cr,ur,ur,ur,ur,ur,ur,ur,ur,ur,ux,ux,ur,ur,ur,ur,ur,ur,ur
ur,ur,ur,ur,ur,ur,ur,ub,ub,ub,ub,ub,ub,ub,ub,cb,ur,ur,ur,ur,ur,ur,ur
ur,ur,ur,ur,ur,cr,ur,ur,ur,ur,ur,ur,ur,ur,ur,ur,ur,ur,ur,ur,ur,ur,ur
cb,ur,ur,ur,ur,ur,ur,ur,ur,ur,ur,ur,ur,cg,ug,ug,ug,cr,ug,ur,ur,ur,ur
ur,ur,ur,ur,ur,ur,ur,ur,ur,ur,cg,ur,ur,ur,ur,ur,ur,ur,ug,ur,ur,ur,ur
ur,ur,ur,ur,ur,ug,ur,ur,ur,ub,ug,ub,ub,ur,ur,ur,ug,ug,ug,ur,ur,ur,ur
ur,ur,ur,ur,ug,ug,ur,ur,ur,ub,ug,ug,ug,cr,ur,ur,ur,ur,ur,ur,ur,cg,ur
ur,ur,ur,ur,ur,ug,ug,ug,ug,ug,ub,ub,ub,ur,ur,ur,ur,ur,ur,ur,ug,ug,ur
ur,ur,ur,ur,ur,ug,ug,ug,ub,ug,ub,ub,ub,ur,cb,ub,ur,ur,ur,ug,ug,ur,ur
ur,ur,ur,ur,ur,ug,ug,ug,ub,ug,ug,ub,ub,ub,cb,ur,ur,ur,ug,ug,ur,ur,ur
ub,ub,ux,ug,ug,ug,ug,ug,ub,ug,ub,cg,ug,ug,ur,ur,ug,ug,ug,ur,ur,ur,ur
ub,ub,ux,ug,ug,ug,ug,ug,ub,ug,ug,ug,ub,ub,ux,ur,ur,ur,ur,ur,ug,ux,cg
ub,ub,ub,ug,ug,ug,ug,ug,ub,ub,ub,ub,ub,ub,ux,ug,ub,ub,ub,ur,ub,ug,ux
ub,ub,ub,ug,ug,ug,ug,ug,ug,ug,ub,ub,ug,ug,ug,ug,ub,ub,ub,ur,ub,ug,ux
ub,ux,ux,ug,ub,ug,ug,ug,ub,ub,ub,ub,ug,ub,ub,ug,ub,cb,ub,ur,ug,ug,ug
ub,ub,ub,ub,ub,ug,ug,ug,ub,ub,ug,ux,ug,ux,ux,ux,ub,ub,ug,ur,ux,ux,ug
cg,ub,ub,ub,ub,ub,ub,ub,ub,ub,ub,ux,ug,ux,ux,ux,ux,ux,ux,ur,ux,ux,ug
ub,ug,ug,ug,ug,ug,ug,ug,ug,ug,ug,ug,ug,ux,ux,ux,ux,ux,ux,ur,cr,ux,ug
ub,ug,ux,ux,ux,ux,ux,ux,ux,ux,ux,ux,ub,ux,ux,ux,ux,ux,ux,ur,ur,ug,ug
ub,ug,ug,ur,ug,ug,ug,ug,ug,ug,ug,ug,ub,ug,ug,ug,ug,ug,ug,ur,ur,ug,ur
cr,ub,ug,ug,ug,ux,ux,ux,ux,ux,ux,ux,ub,ux,ux,ux,ux,ux,ux,ur,ur,cb,cr
cg,ub,ub,ub,ub,ub,ub,ub,ub,ub,ub,ub,ub,cb,ux,ux,ux,ux,ux,cg,cb,ux,cr