ux,ux,cb,ux,ux,ur,ur,ur,ur,ur,ur,ur,ur,ur,ur,ur,ur,ur,ur,cg,ur,ur,ux
ux,ux,ur,ur,ur,ur,ur,ur,ux,ur,ux,ur,ur,ur,ur,ur,ur,ur,ur,ux,ur,ur,ur
ux,ux,ur,ur,ur,ur,ur,ur,ur,ur,ux,ur,ur,ur,ur,ur,ur,ur,ux,ur,cr,ux,ur
cb,ub,cr,ur,ur,ur,ur,ur,ur,ur,ur,ur,ur,ur,ur,ur,ur,ur,ur,ur,ux,ux,ux
ux,ur,ur,ur,ur,ur,ur,ur,ur,ur,ur,ur,cr,ug,ug,ug,ug,ur,ur,ur,ub,ub,ub
ux,ur,ur,ur,ur,ur,ur,ur,ur,ur,ur,ur,ur,ur,ur,ur,ug,ur,ug,ub,ub,ub,ub
ux,ur,ur,ur,ur,ur,ug,cg,ur,ur,ur,ur,ur,ur,ur,ur,ug,ug,cg,ug,ug,ug,ub
ux,ur,ur,ur,ug,ug,ug,ur,ur,ur,ub,ur,ub,ur,ub,ub,ub,ub,ub,ug,ub,ug,ub
ux,ur,ur,ur,ug,ur,ur,ug,ug,cr,ur,ur,ur,ur,ub,ub,ub,ub,ub,ug,ug,ug,ux
ux,ux,ur,ur,ug,ug,ug,ug,ug,ug,ug,cr,ug,ub,ug,ug,ug,ug,ug,ug,ug,ux,ux
ur,ur,ur,ur,ug,ur,ur,ur,ux,ux,ux,ug,ug,ug,ug,ug,ug,ug,ux,ux,ug,ux,ux
ur,ur,ur,ur,ug,ux,ug,ux,ux,ux,ug,ug,ug,ub,ub,ub,ug,ug,ux,ug,ug,ux,ux
cg,ux,ux,ux,ug,ug,ug,ux,ux,ux,ug,ub,cb,ub,ub,ub,ug,ug,cg,ug,ux,ux,ux
ux,ux,ux,ux,ux,ug,ug,ux,ub,ug,ub,ug,ub,ub,ub,ub,ug,ug,ug,ug,ux,ux,ux
ux,ux,ux,ux,ux,ug,ug,ug,ub,ub,ub,ub,ub,ub,ub,ug,ug,ub,ub,ux,ur,ux,ux
ux,ux,ux,ux,ux,ug,ug,ug,ug,ug,ug,ub,ub,ub,ub,ub,ub,ub,ub,ux,ur,ux,ux
ux,ux,ug,ug,ug,ug,ug,ug,ug,ux,ug,ug,ub,ub,ub,ub,ub,ub,ub,ub,ur,ux,ux
cg,ux,ug,ug,ug,ux,ub,ub,ug,ug,ug,ug,ub,ug,ug,ub,ug,ug,ux,ub,ub,ub,ux
ug,ug,ug,ux,ug,ub,ub,ub,ug,ug,ug,ub,ub,ub,cb,ub,ub,ub,ux,ub,ub,ub,ux
ug,ug,ug,ug,ug,ub,cb,ub,ub,ub,ug,ux,ub,ub,ub,ug,cg,ub,ub,ub,ub,ub,ux
cr,ux,ug,ux,ug,ux,ub,ub,ub,ux,ug,ug,ub,ub,ub,ug,ub,ub,ux,ub,ub,ux,ux
cg,cb,ur,ub,ug,ug,ub,ug,ug,ug,ug,ug,ub,ub,ub,ug,ub,ub,ub,ub,ub,cb,cr
cr,ux,ur,ub,ug,ug,ug,ug,ub,ub,ug,ug,ug,cr,ur,cb,ub,ub,ub,ub,cb,ux,cr