ur,ur,ur,ur,ur,ur,ur,ur,ur,ur,ur,cr,ux,ux,ux,ux,ur,ur,ur,ur,ur,ur,ur
ur,cr,ur,ur,ur,ur,ur,ur,ur,ur,ux,ur,ur,ur,ur,ur,ur,ur,ur,ur,ur,ur,ur
ur,ux,cr,ur,ur,ur,ur,ux,ur,ur,ur,ur,ur,ur,ur,ur,ur,ur,ur,ur,ur,ur,ur
ur,ug,ug,ug,ug,ux,ux,ux,ur,ux,ux,ur,ur,ur,ur,ur,ur,ur,ur,ur,ur,ur,ur
ur,ug,ug,ug,ug,ug,ux,ux,ur,ur,ur,ub,ub,ur,ur,ur,ur,ur,ur,cr,ug,ur,ur
ur,ug,ug,ug,ug,ug,ux,ux,ux,ux,ur,ub,ub,ur,ur,ub,ub,ub,ur,ur,ur,ur,ur
ur,ur,ug,ug,ug,ux,ux,ux,ux,ux,ux,ur,ub,ur,ur,cr,ur,cb,ur,ur,ug,ur,ur
ux,ux,ux,ux,ug,ug,ug,ug,ug,ug,ug,ug,ub,ub,ur,ur,ur,ur,ur,ur,ug,ur,ur
cg,ur,ux,ux,ub,ux,ux,ug,ug,ug,cg,ur,ub,ub,ub,ur,ur,ur,ur,ur,ug,ur,ur
ub,ub,ub,ub,ub,ux,ux,ur,ur,ub,ub,ur,ub,ub,ub,ur,ur,ur,ur,ur,ug,ur,ur
ub,ub,ub,ub,ub,ub,ub,ub,ub,ub,ub,ub,ub,ub,ub,ub,cb,ux,ur,ur,ug,ur,ur
ub,ub,cb,ux,ux,ux,ub,cb,ub,ub,ub,ub,ub,ub,ug,ub,ux,ux,ur,ur,ug,ur,ur
ub,ub,ub,ub,ub,ub,ub,ux,ub,ug,ub,ub,ub,ug,ug,ub,ux,ux,ur,ur,cg,ur,ur
cb,ub,ub,ub,ux,ux,ux,ux,ug,ug,ug,ub,ub,ug,ug,cg,ug,ux,ur,ux,ux,ux,ug
cg,ub,ub,ub,ub,ux,ux,ux,ug,ug,ug,ug,ug,ug,ug,ug,ug,ux,ur,ub,ub,ub,ub
ux,ux,ux,ux,ub,ux,ux,ux,ug,ug,ug,ug,ug,ug,ug,ug,ug,ux,ur,ub,ux,ux,ub
ux,ux,ux,ux,ub,ux,ux,ux,ug,ug,ug,ug,ug,ug,ug,ug,ug,ub,ub,ub,ux,ux,ub
ux,ux,ux,ub,ub,ux,ux,ux,ub,ug,ug,ug,ug,ub,ux,ux,ux,ux,ur,ux,ux,ux,ub
ux,ux,ub,ub,ux,ux,ux,ux,ub,ub,ub,cr,ub,ub,ux,ux,ux,ux,ur,ux,ux,ux,ub
ux,ux,ub,ub,ub,ub,ub,ub,ux,ux,ux,ur,ub,ub,ub,ub,ub,ub,ur,ur,ur,ur,ub
ux,ur,ur,ub,ub,ur,ur,ub,ur,ur,ur,ur,ug,ub,ub,ub,ub,ub,ux,ux,ux,ux,ub
ux,ur,ur,ub,ub,ur,ur,ub,ub,ur,ur,ur,ug,ub,ub,ub,ub,ub,ub,ub,ub,ub,cb
ux,ux,ux,ux,ux,ux,ux,ux,ub,cg,ur,ur,ur,ur,ur,ur,ur,ur,ur,ur,ur,ur,ur