ur,ur,ur,ur,ur,ur,ur,ur,ur,ur,ur,ur,ur,ur,ur,ur,ur,cr,ub,cr,ur,ur,ur
ur,ur,ur,ur,ur,ur,ur,cg,ur,ur,ur,ur,ur,ur,ur,ur,ur,ur,ub,ur,ur,ur,ur
ur,ur,ur,ur,ur,ur,ug,ug,ur,ur,ur,ur,ur,ur,cr,ur,ur,ur,cb,ur,ur,ur,ur
ur,ur,ur,ur,ur,ur,cr,ux,ux,cr,ur,ur,ur,ub,ug,ur,ur,ug,ug,ug,ur,ur,ur
ur,ur,ur,ur,ur,ur,ub,ur,ur,ub,ub,ub,ur,ub,ug,ug,ur,ur,ur,ug,ur,ur,ur
ur,ur,ur,ur,cg,ug,ug,ug,ub,ub,ub,ub,ub,ub,ug,ug,ug,ug,cg,ug,ur,ur,cb
ug,ux,ux,ur,ur,ug,ug,ug,ub,ub,ub,cb,ug,ug,ug,ug,ug,ug,ug,ug,ur,ur,ub
ug,ug,ug,ug,ug,ug,cb,ug,ub,ub,ub,ub,ub,ug,ug,ug,ug,ug,ur,ur,ur,ur,ub
cg,ux,ub,ux,ug,ub,ub,ub,ub,ug,ub,ub,ub,ug,ug,ug,ug,ug,ug,ug,ug,ux,ub
ux,ux,ub,ub,ub,ub,ub,ub,ub,ub,ub,ub,ub,cb,ug,ub,ub,ur,ug,ug,ug,ux,ub
ux,ux,ux,ug,ux,ug,ux,ux,ug,ub,ub,ug,ub,ur,ur,ur,ur,ur,ux,ux,ug,ux,ub
ux,ux,ug,ug,ux,ug,ux,ux,ug,ux,ux,ug,ug,ux,ux,ug,ur,ur,ux,ur,ug,ux,ub
ux,ub,ug,ux,ux,ug,ux,ux,ug,ux,ux,ux,ug,ux,ug,ug,ur,ur,ur,ur,ug,ux,ub
ux,ub,ug,ug,ux,ug,ux,ux,ug,ux,ux,ux,ug,ux,ug,ux,ur,ux,ux,ux,ug,ux,ub
cg,ub,ub,ug,ux,ug,ux,ux,ug,ux,ux,ux,ug,ug,ug,ug,ur,ug,ug,ux,ug,ux,ub
cb,ub,ub,ug,ux,ug,ux,ux,ug,ux,ux,ux,ug,ug,ug,ug,ur,ux,ug,ux,ug,ux,ub
ub,ub,ub,ug,ug,ug,ux,ux,ug,ux,ux,ux,ug,ug,ux,ux,ur,ug,ug,ux,ug,ux,ub
ub,ub,ub,ub,ub,ub,ub,ub,ub,ub,ub,ub,ub,ub,ub,ub,ub,ub,ub,ub,ub,ub,ub
ub,ub,ux,ux,ug,ug,ux,ux,ug,ug,ug,ug,ug,ug,ux,ux,ux,ug,ug,ug,ug,ux,ur
ub,ub,ug,ug,ug,ug,ug,ub,ub,ug,ug,ug,ug,ug,ug,ug,ug,ug,ub,ub,ub,ux,ur
ur,ur,ur,ur,ur,ur,ur,ur,ur,ur,ur,ur,ur,ur,ur,ur,ur,ur,ur,ur,ur,ur,ur
ur,ub,ub,ux,ux,ux,ux,ux,ur,ur,ur,ur,ur,ur,ur,ur,ur,cr,ux,ub,ub,ux,cb
ur,ur,ur,ur,ur,ur,ur,ur,ur,cg,ux,ux,ux,ux,ux,ux,ub,ub,ux,ub,ub,ux,ux