ur,ur,ur,ur,ur,ur,ur,ur,ur,ur,ur,ur,ur,ur,ur,ur,ur,ur,ur,ur,ur,ur,ur
ur,ur,ur,ur,ur,ur,ur,ur,ur,ur,ur,ur,ur,ur,cb,ub,cr,ur,ur,ur,ur,ur,ur
ur,ur,ur,ur,ur,ur,ur,ur,ur,ur,ur,ur,ur,ur,ur,ur,ur,ur,ur,ur,ur,ur,ur
ur,ur,ur,ur,ur,ux,ur,ur,ux,ux,ur,ur,ur,ur,ur,ur,ur,ur,ur,ur,ur,ur,ur
ur,ug,cr,ux,ur,ur,ur,ur,ur,ux,ur,ux,ur,ur,ux,ux,ux,ur,ur,ur,ur,ur,ur
ux,ug,ub,ub,cb,ur,ur,ur,ur,ur,ur,ur,ur,ur,ur,ur,ur,ur,ur,ur,ur,ur,ur
ur,ug,ub,ub,ub,ub,ur,ur,ur,ug,ug,ug,ug,ug,ug,ur,ux,ur,ur,ur,ux,ux,ur
ur,cg,ub,ub,ub,ub,ur,ur,ur,ug,ur,ur,ur,ur,ug,ur,ur,ur,ur,ur,cb,ur,cb
cg,ub,ub,ub,ub,ug,ur,ur,ur,ug,ur,cr,cg,ug,ug,ur,ux,ur,ur,ur,ub,ub,cr
ub,ub,ux,ux,ug,ug,ur,ur,ur,ug,ur,ub,ub,ur,ub,ur,ur,ur,ur,ur,ur,ur,ur
ub,ux,ux,ux,ub,ug,ug,ub,ub,ug,ur,ur,ub,ur,cb,cr,ur,ur,ur,ur,ur,ur,ur
ub,ux,ux,ux,ub,ug,ub,ub,ub,ub,ur,ur,ub,ur,ur,cr,ub,ub,ub,ug,ub,ur,ub
ub,ux,ux,ug,ug,ug,ug,ub,ub,ub,ur,ub,cb,ub,ub,ux,ub,ux,ub,ug,ub,ur,ur
ub,ub,ub,ub,ub,ug,ub,ub,ub,ub,ur,ub,ub,ub,ub,ub,ub,ux,ub,ug,ug,ug,ur
cg,ux,ux,ux,ub,ub,ux,ub,ub,ub,ur,ux,ux,ub,ub,ub,ub,ux,ux,ux,ux,ug,ur
ux,ux,ux,ux,ux,ub,ux,ux,ux,ux,ur,ug,ug,ug,ub,ug,ug,ug,ux,ux,ux,ug,ur
ux,ux,ux,ux,ux,ub,ux,ux,ux,ux,ur,ux,ub,ub,ub,ug,ug,ug,ux,ux,ux,ug,ur
ux,ux,ux,ux,ux,ub,ug,ug,ug,ug,ur,ux,ub,ub,ub,ug,ug,ug,ub,ux,ux,ug,ur
ux,ux,ux,ux,ux,ub,ub,ub,ub,ub,ur,ug,ug,ug,ug,ug,ug,ug,ub,ux,ux,ug,ur
ux,ux,ux,ux,ux,ux,ux,ux,ux,ux,ur,ux,ub,ub,ub,ux,ux,ub,ux,ux,ux,ug,ur
ux,ux,ux,ux,ux,ux,ux,ux,ux,ux,ur,ux,ub,ux,ub,ux,ux,ub,ux,ux,ug,ug,ur
ux,ux,ug,ug,ux,ux,ux,ug,ug,ug,ur,ub,ub,ug,ub,ux,ux,ub,ux,ux,ug,ug,ur
ux,ux,ux,ug,ug,ug,ug,ug,ux,cg,ur,ur,ur,cg,ug,ug,ug,ug,ug,ug,ug,ug,ur