ux,ur,ur,ur,ur,ur,ur,ur,ur,ur,ur,ur,ur,ur,ur,cr,ur,ur,ur,ur,ur,ur,ur
ux,ur,cg,ug,ur,ur,ur,ur,ur,ur,ur,ur,ur,ur,ur,ub,cb,cr,ur,ur,ur,ur,ur
ux,ux,ug,ug,ur,ur,ur,ur,ur,ur,ur,ur,ux,ur,ur,ur,ur,ur,ur,ur,ur,ur,ur
ux,ux,ug,ug,ur,ur,ur,ur,ur,ur,ur,ur,ur,ur,ur,ur,ur,ur,ur,ur,ur,ur,ur
ux,ur,ur,ug,ug,ug,ur,ur,ur,ur,ur,ur,ur,ur,ur,ur,ur,ur,ur,ur,ur,cr,ur
ur,ur,ur,ur,ur,ug,ur,ur,ur,ur,ur,ub,ub,ub,ub,ub,cr,cr,ur,ug,ux,ug,ur
ur,ur,ur,ur,ur,ug,ur,ur,ur,ug,ur,ug,ug,ug,cg,ub,ub,ug,ug,ug,ur,ug,ur
ur,ur,ur,ur,ur,ug,ug,ug,ug,ug,ug,ug,ug,ur,ur,ub,ub,ug,ug,ug,ur,ug,ur
cg,ur,ur,ur,ur,ug,ur,ur,ur,ur,ur,ug,ug,ug,ug,ub,ub,ux,ux,ug,ux,ug,ur
ur,ur,ur,ur,ur,ug,ug,ug,ug,ug,ug,ug,ug,ug,ug,ug,ug,ug,ug,ug,ub,ug,ur
ur,ur,ur,ur,ur,ug,ug,ug,ug,ug,ub,ub,ug,ug,ug,ug,ug,ug,ug,ug,ug,ug,ur
ug,ug,ug,ug,ug,ug,ug,ug,ub,ub,ub,ub,ux,ub,ub,ub,ub,ux,ux,ux,ux,ux,ur
ug,ur,ur,ur,ur,ug,ur,cb,ub,ub,ub,ub,ug,ug,ug,ub,ub,ub,ub,ux,ux,ux,cr
cg,ux,ub,ux,ux,ug,ug,ug,ub,ub,ug,ug,ub,ub,ub,ub,ub,ub,ub,ub,ux,ux,ub
ug,ux,ub,ux,ux,ug,ub,ub,ub,ub,ub,ub,ub,ub,ub,ub,ub,ub,ug,ub,ux,ux,ub
ux,ux,ub,ux,ub,ub,ub,ub,ub,ub,ub,ub,ub,ub,ub,ub,ux,ux,ug,ub,ux,ux,cb
ux,ux,ub,ux,ux,ug,ug,ug,ug,ub,ub,ub,ub,ub,ub,ub,ub,ub,ub,ub,ux,ux,ur
ux,ux,ub,ux,ux,ug,ug,ug,ug,ub,ub,ub,ub,ub,ub,cb,ub,ub,ux,ug,ux,ux,ur
ux,ux,ub,ux,ux,ux,ux,ug,ug,ub,ug,ub,ub,ub,ux,ux,ux,ux,ux,ug,ux,ux,ur
ux,ux,ub,ux,ux,ux,ux,ug,ug,cb,ux,ux,ub,ub,ub,ub,ub,ub,ub,ub,ub,ub,ub
ux,ux,ub,ux,ux,ux,ux,ug,ug,ur,ux,ux,cb,ub,ub,ux,ux,ux,ux,ub,ub,ub,ub
ux,ux,ub,ub,ub,ub,ub,ub,ub,ub,ux,ux,ux,ux,ux,ux,ux,ux,ux,ub,ub,ub,ub
ux,ux,ux,ux,ux,ux,ux,ux,ux,ub,ub,ub,ub,ub,ub,ub,ub,ub,ub,ub,ub,ub,ub