ur,ur,ur,ur,ur,ur,ur,ur,ur,cb,ub,ub,ur,ur,ur,ur,ur,ur,ur,ur,ur,ur,ur
ur,ur,ur,ur,ur,ur,ur,cr,ub,ub,ub,cr,ur,ur,ur,ur,ur,ur,ur,ur,ur,ur,ur
ur,ur,ur,ur,ur,ur,ur,ur,ur,ur,ub,ur,ur,ur,ur,cr,ug,ug,cg,ur,ur,cb,ur
ur,ur,ur,ur,ur,ur,ug,ug,ug,ug,ug,ur,ur,ur,ur,ur,ub,ur,ur,ur,ur,ub,cr
ur,ux,ux,ux,ux,ug,ug,ux,ur,ur,ug,ug,cg,ug,ux,ur,ub,ub,ub,ur,cr,ur,ur
ur,ux,ux,ux,ux,ug,ug,ug,ur,ur,ub,ug,ug,ug,ug,ug,ug,ur,ub,ur,ur,ur,ur
ur,ur,ur,ur,ur,ur,ur,ug,ur,ur,ub,ug,ug,ug,ug,ug,ug,ur,ub,ur,ur,ur,ux
ur,ur,ur,ur,ur,ur,ur,ur,ur,ub,ub,ub,ur,ur,ug,ug,ux,ur,ub,ur,ub,ub,ux
ur,ur,ur,ur,ur,ur,ur,ur,ug,ub,ug,ub,ug,ug,ug,ug,ug,ur,ub,ur,ub,ur,ur
ur,ur,ur,ur,ur,ug,ug,ub,ub,cb,ub,ub,ux,ux,ux,ux,ug,ug,ub,ux,ux,ux,ur
cg,ug,ug,ug,ug,ug,ug,ug,ug,ub,ub,ub,ug,ug,ug,ug,ug,ug,ub,ux,ux,ux,ur
ub,ub,ub,ur,ur,ug,ub,ub,ug,ub,ub,ub,ub,ub,ux,ug,ug,ug,ub,ux,ux,ux,ur
ub,ub,ub,ur,ur,ug,ug,ug,ug,ub,ub,ub,ub,ub,ub,ug,ug,ug,ub,ub,cb,ux,ur
ug,ux,ub,ub,ug,ug,ur,ug,ub,ub,ub,ub,ub,ub,ug,ug,ug,ug,ux,ux,ux,ux,ur
ug,ux,ux,ux,ug,ug,ur,ux,ub,cb,ub,ub,ub,ub,ux,ux,ux,ux,ux,ux,ux,ux,ur
ug,ux,ux,ux,ug,ug,ug,ug,ub,ub,ug,ub,ub,ub,ux,ux,ux,ux,ux,ux,ux,ux,ur
ug,ux,ux,ux,ux,ux,ug,ux,ux,ux,ug,ub,ub,ub,ux,ux,ux,ux,ux,ux,ux,ux,ur
ur,ur,ur,ur,ur,ur,ur,ur,ur,ur,ur,ur,ur,ur,ur,ur,ur,ur,ur,ur,ur,ur,ur
ur,ux,ux,ux,ux,ux,ur,ux,ux,ux,ux,ux,ux,ug,ux,ux,ux,ux,ux,ux,ux,ux,ux
ur,ux,ux,ux,ux,ux,ur,ux,ux,ux,ux,ux,ux,ug,ux,ux,ux,ux,ux,ux,ux,ux,ux
ur,ux,ux,ux,ux,ux,ur,ux,ux,ux,ux,ux,ux,ug,ux,ux,ux,ux,ux,ux,ux,ux,ux
ur,ur,ur,ur,ur,ur,ur,ur,ur,ur,ur,ur,ur,ur,ur,ur,ur,ur,ur,cr,ux,ux,ux
ur,ur,ur,ur,ur,ur,ur,cg,ux,ux,ux,ux,ux,ux,ux,ux,ux,ux,ux,ux,ux,cb,ux