ur,ur,ur,ur,ur,ur,ur,ur,ur,ur,ur,ur,ur,ur,ur,ub,ub,ub,ub,ub,ur,ub,ub
ux,ur,ur,ur,ur,ur,ur,cr,ur,ur,ur,ur,ur,ur,ur,ur,ur,ur,ur,ub,ur,ub,ub
ux,ur,ur,ur,ur,ur,ur,ur,cg,ug,ur,ur,ur,ur,ur,ur,ur,ur,ur,ub,ub,ub,cb
ur,ur,ur,ug,ur,ur,ur,ur,ur,ur,ur,ur,ur,ur,ur,ur,ur,ur,ur,ub,ub,cg,cb
ur,ur,ur,ug,ur,ur,ur,ur,ur,ur,ur,ur,ur,ur,ur,ur,ur,cr,ug,ub,ub,ug,ux
ux,ur,ur,ur,ur,ur,ur,ur,ur,ur,ur,ur,ur,ur,ur,ur,ur,ur,ug,ub,ub,ug,ub
ur,ur,ux,cr,ur,ur,ur,ur,ur,ur,ur,ur,ur,cg,ug,ug,ug,ug,ug,ur,ub,ug,ub
ur,ur,ur,ur,ur,ur,ur,ur,ur,ur,ur,cr,ug,ug,ug,ug,ug,ug,ug,ux,ub,ug,ub
cg,ur,ur,ur,ur,ur,ur,ur,ur,ur,cb,ug,ug,ug,ug,ug,ug,ug,ug,ux,ub,ug,ub
ur,ur,ur,ur,ur,ur,ur,ur,cr,ub,ub,ub,ug,ug,ug,ug,ug,ug,ug,ur,ub,ug,ub
ur,ur,ur,ur,ur,ur,ur,ur,ur,ur,ub,ub,ub,ug,ug,ug,ug,ug,ug,ug,ub,ug,ub
ur,ur,ur,ur,ub,ub,ub,ur,ug,ur,ub,ub,ub,ug,ug,ug,ug,ug,ug,ug,ub,ug,ub
ur,ur,ur,ub,ub,ub,ug,ug,ug,ub,cb,ub,ub,ub,ug,ug,ug,ug,ug,ug,ub,ug,ub
ub,ub,ux,ub,ub,ug,ux,ub,ub,ub,ub,ug,ub,ub,cb,ub,ug,ug,ug,ug,ug,ug,ub
cg,ub,ux,ub,ug,ug,ub,ux,ux,ub,ur,ug,ub,ug,ug,ur,ug,ug,ug,ur,ux,ux,ur
ub,ub,ux,ub,ug,ux,ub,ux,ub,ub,ur,ug,ub,ub,ub,ub,ub,ub,ug,ur,ur,ur,ur
ub,ub,ug,ub,ug,ux,ux,ux,ux,ux,ug,ug,ub,ub,ub,ub,ub,ug,ux,ur,ur,ur,ur
ub,ub,ub,ub,ux,ux,ux,ux,ux,ux,ug,ux,ub,ub,ub,ub,ub,ug,ug,ug,ur,ur,ur
ub,ub,ug,ub,ub,ux,ux,ux,ux,ux,ug,ug,ub,ub,ub,ur,ub,ub,ur,ug,ur,ur,ur
ub,ub,ug,ux,ub,ux,ux,ux,ux,ux,ur,ug,ug,ug,ug,ug,ub,ub,ub,ug,ur,ur,ur
ur,ur,ur,ur,ur,cr,ur,ur,ur,ur,ur,ux,ux,ub,ub,ug,ug,ug,ug,ug,ur,ur,ur
ur,ub,ub,ub,ub,ur,ux,ub,cb,ux,ur,ur,ur,ur,ur,ur,ux,ux,ur,ur,ur,ur,cb
ur,ur,ur,ur,ur,ur,ub,ub,ux,cg,ur,ur,ur,ur,ur,ur,ur,ur,ur,ur,ur,ur,ur