ur,ur,ur,ur,ur,ur,ur,ur,ur,ur,ur,ur,ur,ux,ur,ur,ur,cb,cr,ur,ur,ur,ur
ur,ur,ur,ug,ur,ur,ur,cg,ug,ug,ug,ur,ur,ur,ur,ur,ug,ug,ug,ur,ur,ur,ur
ur,ur,ur,cr,ur,ur,ur,ur,ur,ur,ug,ug,ug,cr,ur,ur,cg,ur,ur,ux,ur,ub,ug
ur,ur,ur,ug,ug,cr,ug,ur,ur,ur,ur,ur,ur,ur,ub,ub,ub,ux,cr,ur,ur,ub,ug
ur,ur,ur,ug,ug,ur,ur,ur,ur,ug,ug,ug,ug,ub,ub,ub,ub,ub,ux,ub,ux,ub,ug
ux,ur,ux,ur,ux,ug,ur,ug,ug,ur,ur,ur,ug,ug,ub,ub,ub,ub,ux,ub,ux,ub,ug
ur,ur,ux,ur,ug,ug,ur,ur,ug,ug,ux,ux,ux,ug,cg,ub,cb,ub,ub,ub,ux,ub,ug
ur,ur,ur,ur,ur,ug,ux,ux,ux,ub,ux,ux,ux,ub,ub,ub,ub,ub,ub,ub,ux,ub,ug
ur,ur,ur,ug,ug,ug,ux,ux,ux,ub,ux,ux,ux,ub,ub,ub,ub,ub,ub,ub,ux,ub,ug
ur,ux,ur,ux,ux,ug,ux,ux,ux,ub,ub,ux,ux,ub,ug,ub,ub,cb,ub,ub,ux,ub,ug
ur,ur,ur,ux,ux,ug,ug,ub,ub,ub,ug,ub,cg,ug,ug,ug,ug,ub,ub,ub,ub,ub,ug
ux,ux,ux,ux,ux,ug,ug,ub,ub,cb,ub,ub,ub,ug,ug,ug,ug,ug,ux,ux,ub,ub,ug
ux,ux,ux,ux,ub,ug,ub,ub,ub,ub,ug,ub,ug,ug,ug,ub,ug,ug,ux,ux,ub,ub,ug
ux,ux,ux,ux,ub,ug,ux,ub,ub,ub,ub,ug,ug,ug,ug,ub,ub,ub,ub,ux,ub,ub,ug
cg,ux,ux,ux,ub,ug,ug,ub,ub,ub,ug,ug,ug,ug,ug,ub,ub,ub,ub,ux,ub,ug,ug
ub,ub,ub,ub,ub,ug,ub,ub,ub,ug,ug,ug,ug,ug,ug,ub,ub,ub,ub,ur,ub,ug,ug
ub,ux,ux,ub,ub,ug,ub,ub,ub,ub,ub,ub,ub,ub,ub,ux,ux,ux,ux,ur,ub,ur,ur
ub,ux,ux,ux,ux,ug,ux,ux,ux,ux,ub,ub,ub,ux,cr,ur,ur,ur,cb,ub,ub,ur,ur
ub,ux,ux,ux,ux,ug,ux,ux,ux,ux,ux,ub,ub,ub,ub,ux,ux,ux,ux,ur,ur,ur,ur
ub,ux,ux,ub,ub,ub,ug,ub,ub,ub,ub,ub,ub,ub,ub,ub,ub,ub,ub,ub,ub,ur,ur
ub,ub,ub,ub,ux,ub,ur,ub,ub,ub,ub,ub,ub,ub,ub,ub,ub,ub,ub,ur,ub,ur,ur
cr,ux,ux,ux,ux,ub,ux,ux,ub,ub,ub,ub,ub,ub,ub,ub,ub,ub,ur,ur,ub,ur,cb
cg,ux,ux,ux,ux,ub,ub,ub,ub,cg,ux,cb,ub,ub,ub,ub,ub,ub,ur,ur,cb,ur,ur