ur,ur,ur,ur,ur,ur,cr,ur,ub,ub,ub,ub,ub,ub,ub,ub,ur,ur,ur,cg,ur,ur,ur
ur,ur,ur,ur,ur,ur,ur,ur,ub,cg,ur,ur,ur,ur,ur,ub,ub,ur,ur,ur,ur,ur,ur
ur,ur,ur,cr,ub,ug,ub,ug,ub,ug,ur,ur,ur,ur,ur,ur,cb,ug,ug,cr,ur,ux,ur
ur,ur,ub,ur,ur,ug,ug,ug,ug,ug,ur,ur,ur,ur,ug,ur,ur,ux,ug,ux,ur,ur,ur
ur,cr,ur,ub,ub,ur,ub,ub,ur,cr,ur,ug,ux,ur,ur,ur,ug,ug,ug,ux,ux,ur,ux
ub,ub,ur,ub,ur,ub,ub,ub,ub,ur,ug,ug,ub,ub,ug,ux,ux,ux,ux,ux,ux,ux,ux
ub,ub,ur,ur,ur,ug,ub,ub,ub,ur,ub,ub,ub,ub,ug,ux,ux,ux,ux,ux,ux,ux,ux
ub,ub,ub,ug,ug,ug,ub,ug,ug,ub,ub,ub,ub,ub,ug,ux,ux,ux,ux,ux,ux,ux,ux
ub,ub,ug,ug,ug,ug,ub,ug,ug,ug,ux,ug,ub,ub,ug,ux,ux,ux,ux,ux,ux,ux,ux
ux,ub,ux,ug,ub,ub,ub,ug,ub,ug,ub,ub,cb,ub,ug,ux,ux,ux,ux,ux,ux,ux,ux
ux,ub,ux,ub,ub,ux,ub,ux,ub,ub,ub,ub,ub,ub,ub,ub,ug,ug,ug,ug,ug,ug,ux
ux,ub,ub,ub,cg,ux,ub,ux,ug,ug,ub,ub,ub,ub,ug,ub,ux,ux,ux,ux,ux,ug,ux
ux,ux,ux,ub,ug,ub,ub,cg,ug,ug,ug,ub,cb,ub,ub,ub,ux,cr,ub,ux,ux,ug,ux
ux,ux,ux,ub,cb,ub,ub,ug,ug,ug,ug,ug,cb,ub,ub,ub,ub,ur,ub,ux,ux,ug,ux
ux,ux,ux,ub,ub,ub,ub,ug,ug,ug,ux,ug,ub,ub,ug,ux,ux,ur,ux,ug,cg,ug,ux
ux,ux,ux,ux,ug,ug,ug,ux,ug,ux,ux,ug,ub,ub,ug,ub,ub,ur,ug,ug,ug,ux,ux
ux,ux,ux,ux,ug,ug,ug,ug,ug,ug,ux,ub,ub,ub,ug,ub,ug,ur,ug,ux,ug,ug,ug
cg,ux,ux,ux,ug,ug,ug,ug,ug,ug,ub,ub,cb,ub,ug,ug,ug,ur,ug,ug,ub,ub,ug
ur,ur,ur,ur,ur,ur,ur,ur,ug,ur,ug,ub,ub,ur,ug,ug,ug,ug,ug,cg,ub,ub,ug
ur,ur,ur,ur,ur,ur,ur,ur,ug,ur,ug,ug,ug,ur,ub,cb,ug,ur,ug,ug,ug,ug,ug
cr,ux,ux,ux,ux,ux,ux,ux,ug,ug,ug,ux,ug,ur,ub,ub,ux,ur,ux,ux,ub,ub,ub
cg,ux,ux,ux,ux,ux,ux,ux,ux,ux,ug,ug,ug,ur,ub,ub,ub,ub,ux,ub,ub,cb,cr
cr,ux,ux,ux,ux,ux,ux,ux,ux,ux,ux,ux,ux,ur,ur,ur,ur,ub,ub,ub,cb,ux,cr