cb,cb,cb,cr,ur,ur,cg,ur,ur,ux,ur,ur,ur,ur,ur,ur,ur,ur,ur,ur,ur,ur,cb
ur,ur,ur,cg,ur,ur,ug,ur,ur,ur,ur,ur,ur,ur,ur,ur,ur,ur,ub,ub,ub,ub,ur
ur,ur,ur,ug,ur,cr,ug,ur,ur,ur,cg,ur,ur,ur,ur,ur,ur,ub,cb,ub,ub,ub,ur
ur,ur,cr,ug,ur,ur,ug,ur,ur,ug,ug,ur,ur,ur,cr,ur,ur,ur,ub,ub,ub,ub,ur
ub,cb,cb,ub,ug,ug,ug,ur,ur,ug,ur,ur,ur,ur,ug,ur,ur,ub,ub,ub,ub,ur,ur
ub,ur,ur,ub,ug,ur,ug,ur,ur,ug,ur,ur,ur,ur,ug,ug,ug,ug,ur,ub,ub,ub,ub
ub,cr,ur,ub,ug,ub,ur,ur,ur,cr,ug,ux,ux,ux,ub,ux,ux,ug,ub,ub,ub,ux,ub
cb,ux,ub,ub,ug,ug,ur,ur,ur,ur,ug,ug,ux,ug,ub,ug,ug,ug,ux,ux,ug,ux,ub
ux,ur,ur,ug,ug,ug,ug,ub,ub,ub,ug,ug,ug,ug,ub,ug,ug,ug,ux,ux,ug,ug,ub
ux,ur,ur,ur,ug,ur,ug,ub,ub,ub,ug,ub,ux,ux,ub,ub,ux,ug,ux,ux,ub,ug,ub
ux,ur,ur,ur,ug,ug,ug,ub,ub,cb,ub,ub,ux,ux,ug,ub,ub,ug,ub,ub,ub,ug,ub
ux,ur,ur,ur,ur,ug,ug,ug,ug,ug,ug,ub,cg,ug,ug,ug,ug,ug,ub,ub,ub,ug,ub
cb,ur,ur,ur,ur,ur,ug,ub,ub,ub,ug,ub,ub,ug,ug,ug,ug,ug,ub,ub,ub,ug,ub
ur,ur,ur,ur,ug,ug,ug,ub,ub,ub,ug,ug,ug,ug,ug,ug,cr,ug,ux,ux,ux,ug,ub
ur,ur,ur,ur,ug,ur,ub,ub,ub,ub,ug,ug,ug,ug,ug,ug,ur,ug,cg,ux,ux,ug,ub
ur,ur,ur,ux,ug,ur,ux,ub,ux,ub,ug,ug,ug,ug,ug,ux,ur,ug,ug,ub,ub,ug,ub
ux,ur,ur,ur,ug,ur,ux,ux,ux,ux,ug,ux,ug,ux,ux,ux,ur,ux,ux,ux,ux,ug,ux
cr,ux,ux,ux,ug,ub,ub,ub,ub,ub,ug,ug,ug,ub,ub,ub,ur,ub,ub,ub,ub,ug,ub
cg,ux,ux,ux,ug,ub,ux,ux,ux,ux,ux,ux,ux,ux,ux,ux,ur,ux,ux,ux,ux,ug,ub
cb,ub,ub,ub,ug,ug,ug,cb,ub,ub,ub,ub,ub,ub,ub,ub,ur,ug,ug,ug,ug,ug,ub
ux,ub,ux,ux,ux,ux,ux,ux,ux,ux,ux,ux,ux,ux,ux,ux,ur,ux,ux,ux,ux,ux,cr
cr,ub,ub,ub,ub,ub,ub,ub,ub,ub,ub,ub,ub,ub,ub,ub,ur,cb,cg,ux,cb,ux,cr
cg,cb,cg,cb,ux,ux,ux,ux,ux,ux,ux,ux,ux,ux,ux,cg,ur,ur,ur,cg,cg,ux,cr