ux,cb,cb,cr,ur,ur,ux,ux,ux,cr,ux,ux,cb,ub,ub,ub,ub,ub,ub,ub,ub,ur,cb
ux,cb,cb,ux,ur,ur,ur,ur,ur,ur,ur,ur,ur,ub,ub,ur,ur,ur,ur,ur,ub,ur,ur
ux,ub,ub,ux,cr,ur,ur,ur,ur,ur,ur,ur,ur,ur,ur,ur,ur,ur,cr,ub,ub,ur,ur
ub,ub,ub,ux,ux,ur,ug,ug,ug,ug,ur,ug,ur,ur,ur,ur,ur,ur,ur,ur,ur,ur,ur
ub,ub,ub,ux,ub,ur,ug,ur,ur,ug,ur,ur,ur,cg,cg,ug,cb,ub,ug,ur,ur,ur,ur
ub,ub,ub,ux,ub,cg,ug,ub,ub,ub,ub,ur,ur,ug,ub,ub,ub,ub,ug,ur,ur,ur,ur
ub,ub,ub,ux,ub,ub,ur,ur,ub,ub,ub,ur,cr,cb,ur,ur,ur,ur,ur,ur,ur,ur,ur
cb,ub,ux,ux,ux,ux,ub,ub,ub,ub,ub,ub,ur,ub,ur,ur,ur,ur,ur,ur,ur,ur,ur
ux,ub,ub,ur,ur,ur,ub,ub,ub,ub,ub,ur,ug,ub,ub,cr,ux,ur,ub,ub,ug,ub,ur
ub,ub,ub,ur,ux,ux,ub,ux,ux,ub,ux,ux,ux,ub,ub,ub,ur,ur,ug,ub,ug,ub,ur
ug,ug,ub,ug,ur,ux,ub,ux,ux,ub,ub,ub,ug,ug,cb,ug,ug,ug,ux,ub,ug,ub,ur
ug,ug,ug,ug,ug,ug,ub,cr,ur,ur,ur,ur,ur,ur,ur,ur,ug,ug,ug,ug,ur,ur,ur
cb,ub,ug,ux,ug,ug,ub,ub,ug,ug,ux,ux,ug,ug,ug,ug,ug,ug,ug,ug,ug,ub,cg
ur,ur,ug,ur,ug,ug,ug,ub,ug,ug,ug,ug,ug,ug,ug,ug,cb,ub,cg,ub,ub,ub,ub
ug,ug,ug,ux,ux,ux,ug,ug,ug,ub,ug,ux,ug,ug,ug,ug,ug,ug,ux,ub,ug,ub,ub
ug,ux,ug,ug,ug,ug,ug,ug,ug,ub,ug,ug,ug,ug,ug,ub,ub,ug,ub,ub,ug,ub,ub
ug,ux,cg,ug,ug,ux,ug,ug,ug,ub,ug,ug,ug,ug,ug,ux,ux,ug,ug,ug,ug,ub,ub
ug,ux,ug,ug,ug,ug,ug,ug,ug,ub,ug,ug,ub,ub,ub,ub,ub,ub,ux,ub,ur,ug,ub
ug,ux,ug,ug,ug,ug,ug,ug,ug,ub,ug,ug,ug,ug,ug,ug,ug,ug,ug,ug,ur,ux,ub
ug,ug,ug,ug,ug,ug,ug,ug,ug,ub,ug,ur,ur,ur,ur,ur,ur,ur,ur,ur,ur,ur,ub
cr,ux,ux,ux,ug,ug,ug,ug,ug,ug,ug,ux,ux,ux,ux,ux,ux,ux,ux,ux,ux,ur,cr
cg,ux,ux,ux,ux,ux,ug,ug,ug,ug,ug,ux,ux,ux,ux,ux,ux,ux,ux,cb,cb,ur,cr
cr,cg,cg,cb,ux,ux,ug,ug,ug,ux,ux,ux,ux,ux,ux,cg,ux,ux,ux,cg,cg,ur,cr