ur,ur,ur,ur,ur,ur,ur,ur,ur,ur,ur,ur,ur,ur,ur,ur,ur,cb,ur,ur,ur,ur,ur
ur,ur,ur,ur,ur,ur,ur,ur,ur,ur,ur,ur,ur,ur,ur,ur,ur,ur,ur,ur,ur,ur,ur
ur,ur,ur,ur,ur,ur,cr,ur,ux,ur,ur,ur,ur,ur,ur,ur,ur,ur,ur,ur,cr,ur,ur
ur,ur,ur,ur,ur,ur,ur,ur,ur,ur,ur,ur,ur,ur,ur,ug,ug,ug,ug,ux,cr,ur,ur
cb,ux,ux,cr,ur,ur,ur,ur,ur,ur,ur,ur,ur,ur,ur,ux,ux,ux,ug,ux,ux,ux,ux
ux,ux,ux,ur,ug,ur,ug,ug,ur,ur,ur,ur,ur,ur,ur,ug,ug,ug,ug,ux,ux,ux,ux
ux,ux,ux,ur,ug,ur,ur,ug,ur,ur,ur,ur,ur,cg,ug,ug,ug,ug,ug,ux,ux,ux,ux
ur,ur,ur,ur,ug,ug,ug,cr,ur,ur,ur,ug,ug,ug,ug,ug,ug,ug,ug,ux,ux,ux,ux
ur,ur,ur,ur,cg,ug,ug,ur,ur,ug,ur,ur,ur,ur,ux,ux,ug,ug,ux,ux,ux,ux,ux
ur,ur,ur,ur,ur,ug,ug,ug,ug,ug,ug,ug,ur,ux,ux,ux,ux,ux,ux,ux,ux,ux,ux
ur,ur,ur,ur,ur,ug,ug,ug,ub,ug,ub,ub,ub,ug,ug,ug,ux,ub,ub,ux,ux,ux,ux
ur,ur,ur,ur,ur,ug,ur,ug,ub,ug,ug,ub,ub,ug,ub,ug,ug,ug,ug,ug,ug,ux,ux
ur,ur,ur,ur,ur,ur,ug,ug,ug,ug,cg,ub,ub,ug,ub,ub,ub,ub,ub,ub,ug,ux,cg
ur,ur,ur,ur,ur,cb,ub,ub,ub,ub,ub,ug,ug,cg,ub,ub,ub,ug,ug,cb,ub,ug,ux
ur,ur,ur,ur,ur,cb,ub,ub,ub,ub,ub,ub,ub,ub,ub,ub,ub,ub,ug,ub,ub,ug,ux
ux,ub,ub,ub,ub,ub,ub,ub,ub,ub,ub,ub,ub,ub,ub,ub,ub,ub,ub,ub,ur,ur,ur
ux,ub,ub,ub,ub,ub,ub,ub,ug,ub,ub,ub,ub,ub,ub,ub,ux,ub,ub,ub,ub,ug,ur
cg,ub,ub,ub,cb,ux,ux,ub,ub,ub,ub,ux,ux,ux,ux,ub,ub,ub,ub,ub,ug,ug,ur
ur,ub,ub,ub,ug,ug,ug,ug,ug,ug,ub,ub,ub,ub,ub,ub,ub,ub,ub,ug,ug,ub,cr
ur,ub,ub,ub,ub,ub,ub,ub,ub,ub,ub,ub,ub,ug,ug,ug,ug,ug,ug,ug,ub,ub,ub
ur,ur,ug,ub,ub,ub,ub,ub,ub,ub,ub,ub,ug,ug,ub,ug,ug,ub,ub,ub,ub,ub,ub
cr,ux,ug,ub,ub,ub,ub,ub,ug,ug,ug,ug,ug,ub,ub,ub,ub,ub,ux,ux,ux,cb,cr
cg,ux,ug,ug,ug,ug,ug,ug,ug,ux,ux,ux,ux,cb,ux,ux,ub,ub,ux,cg,cb,ux,cr