ur,cb,cb,cr,ur,ur,ur,ur,ur,ur,ur,ur,ur,ur,ub,ub,ur,ub,ub,ub,ub,ur,cb
ur,ur,cb,ux,ur,ur,ur,ur,ur,ur,ur,ur,ur,ur,cb,ub,ub,ub,ur,ur,ub,ur,ux
ur,ur,ur,ur,ur,ur,ur,ur,ur,ur,ur,ur,ug,ug,ug,ug,ug,ug,cg,ub,ub,ur,ux
ur,ur,ur,ur,cr,cr,ux,ur,ub,ub,ug,ug,ug,ur,ux,ur,ur,ur,ur,ur,ur,ur,ux
ug,ug,ur,ur,ug,cr,ur,ur,ur,ur,ur,ur,ur,ur,ur,ur,ur,ur,ur,ur,ur,ur,ur
ur,ur,ur,ur,ur,ur,ur,ug,ur,ur,ug,ug,ug,ug,ug,ug,ug,ug,ug,ug,ur,ur,ur
ur,ur,ur,ur,ug,ur,ug,ug,ur,ur,cg,ur,ur,ur,ur,ur,ur,ur,ur,ug,ur,ur,ur
cb,ub,cr,ug,ug,ur,ur,ur,ur,ur,ur,ug,cr,ug,ug,ur,ur,ug,ug,ug,ur,ur,ur
ub,ub,ur,ug,ur,ur,ur,ur,ur,ur,ur,cg,ur,ug,ub,ub,ug,ug,ug,ug,ug,ug,ux
ub,cb,ur,ug,cr,ub,ux,ug,ux,ux,ug,ug,ug,ug,ub,cb,ug,ux,ug,ug,ug,ug,ux
ub,ub,ub,ub,ur,ub,ub,ug,ux,ux,ub,ug,ug,ub,ug,cg,ug,ug,ug,ug,ug,ug,ux
ux,ub,ub,ux,ur,ug,ug,ug,ux,ug,ug,ug,ug,ub,ug,ug,ux,ug,ug,ug,ug,ug,ux
cb,ub,ub,ux,ur,ug,ug,ug,ug,ub,ug,ug,ub,ug,ug,ug,ux,ug,ug,ug,ug,ug,ux
ub,cb,ub,ug,ur,ug,ug,ug,ug,ux,ub,ub,ub,ug,ug,ug,ug,ug,ug,ug,ug,ug,ux
ub,ub,ug,ug,ur,ug,ug,ug,ug,ug,ug,ug,ub,ug,ug,ug,ug,ug,ug,ug,ug,ug,ux
ux,ux,ug,ug,ur,ug,ug,ux,ux,ux,ux,ub,ug,ug,ug,ug,ug,ug,ug,ug,ug,ug,ux
ux,ux,ug,ug,ur,ug,ug,ug,ug,ux,ub,ug,ug,ug,ug,ug,ux,ux,ux,ug,ug,ug,ux
ur,ug,ug,ug,ur,ug,ug,ug,ug,ug,ug,ug,ug,ug,ug,ur,ur,ur,ur,ur,ur,ur,ur
ur,ug,ug,ug,ug,cb,ub,ug,ub,ux,ux,ux,ug,ug,ug,ug,ug,ux,ux,ug,ux,ug,ur
cr,ub,ub,ub,ug,cg,ub,ub,ub,ub,ub,cb,ug,ug,ug,ur,ug,ur,ur,ur,ur,ur,ur
cg,ub,ub,ub,ub,ub,ub,ug,ub,ub,ug,ux,ug,ug,ug,ug,ug,ux,ug,ug,ug,ug,cr
cr,ub,ub,ub,ub,ub,ub,ug,ub,ub,cg,ur,ug,ur,ux,ux,ux,ub,ub,cb,cb,ug,cr
cg,ur,cg,cb,ux,ug,ug,ug,ux,ux,ug,ug,ug,ur,ur,cg,ux,ux,ux,cg,cg,ug,cr