ur,ur,ur,ur,ur,ur,ur,ur,ur,ur,ur,ur,ub,cb,ur,ur,ur,cr,ug,ux,ux,cr,ux
ur,ur,ur,ub,cb,ur,ur,ur,ur,ur,ur,ub,ub,ur,ux,ux,ux,ux,ug,ux,ux,ur,ux
ur,ur,ur,cr,ur,ur,ur,ur,ur,ur,ur,ub,ux,ur,ux,ub,ub,ub,ug,ux,ux,ur,ux
ur,ur,ur,ur,ur,ur,ux,ux,ur,ur,ub,ub,ub,ub,ub,ub,ux,ub,ug,ux,ux,ur,ux
ur,ur,ur,ur,ur,ur,ux,ux,ur,ur,ub,ub,ub,ub,ug,ug,ub,ub,ug,ux,ux,ur,ux
ur,ur,ur,ur,ur,cg,ug,ug,ur,ur,ug,ub,ub,ub,ub,ug,ux,ub,ug,ux,ux,ur,ux
ur,ur,ur,ur,ur,ur,ur,ug,ug,ug,ub,ub,ub,ub,ux,ug,ux,ub,ug,ux,ux,ur,ux
ur,cr,ur,ur,ur,ur,ug,ug,ur,ug,ub,ub,ub,ub,ux,ug,ub,ub,ug,ux,ux,ur,ux
ur,ug,ur,ur,ur,ur,ug,ug,ug,ug,ub,ub,ub,cb,ub,ug,ux,ux,ug,ux,ux,ur,ux
ur,cg,ur,ur,ur,ub,ub,ub,ug,ug,ub,ub,ug,ub,ub,ub,ux,ux,ug,ux,ux,ur,ux
cg,ur,ur,ur,ur,ub,ub,ub,ub,ub,ub,ug,ug,ub,ub,ub,ux,ux,ug,ux,ux,ur,ux
ur,ur,ur,ur,ur,ub,cb,ub,ub,ug,ug,ug,ur,ur,ur,ur,ur,ur,ug,ur,ur,ur,ur
ur,ur,ur,ur,ux,ub,ub,ux,ub,ug,ub,ub,ub,ub,ux,ux,ux,ux,ug,ux,ur,ux,ur
ur,ur,ur,ur,ux,ux,ub,ub,ub,ub,ug,ub,ub,ub,ux,ux,ux,ux,ug,ux,ur,ux,ur
ur,ur,ur,ur,ub,ub,ub,ub,cr,ub,ub,ub,ub,ub,ux,ux,ux,ux,ug,ux,ur,ux,ur
ur,ur,ur,ur,ux,ux,ub,ub,ur,ux,ux,ux,ux,ux,ux,ux,ux,ux,ug,ux,ur,ux,ur
ur,ur,ur,ur,ux,ux,ux,ub,ur,ux,ux,ux,ux,ux,ux,ux,ux,ux,ug,ux,ur,ux,ur
ur,ur,ur,ur,cr,ug,ug,ug,ur,ug,ug,ug,ug,ug,ug,ug,ug,ug,ug,ux,ur,ur,ur
ur,ur,ur,ur,ub,ub,ub,ub,ub,ub,cb,ux,ux,ux,ux,ux,ux,ux,ux,ux,ur,ur,ux
ur,ur,ur,ux,ux,ux,ux,ux,ur,ux,ux,ux,ux,ux,ux,ux,ux,ux,ux,ux,ur,ur,ur
ur,ur,ur,ur,ur,ur,ur,ur,ur,ur,ur,ur,ur,ur,ur,ux,ux,ux,ux,ux,ur,ur,ur
ur,ur,ur,ur,ur,ur,ur,ur,ur,ur,ur,ur,ur,ur,ur,ur,ur,ur,ur,ur,ur,ur,ur
ux,ux,ux,ux,ux,ux,ux,cg,ur,ur,ur,ur,ur,ur,ur,ur,ur,ur,ur,ur,ur,cb,ur