ur,ur,cb,ur,ur,ur,ur,ur,ur,ur,ur,ur,ur,ur,ur,ur,ur,cb,ur,cg,ux,ux,ux
ur,ur,ur,ur,ur,ur,ur,ur,ur,cr,ur,ur,ur,ur,ur,ur,ur,ur,ur,ux,ux,ux,ux
ur,ur,ur,ur,ub,ur,ur,ur,ux,ux,ur,ur,ur,ur,ur,ur,ur,ur,ur,ux,ux,ux,ux
ur,ur,cr,ur,ub,ur,ur,ur,ux,ux,ur,ur,ur,ur,ur,ur,ux,ur,ux,ux,ux,ux,ux
ur,ur,ux,ur,cb,ur,ur,cb,ub,ur,ur,ur,ur,ur,ur,ug,ug,ug,ug,ug,ug,ug,ux
ur,ur,ux,ur,ur,ur,ur,ur,cr,ur,ur,ur,ur,ur,ur,ug,ug,ug,ug,ug,ug,ug,ug
ur,ur,ur,ur,ug,ub,ug,ub,ub,cg,ur,ur,ur,ur,ur,ux,ur,ug,ux,ux,ug,ug,ug
ur,ur,ur,ux,ur,ur,ug,ug,ug,ug,ur,ur,ur,ur,ur,ug,ub,cb,ux,ug,ug,ug,ug
ur,ur,ux,ur,ur,ur,ur,ur,ug,ug,cr,ub,ub,ub,ub,ub,ub,ug,ug,ug,ug,ug,ug
ur,ur,ur,ur,ur,ur,ur,cg,ug,cr,ub,ub,ub,ub,ub,ub,ux,ug,ug,ug,ub,ub,ur
ur,ur,ur,ur,ur,ur,ur,ur,ur,ur,ux,ug,ux,ug,ug,ug,ug,ug,ug,cg,ux,ug,ug
ur,ur,ur,ur,ur,ur,ur,ux,ux,ux,ux,ug,ub,ub,ub,ug,ub,ug,ug,ug,ug,ug,ug
cg,ux,ux,ux,ub,ug,ug,ux,ux,ux,ub,ug,ub,ub,ub,ug,ub,ug,ug,ux,ug,ug,ug
ux,ux,ux,ux,ux,ug,ug,ux,ux,ux,ub,ug,ub,ub,ub,ug,ug,ug,ug,ug,ug,ug,ug
ur,ur,ur,ur,ur,ur,ur,ur,ur,ur,ur,ur,ur,ur,cg,ug,ug,ur,ur,ur,ug,ug,ug
ur,ux,ux,ux,ux,ug,ug,ux,ux,ub,ub,ub,ub,ub,ub,ux,ug,ug,ug,ug,ug,ug,ug
ur,ur,ur,ur,ur,cb,ub,ur,ur,ur,ur,ur,ur,ur,ur,ur,ur,ur,ur,ur,cr,ug,ug
cg,ux,ux,ux,ux,ug,ub,ub,ub,ub,ug,ux,ug,ug,ux,ug,ux,ug,ux,ux,ux,ug,ug
ux,ux,ux,ux,ux,ug,ub,ub,ub,ub,ug,ub,ug,ug,ug,ug,ug,ug,ug,ug,ug,ug,ug
ux,ux,ux,ub,ub,ub,ub,ub,ub,ub,ub,ub,ub,ub,ub,ub,ub,ux,ux,ux,ux,ug,ux
ur,ux,ux,ub,ub,ub,ub,ub,ub,ub,ug,ug,ug,ug,ug,ug,ug,ug,ug,ug,ug,ug,ux
cr,ux,ux,ub,ub,ub,ub,ub,ub,ub,ux,ux,ux,ux,ux,ux,ux,ux,ux,ux,ux,cb,cr
cg,ux,ux,ub,ub,ug,ub,ub,ub,ub,ux,ux,ux,cb,ux,ux,ux,ux,ux,ux,cb,ux,cr