ux,ux,cb,ur,ur,ur,ur,ux,ur,ur,ur,ur,ur,ur,ur,ur,ur,ur,ur,cg,ur,ur,ur
ux,ur,ur,ur,ur,ur,ur,ur,ur,ur,ur,ur,ur,ur,ur,ur,ur,ur,ur,ug,ur,ur,ur
ux,ur,ur,ur,ur,ur,cr,ur,ur,ur,ur,ur,ur,ur,ug,ur,ur,ur,ur,ug,ur,ur,ur
ux,ur,ur,ur,ur,ur,cr,cr,ur,ur,ur,ug,ug,ur,ur,ur,ur,ub,ur,cr,ur,ur,ur
ux,ur,ur,ug,ur,ur,ur,ur,ug,ug,cg,ur,ur,ur,ur,ur,ur,ur,ur,ug,ur,ur,ur
ur,ur,ur,ug,ur,ur,ur,ur,ur,ur,ur,ur,ur,ur,ur,ur,ur,ur,ur,ug,ur,cb,ub
ur,ur,ur,ur,ur,ur,ur,ur,ur,ur,ur,ur,cr,ur,ur,ug,ug,ub,ub,ug,ug,ub,ux
ux,ux,ur,ur,ur,ug,ux,ux,ux,ug,ux,ug,ug,ug,ug,ub,ug,ug,ux,ug,ux,ub,ub
ux,ux,ur,ug,ub,ub,ub,ub,ub,ub,ub,ub,ub,cb,ur,ur,ur,cr,ux,ug,ux,ur,ub
ux,ux,ur,ug,ub,ug,ux,ug,ug,ug,ug,ug,ux,ug,ux,cg,ug,ub,ux,ug,ug,ub,ub
ux,ux,ur,ug,ub,ug,ux,ug,ux,ug,ux,ux,ux,ug,ug,ug,ug,ub,ux,ug,ug,ub,cb
ux,ux,ur,ug,ub,ub,ub,ub,ux,ub,ug,ux,ug,ug,ug,ug,ug,ub,ux,ug,ug,ub,ur
ux,ux,ur,ub,ur,ug,ug,ug,ug,ug,ug,ub,ug,ub,cb,ug,ug,ub,ux,ug,ug,ub,ub
ux,ux,ur,ub,ub,ub,ub,ug,ub,ub,ub,ub,ub,ub,ug,ug,ug,ub,ux,ug,ug,ug,ub
ux,ux,ub,ub,ur,ug,ub,ug,ub,ug,cg,ub,ub,ub,ux,ux,ug,ub,ux,ug,ug,ug,ub
cg,ug,ug,ug,cg,ug,ux,ub,ub,ug,ug,ug,ug,ug,ug,ux,ug,ub,ux,ug,ug,ug,ub
ub,ug,ub,ug,ub,ug,ux,ug,ub,ug,ux,ux,ub,ux,ug,ug,ug,ub,ux,ug,ug,ug,ub
ub,ug,ub,ug,ug,ug,ub,ug,ug,ug,ug,ug,ug,ur,ur,ur,ur,ub,ur,ug,ur,ur,ub
ub,ug,ug,ug,ug,ug,ur,ur,ug,ur,ug,ur,ug,ub,ur,ub,ur,ub,ub,ug,ur,ur,ub
ub,ub,ub,ub,ub,ug,ug,ug,ug,ux,ug,ug,ub,ub,ub,ub,ub,ub,ub,ub,ub,ub,ub
cr,ub,ub,ub,cg,ug,ub,ug,ux,ux,ux,ub,ub,ux,ub,ux,ub,ux,ub,ug,ur,ur,ur
cg,ux,ug,ub,ub,cb,ub,ug,ux,ux,ub,ub,ux,ux,ux,ux,ux,ux,cb,ug,ur,cb,cr
cr,ux,ux,ub,ub,ub,ub,ux,ux,ux,ux,ub,ub,ux,ux,ux,ux,ux,ux,ug,cb,ux,cr