ur,ur,ur,ur,ur,ur,ur,ur,ur,ur,ur,ur,ur,ur,ur,ur,ur,cb,ur,ur,ur,ur,ur
ur,ur,cb,ur,ur,ur,ur,ur,ur,ur,ur,ur,ur,ur,ur,ur,ur,ux,ur,ur,ur,ur,ur
ur,ur,ub,ub,ur,ur,cr,ur,ur,ur,ur,ur,ur,ur,ur,ur,ur,ug,ug,ug,ug,ug,ur
ur,ur,ur,ub,ub,cr,cg,ur,cr,ur,ur,ur,ur,ub,ug,ug,ug,ug,ug,ug,ug,ug,ur
ur,ur,ur,ur,ub,ub,ur,cr,ug,ub,ux,ug,ug,ub,cg,ur,ug,ur,ur,ug,ug,ug,ur
ur,ug,ur,ur,ur,ug,ur,ug,ug,ub,ux,ug,ug,ug,ub,ub,ug,ub,ur,ug,ug,ug,ur
ur,ug,ug,ur,ur,ur,ug,ug,ug,ub,ur,ug,ux,ux,ub,ub,ug,ug,ug,ug,ug,ug,ur
cr,ur,ug,ug,ux,ub,ug,ub,ub,ub,ux,ug,ux,ux,ub,ug,ug,ug,ug,ur,ug,ug,ur
ux,ur,ub,ug,ug,ub,ug,ug,ug,ug,ux,ug,ux,ub,ub,ug,ub,ub,ug,ug,ug,ug,ug
ux,ux,ub,ub,ug,ug,ug,ux,ug,ug,ux,ug,ub,ub,ub,ug,ub,ug,ux,ug,ux,ux,ug
ux,ux,ub,ub,ub,ub,ux,ux,ux,ux,ub,ub,ub,ub,ub,ub,ub,ub,ux,ug,ug,ux,ug
ux,ux,ub,ub,ub,ub,ux,ux,ux,ug,ug,ub,ub,ub,ub,ub,ub,ub,ux,ub,ug,ux,ug
ux,ux,ub,ub,ub,ub,ux,ub,ub,ug,cb,ub,ub,ub,ub,ub,ub,ub,ux,ub,ug,ug,ug
ux,ux,ub,ub,ub,ub,ux,ux,ux,ux,cb,ug,ub,ub,ub,ub,ub,cb,ux,ub,ux,ug,ug
cg,ux,ub,ub,ub,ub,ux,ux,ux,ux,ub,ub,ug,cg,ub,ub,ux,ug,ux,ub,ux,ug,ug
ur,ur,ur,ur,ur,ur,ur,ur,ur,ur,ub,ug,ug,ur,ur,ur,ub,ub,ub,ub,ux,ug,ug
ur,ux,ub,ub,ux,ux,ug,ux,ux,ux,ub,ub,ux,ug,ub,ub,cb,ur,ub,ub,ux,ug,ug
ur,ux,ub,cg,ux,ux,ug,ug,ug,ug,ub,ub,ub,ub,ub,ub,ub,ur,ub,ub,ux,ug,ug
ur,ux,ub,ug,ux,ux,ux,ux,ux,ux,ub,ub,ug,ug,ug,ub,ub,cr,ub,ux,ux,ug,ug
ur,ux,ub,ug,ux,ux,ux,ux,ux,ub,ub,ub,ub,ux,ux,ub,ub,ub,ub,ub,ux,ug,ug
ur,ur,ur,ug,ug,ug,ug,ug,ug,ug,cb,ub,ub,ub,ub,ub,ub,ub,ub,ug,ug,ug,ug
cr,ux,ub,ub,ux,ux,ux,ug,ux,ux,ub,ub,ub,ux,ux,ux,ux,ux,ub,ux,ux,ux,cb
cg,ux,ub,ub,ug,ug,ug,ug,ux,cg,ub,ux,ux,ux,ux,ux,ux,ux,ub,ub,ub,ub,ub