ur,ur,ur,ur,ur,cg,ug,ug,ug,cg,ub,ub,ur,ur,ub,ub,ur,cb,ub,ub,ub,ub,ub
ur,ur,ur,ur,ur,ur,ug,ug,ub,ub,ub,ub,ur,ub,ub,ub,ur,ub,ub,ug,ub,ub,ub
ur,ur,ur,cr,ur,ur,cr,ur,ub,ur,ur,ub,ub,ub,ur,ub,ub,ub,ug,ub,ub,ub,ub
ur,ur,ur,ur,ur,ug,ur,cb,ub,ur,ur,ub,ur,ub,ub,ug,ug,ug,ug,ub,ub,ub,ub
ub,cr,ur,ur,ur,ug,ub,ub,ug,ub,ur,ur,ur,cb,ub,ux,ur,ur,ux,ub,ub,ub,ub
ub,cr,ub,ur,ur,ug,ug,ug,ug,ub,ux,ux,ub,ub,ub,ux,ux,ug,ug,cg,ub,ub,ux
ur,ur,cb,ug,cg,ur,ub,ub,ub,ub,ub,ub,ub,ug,ub,ug,ug,ug,ug,ug,ub,ub,ux
ur,ur,ur,ur,ub,ux,ub,ub,ub,ug,ug,ug,ug,ub,ub,ux,ux,ux,ug,ug,ub,ub,ux
ux,ux,ur,ur,ug,ug,ug,ug,ub,ug,cg,ug,ug,ug,ub,ub,ub,ub,ub,ug,ub,ub,ux
ux,ux,ur,ur,ur,ux,ux,ux,ug,ug,ug,ug,ug,ux,ub,ub,ub,ub,ub,ug,ub,ub,ux
ux,ux,ur,ug,ur,ur,ux,ux,ug,ug,ub,ug,ub,ub,ub,ub,ub,ug,ug,ug,ub,ub,ux
ux,ux,ur,ur,ur,ub,ub,ug,ug,ug,ub,ug,ub,ub,ug,ug,ug,ug,ub,ub,ub,ug,ux
ux,ux,ux,cr,ur,ub,ub,ug,ug,ug,ug,ug,ub,ub,ub,ub,ug,ug,ug,ub,ub,ub,cg
ux,ux,ux,ug,ug,ug,ug,ug,ug,ug,ug,ug,ub,cb,cb,ub,ug,ug,ug,ub,ux,ug,ux
ux,ux,ux,ux,ux,ug,ug,ur,ur,ur,ur,ur,ur,ur,ub,ub,ur,ur,ur,cr,ug,ug,ux
ux,ub,ub,ub,ub,ub,ub,ur,ub,ub,ub,ux,ux,ux,ug,ug,ug,ug,ug,ux,ur,ur,ur
ux,ux,ux,ux,ux,ub,ub,ur,ub,ub,ub,ug,ug,ug,ug,ug,ub,ux,ux,ux,ur,ur,ur
cg,ur,ur,ur,ur,ur,ur,ur,ur,ub,ub,ug,ug,ug,ug,ur,ur,ur,ur,ur,ur,ux,ux
ux,ur,ux,ux,ux,ug,ur,ux,ug,ub,ug,ug,ux,ux,ux,ug,ux,ux,ux,ux,ur,ux,ux
ux,ur,ux,ub,ux,ub,ub,ub,ux,ux,ub,ub,ug,ug,ug,ug,ux,ux,ux,ux,ur,ux,ux
ux,ur,ub,ub,cb,ub,ur,ub,ub,ub,ub,ux,ux,ux,ux,ux,ux,ux,ux,ux,ur,ux,ux
cr,ur,ub,ub,ub,ub,ub,ub,ub,ub,ux,ux,ux,ux,ux,ux,ux,ux,ux,ux,ur,ux,cb
cg,ur,ur,ur,ub,ub,ub,ub,ub,ub,ur,ur,ur,ur,ur,ur,ur,ur,ur,ur,ur,ur,ur