ur,cb,cb,cr,ur,ur,ur,ur,ur,ur,ur,ur,ur,ur,ur,ur,ur,ur,ub,cr,ur,ur,cb
ur,cb,cb,ur,ur,ur,ur,ur,ur,ur,ur,ur,ur,ur,ur,ur,ur,ur,ub,ur,ur,ur,ur
ur,ur,ur,ur,ur,ur,ur,ur,ur,ur,ur,ur,ur,ur,ur,ur,ur,ur,ub,cb,ur,ur,ur
ub,ux,ub,ub,ux,ux,ux,cr,ur,ur,ur,ur,ur,cr,ur,ur,ur,ur,ur,ur,ur,ur,ur
ub,ux,ub,ub,ur,ur,ur,ur,ur,ur,ur,ur,ur,ug,cg,ur,cr,ug,ug,ur,ur,ur,ur
ub,ux,ux,ux,ur,ur,ur,ur,ux,ux,ux,ur,ur,ur,ur,ur,ur,ur,ug,ug,ur,ur,ur
ub,ub,ub,ur,ur,ur,ur,ur,ur,ur,ur,ur,ur,ug,ug,ug,ug,ug,ur,ug,ur,ur,ur
cb,ux,ub,ur,ur,ux,cb,ub,ub,ux,ug,ug,ug,ug,ug,ug,ux,ux,ux,ug,ub,ux,ux
ux,ur,ub,ug,ur,ur,cr,ur,ub,ug,ug,ug,ug,ug,ug,ug,ug,ux,ux,ug,ub,ub,ub
ux,cb,ub,ur,ur,ur,ur,ur,ug,ug,ub,ug,ug,ug,ug,ug,ug,ux,ux,ug,ux,ux,ub
ur,ub,ub,ur,ur,ur,ur,cb,cg,ub,ub,ug,ux,ux,ug,ug,ug,ux,ux,ug,cg,ux,ub
ur,ub,ub,ur,ur,ur,ug,ub,ub,ub,ub,cg,ug,ug,ug,ug,ug,ux,ux,ux,ux,ux,ux
cb,ub,ub,ur,ur,ur,ur,ub,ub,ur,ur,ur,ur,ur,ur,ur,ur,ur,ur,cr,ux,ux,ux
ub,ub,ub,ub,ub,ub,ub,ub,ub,ub,ub,ub,ub,ug,ug,ug,ug,ug,ug,ux,ux,ux,ux
ub,ub,ub,ub,ug,ug,ux,ub,ub,ub,ub,ub,ub,ub,ug,ug,ug,ug,ug,ux,ux,ux,ux
cg,ug,ug,ub,ux,ux,ug,ug,ug,ub,ub,cb,ub,ub,ug,ug,ug,ug,ug,ux,ux,ux,ux
ux,ug,ug,ub,ug,ug,ug,ug,ug,ug,ug,ub,ub,ub,ub,ub,ug,ug,ug,ux,ux,ux,ux
ux,ug,ug,cg,ug,ug,ug,ug,ux,ux,ug,ug,ux,ux,ub,ux,ub,ug,ug,ub,ub,ub,ub
ux,ug,ug,ug,ug,ux,ug,ug,ux,ux,ub,ux,ux,ux,ub,ux,ug,ug,ux,ux,ux,ux,ub
ux,ug,ug,ug,ug,ux,ug,ug,ug,ug,ug,ug,ug,ug,ug,ug,ug,ux,ub,ub,ub,ub,ub
cr,ug,ug,ug,ug,ug,ug,ug,ug,ug,ug,ux,ux,ux,ux,ux,ux,ux,ub,ux,ux,ux,cr
cg,ug,ug,ug,ug,ug,ug,ug,ug,ug,ug,ub,ub,ub,ub,ub,ub,ub,ub,cb,cb,ux,cr
cr,cg,cg,cb,ug,ug,ug,ug,ug,ux,ux,ux,ux,ux,ux,cg,ur,ur,ur,cg,cg,ux,cr