ur,cb,ur,ur,ur,ur,ur,ur,ur,ur,ur,ur,ur,ur,ur,ur,ur,ur,ur,ur,ur,ur,cr
ur,ub,ub,ur,ur,ur,ur,ur,ur,ur,ur,ur,ur,ur,ur,ur,ur,ur,ur,ur,ur,ur,ub
ur,ur,ub,ub,ur,ur,ur,ur,ur,ur,ur,ur,ur,ur,cg,ug,ug,ug,ur,ur,ur,ur,ub
ux,ur,ur,cr,ur,ug,ur,ug,ug,ug,ug,ug,cr,ur,ur,ur,ug,ug,ur,ur,ur,ur,ub
ux,ur,ur,ur,ur,ub,ur,ub,ur,ug,ug,ug,ur,ur,ur,ur,ur,ur,ur,ur,ur,ur,ub
ur,ur,ur,ur,ur,ug,ur,ub,ub,ub,ub,ur,ur,ur,ur,ur,ur,ur,ur,cg,cr,ur,ub
ur,ur,ur,ur,ug,ug,ur,ur,ur,cr,ug,ug,ug,ug,ug,ug,ug,ug,ug,ug,ur,ur,ub
ur,ur,ur,ur,ur,ur,ur,ur,ur,ur,ub,ub,ub,ub,ub,ub,ub,ub,ub,ur,ur,ur,ub
cg,ur,ur,ur,ur,ur,ur,ur,ub,ub,ur,ur,ub,ub,ug,ur,ur,ur,ur,ur,cb,ub,ub
cb,ub,ub,ub,ub,cb,ub,ub,ub,ub,cb,ub,ub,ub,ug,ur,ux,ux,ug,ux,ux,ux,ux
ur,ur,cr,ub,ub,ub,ub,ub,ub,ub,ub,ub,ub,ub,ug,ug,ug,ug,ug,ux,ux,ux,ux
ux,ug,ub,ub,ub,ub,ub,ub,ub,ub,ub,ub,ub,ug,ug,ug,ug,ug,ug,ug,ug,ux,ux
ux,ub,ub,cb,ub,ux,ux,ux,ug,ub,ub,ub,ub,ub,ub,ug,ug,ug,ug,ug,ug,ux,ux
ux,ub,ub,ub,ux,ux,ux,ux,ug,ux,ur,ub,ub,ux,ub,ug,ug,ug,ug,ug,ux,ux,ux
cg,ub,ub,ub,ux,ux,ux,ux,ug,ux,ur,ux,ux,ux,ug,ug,ug,ub,ux,ug,ux,ux,ux
ub,ub,ux,ux,ux,ux,ux,ux,ug,ux,ur,ux,ux,ux,ux,cg,ug,ug,ug,ug,ux,ux,ux
ux,ug,ux,ux,ux,ux,ux,ux,ug,ux,ur,ux,ux,ux,ux,ux,ub,ub,ux,ux,ux,ux,ux
ux,ug,ux,ux,ux,ux,ux,ux,ug,ux,ur,ux,ux,ux,ux,ux,ux,ux,ux,ux,ux,ux,ux
ux,ug,ux,ux,ux,ux,ux,ux,ug,ux,ur,ux,ux,ux,ux,ux,ux,ux,ux,ux,ux,ux,ux
ux,ug,ux,ux,ux,ux,ux,ux,ug,ux,ur,ux,ux,ux,ux,ux,ux,ux,ux,ux,ux,ux,ux
ux,ug,ux,ux,ux,ux,ux,ux,ug,ux,ur,ux,ux,ux,ux,ux,ux,ux,ux,ux,ux,ux,ux
ux,ug,ux,ux,ux,ux,ux,ux,ug,ux,ur,ux,ux,ux,ux,ux,ur,ur,ur,ur,ur,ur,cb
ux,ug,ug,ug,ug,ug,ug,ug,ug,cg,ur,ur,ur,ur,ur,ur,ur,ur,ur,ur,ur,ur,ur