ur,ur,ur,ur,ur,ur,ur,ur,ur,ur,ur,ur,ur,ur,ur,ur,ur,ur,ur,ur,ug,cr,cb
ur,ur,ur,ur,ur,ur,ur,ur,ur,ux,ur,ur,ur,ur,ur,ur,ur,ur,ur,ur,ur,ur,ux
ur,ur,ur,ur,ur,ur,ur,ur,ub,ub,ub,ub,cb,cr,ur,ur,ur,ur,ur,ur,ur,ur,cr
ur,ur,ur,ug,ur,cr,ug,ug,ub,ug,ur,ur,ur,ur,ur,ur,ur,ub,ub,ug,ux,ug,ux
ur,ur,ur,ug,ub,ur,ur,ub,ub,ur,ur,ur,ub,cr,ub,ug,ug,ug,ub,ug,ug,ug,ux
ur,ur,ur,ug,cg,ub,ur,ub,ub,ub,ub,ug,ug,ug,ux,ug,ub,ug,ug,ug,ug,ug,ux
ur,ur,ur,ug,ux,ug,ug,ug,ug,ug,ug,ug,ug,ub,ub,ug,cg,ug,ug,ux,ug,ux,ux
ux,ur,ur,ub,ug,ug,ux,ux,ub,ug,ug,ur,ug,ub,ux,ug,ug,ug,ug,ug,ug,ux,ux
cg,ur,ux,ub,ug,ug,ug,ug,ub,ug,ub,ub,ug,ub,ub,ug,ug,ug,ux,ug,ug,ux,ux
ur,ur,ux,ub,ug,ug,ug,ug,ur,ug,ug,ub,ug,ug,ug,ug,ub,ub,ug,ug,ug,ux,ux
ur,ux,ux,ub,ug,ux,ug,ug,ur,ug,ug,ub,ub,ug,ub,ug,ug,ub,ug,ux,ug,ug,ug
ur,ur,ur,ub,ug,ux,ug,ug,ur,ug,ug,ur,ug,ug,ux,ug,ug,ub,ug,cb,ug,ux,ug
ur,ur,ur,ub,ug,ur,ug,ug,ug,ug,ub,ur,ug,ug,ub,ub,cb,ux,ux,ub,ub,ug,ug
ur,ur,ur,ub,ug,ub,ug,ug,ug,ub,ub,ug,cb,ub,ub,ub,ub,ux,ux,ux,ub,ug,ug
ur,ur,ur,ub,ug,ub,ug,ug,ug,ub,ub,ug,ub,ub,ub,ub,ub,ub,ub,ux,ub,ug,ug
ur,ur,ux,ub,ug,ub,ug,ug,ug,ug,ug,ug,ub,ub,ub,ug,ug,ub,ub,ub,ub,ug,ug
ur,ur,ur,ub,ug,ur,ug,ur,ub,ub,ub,ub,ub,ub,ur,ug,ur,ub,ub,ub,ub,ub,ur
cb,ux,ux,ub,ug,ux,ug,ug,cg,ux,ux,ub,ub,ub,ug,ug,ug,ug,ub,ub,ug,ub,ur
ub,ur,ur,ur,ur,ur,ur,ur,ur,ur,ur,ur,ur,ur,ur,ur,ur,ur,ur,ur,ur,ub,ub
ub,cr,ux,ub,ux,ux,ux,ux,ux,ux,ug,ug,ug,ux,ux,ug,ug,ug,ug,ug,ub,ux,ub
ub,ux,ub,ub,ux,ux,ux,ux,ux,ux,ux,ur,ux,ux,ux,ux,ux,ux,ux,ux,ub,ux,ux
ub,ub,ub,ux,ux,ux,ux,ux,ux,ux,ux,ur,ux,ux,ux,ux,ux,ux,ux,ux,ub,ub,ux
ub,ub,ur,ur,ur,ur,ur,ur,ur,ur,ur,ur,ux,ux,ux,ux,ux,ux,ux,ux,ux,ux,ux