ur,ur,ur,ur,ur,ur,ur,ur,ur,ur,ur,ur,ur,ur,ur,cr,ub,ub,cb,ur,ur,ur,ur
ur,ur,ur,ur,ur,ur,ur,ur,ur,ur,ur,ur,ur,ur,ur,ur,ur,ur,ur,ur,ur,ur,ur
ur,ur,ur,ur,ur,ur,ur,ur,ur,ur,ur,ur,ur,ur,ur,ur,cb,ub,cr,ur,ur,cb,ub
ub,cr,ur,ur,ur,ux,ux,ux,ux,ux,ux,ur,ur,ur,ur,ur,ur,ur,ur,ur,ur,ur,ub
ux,ub,ub,ub,ur,ur,ux,ux,ux,ux,ux,ux,ur,ur,ur,ur,ur,ur,ur,ur,ur,ur,ub
ur,ub,ub,ub,ur,ur,ug,ug,ug,ug,ug,ug,ug,ug,cr,ug,ur,ur,ur,ur,ur,ur,ub
ux,ug,ub,ug,ug,ur,ur,ur,ur,ur,ur,ur,ur,ug,ug,ux,ux,ur,ur,ur,ub,ub,ub
ux,ug,ug,ug,ub,ur,ug,ug,cg,ur,ur,ur,ug,ug,ug,cr,ur,ug,ug,ur,ub,ur,cb
cg,ub,ub,ub,ub,ur,ug,ug,ug,ug,ug,ug,ug,ug,ur,ur,ux,ux,ug,ur,ur,ur,ur
ub,ub,ux,ux,ug,ur,ur,ur,ur,ur,ug,ug,ug,ug,ug,ur,ur,ur,ug,ur,ur,ur,ur
ub,ux,ux,ux,ub,ur,ur,ur,ur,ug,ug,ug,ub,ub,ub,ur,ur,cg,ug,ur,ur,ur,ur
ub,ux,ux,ux,ub,ug,ub,ug,ur,ub,ug,ur,ub,ub,ug,ug,ug,ug,ug,ur,ur,ur,ub
ub,ux,ux,ug,ug,ug,ug,ug,ur,ub,ub,ub,ub,ub,ug,ug,ug,ug,ur,ur,ur,ur,ur
ub,ub,ub,ub,ub,ug,ub,ug,ub,ub,ug,ub,ub,ub,ub,ub,ur,ur,ur,ur,ur,ur,ur
cg,ux,ux,ux,ub,ub,ux,ug,ub,ub,ug,cb,ub,ub,ux,ux,ur,ur,ur,ur,ur,ur,ur
cr,ux,ux,ux,ux,ub,ux,ug,ub,ub,ug,ux,ux,ub,ux,ux,ux,ux,ux,ux,ux,ug,ur
ur,ux,ux,ux,ux,ub,ux,ug,ur,ux,ug,ux,cb,ub,ux,ux,ux,ux,ux,ux,ux,ug,ur
ur,ux,ux,ux,ux,ub,ux,ug,ur,ux,ug,ux,ux,ux,ux,ux,ux,ux,ux,ux,ux,ug,ur
ur,ux,ux,ux,ux,ub,ub,ug,ur,ub,ug,ux,ux,ux,ux,ux,ux,ux,ux,ux,ux,ug,ur
ur,ux,ux,ux,ux,ux,ux,ug,ur,ux,ug,ux,ub,ub,ub,ux,ux,ux,ux,ux,ux,ug,ur
ur,ux,ux,ux,ux,ux,ux,ug,ur,ux,ug,ux,ub,ux,ub,ux,ux,ux,ux,ux,ux,ug,ur
ur,ux,ux,ux,ux,ux,ux,ug,ur,ux,ug,ub,ub,ux,ub,ux,ux,ux,ux,ux,ux,ug,ur
ur,ur,ur,ur,cg,ug,ug,ug,ur,cg,ug,ug,ug,ug,ug,ug,ug,ug,ug,ug,ug,ug,ux