ux,ur,ur,ur,ur,ur,ur,ur,ur,ur,ur,ur,ur,ur,ur,cb,ub,ur,ur,ur,ur,ur,ur
ux,ur,ur,cb,ub,ur,ur,ur,ur,ur,ur,ur,ur,ur,ur,ur,ub,ur,ur,ur,ur,ur,ur
ur,ur,cr,ub,ub,ur,ux,ux,ux,ur,ur,ur,ur,ur,ur,ur,ub,cr,ur,ur,ur,ur,ur
ur,ur,ur,ur,ur,ur,ur,ur,ur,ur,ur,ur,ur,ur,ur,ur,ur,ur,ur,ur,ur,ur,ur
ur,ur,ur,ur,ur,ux,ur,ur,ur,ur,ur,ur,ur,ur,ur,ur,ur,ur,ur,ur,cr,ur,ur
ur,ur,ur,ur,ur,ur,ur,ur,ur,ur,ur,ur,ur,ur,ur,ur,ux,ux,ux,ux,ux,ur,ur
ux,ur,ur,ur,ur,ur,ur,ur,ur,ur,ur,ur,ug,ux,ux,ux,ux,ux,ux,ux,ux,ur,ur
ur,ur,ur,ur,ur,ur,ur,ur,ur,ur,ur,ur,ug,ub,ux,ux,ux,ux,ux,ux,ux,ur,ur
ur,ur,ur,ur,ur,ur,ur,ur,ur,ur,ug,ub,ub,ub,ub,ux,ux,ux,ux,ux,ux,ur,ur
cb,ub,ur,ur,ur,ur,ur,ur,ur,ur,ug,ub,ub,cb,ub,ub,ux,ux,ux,ux,ux,ur,ur
cg,ub,ur,ur,ur,ur,ur,ur,ur,ur,ug,ub,ub,ub,ub,ub,ux,ux,ux,ux,ux,ur,ur
ur,cr,ur,ur,ur,ur,ur,ur,ur,ur,cr,ub,ub,ub,ub,ub,ub,ux,ux,ux,cr,ur,ur
ur,ur,ur,ur,ur,ur,ug,ub,ub,ug,ub,ub,ub,ub,ub,cb,ub,ux,ux,ux,ur,ux,ux
ur,ur,ur,ur,ur,ur,ug,ur,ug,ux,ub,ub,ub,ub,ub,ux,ux,ux,ux,ux,ur,ux,ux
ur,ur,ur,ur,ug,ur,ug,cg,ug,ug,ub,ub,ub,ub,ux,ux,ux,ux,ux,ux,ur,ux,ux
ur,ur,ur,ux,ur,ux,ug,ug,ur,ux,ux,ux,ux,ux,ux,ux,ux,ux,ux,ux,ur,ux,ux
ub,ub,ug,ux,ur,ux,ux,ux,ur,ux,ux,ux,ux,ux,ux,ux,ux,ux,ux,ux,ur,ux,ux
ub,ur,ug,ub,ub,ub,ub,ub,ub,ub,ub,ub,ub,ub,ub,ub,ub,ub,ub,ub,ub,ub,ub
ub,ur,ug,ur,ub,ub,ub,ub,ub,ub,ub,ub,ub,ub,ub,ub,ub,ub,ub,ux,ur,ux,ub
ub,ux,ug,ux,ux,ux,ux,ux,ur,ux,ux,ux,ux,ux,ux,ux,ux,ux,ub,ub,ur,ur,ub
ub,ux,ug,ug,ug,ug,ug,ug,ug,ug,cg,ux,ux,ux,ux,ux,ux,ux,ux,ub,ub,ub,ub
ub,ub,ub,ux,ux,ux,ux,ux,ur,ux,ux,ux,ux,ux,ux,ux,ur,ur,ur,ur,ur,ur,ux
ub,ub,ux,ux,ux,ux,ux,cg,ur,ur,ur,ur,ur,ur,ur,ur,ur,ur,ur,ur,ur,cb,ux