cb,ub,cb,ur,ur,ur,ur,ur,ur,ur,ur,ur,ur,ur,ub,ur,ur,ur,ur,ur,ur,ur,ur
ur,ur,ur,ur,ur,ur,ur,ur,ur,ur,ur,ur,ur,ur,ur,ur,ur,ur,ur,cr,ur,cr,cg
cr,ur,ur,ur,ur,ur,ur,ur,ur,ug,ug,ug,ug,ur,ub,ur,ur,ur,ur,ug,ur,ur,ur
ur,ur,ur,ur,ur,ur,ur,ur,ur,ug,ur,ur,ur,ur,ub,ug,ur,ur,ur,ub,ub,ub,ur
ub,cb,ur,ur,cr,ur,ux,ur,ug,ug,ur,ur,ug,ub,ub,ug,ug,ur,ub,ub,ub,ub,ub
ub,ub,ub,ur,ur,ur,ur,ur,ur,ur,ug,ug,ug,ug,ug,ur,ug,ur,ub,ub,ub,ub,ub
ub,ub,ub,ub,ub,ux,ux,ug,ug,ug,ug,ug,ug,ug,ug,ug,cr,ur,cb,ux,ub,ub,ub
ub,ur,ux,ur,ub,ur,ur,ug,ug,ug,ug,ug,ug,ug,ug,ug,ub,ub,ub,ug,cb,ux,ux
ux,ur,ux,ur,ub,ur,ur,ug,ug,ug,ug,ug,ug,ug,ug,ug,ub,ub,ub,cg,ub,ub,ux
ux,ur,ur,ur,ub,ug,ug,ug,ug,ug,ug,ug,cg,ug,ug,ug,ub,ur,ug,ug,ug,ug,ug
ux,ux,ux,ux,ux,ux,ug,ug,ug,ug,ub,ug,ug,ug,ug,ug,ub,ub,ub,ub,ub,ub,cb
ux,ux,ug,ug,ug,ug,ug,ug,ux,ux,ug,ub,ub,ub,ub,ub,ub,ux,ug,ux,ux,ux,ug
ub,ux,ug,ug,ug,ug,ug,ug,ux,ux,ug,ub,ub,ub,ub,ub,ub,ub,ug,ux,ux,ux,ug
ux,ux,ug,ug,ug,ug,ug,ug,ux,ug,ug,ug,ug,cg,ub,ub,ub,ub,ub,ug,ug,ug,ug
ux,ux,ug,ug,ux,ug,ug,ug,ub,ug,ug,ug,ux,ug,ug,ub,cb,ub,ub,ux,ux,ug,ug
cg,ug,ug,ug,ux,ux,ug,ug,ux,ux,ug,ug,ux,ub,ub,ub,ux,ux,ug,ug,ug,ug,ug
ux,ug,ug,ug,ug,ug,ux,ug,ug,ug,ug,ux,ug,ug,ug,ub,ux,ug,ug,ug,ug,ug,ug
ug,ug,ug,ug,ug,ug,ug,ug,ug,ug,ug,ux,ug,ug,ux,ux,ux,ug,ux,ug,ug,ug,ug
ug,ug,ug,ug,ug,ux,ug,ug,ug,ug,ug,ug,ug,ug,ug,ug,ug,ug,ug,ug,ug,ug,ug
ug,ug,ug,ug,ug,ug,ug,ug,ug,ug,ug,ug,ux,ug,ug,ug,ug,ug,cr,ug,ug,ug,ug
cr,ur,ur,cg,ug,ug,ug,ug,ug,ug,ug,ug,ug,ug,ug,ug,ug,ug,ur,ug,ug,ug,ug
cg,ur,ug,ug,ug,ug,ug,ug,ug,ux,ux,ux,ux,ux,ub,ub,ub,ub,ur,ug,ub,cb,cr
cr,ur,ur,ur,ur,ur,ur,ur,ur,ur,ur,ur,ur,ur,ur,ur,ur,ur,ur,cg,cb,ux,cr