ur,ur,ur,ux,ux,ux,ux,ux,ux,ux,ux,ux,ux,ur,ur,ux,ux,ux,ux,ur,ur,ur,ur
ur,ur,ur,ur,ux,ur,ur,ur,ur,ur,ur,ur,ur,ur,ur,ur,ur,ur,ur,ur,ur,ur,ur
ur,ur,ur,ur,ur,ur,ur,ur,ur,ur,ur,ur,ur,ur,ur,ur,ur,ur,ur,ur,ur,ur,ur
ur,ur,ur,ug,ug,ur,ur,ur,ur,ur,ur,ur,ur,ur,ur,ur,ur,ur,ur,ur,ur,ur,ur
cr,ur,ur,cb,ug,ur,ur,ur,ur,ur,ur,cb,ur,ur,ur,ur,ur,cr,ug,ug,ur,ur,ur
ur,ur,ur,ub,ug,ur,ur,ur,ur,ur,ub,ub,ur,ur,ur,ur,ur,ur,ur,ug,cg,ur,ur
ur,ux,ur,ub,ug,ug,ur,ug,ug,ur,ub,cr,ur,ur,ur,ur,ur,ur,ur,ur,ur,ur,ur
ur,ur,ur,ub,ug,ug,ur,ug,ug,ur,ur,ur,ur,ur,ub,ur,ur,ur,ur,ur,ur,ur,ur
ux,ux,ur,ub,ur,ug,ur,ug,ug,ug,ug,ur,ur,ur,ur,ur,ur,ur,ur,ur,ur,ur,ur
ux,ux,ur,cg,ux,ug,ur,ug,ug,ug,ug,cb,ub,ub,ub,cr,ur,ub,cr,ur,ur,ur,ur
ux,ux,ur,ug,ux,ug,ux,ug,ug,ux,ux,ub,ub,ub,ub,ub,ug,ug,ux,ub,ur,ur,ur
ux,ux,ur,ug,ur,ug,ur,ug,ug,ur,ur,ur,ur,ub,ub,ub,ug,ub,ub,ux,ux,ub,ur
ur,ur,ur,ug,ug,ug,ur,ug,ug,ux,ug,ug,ur,ub,ub,ug,ug,ug,ub,ub,ub,cr,ur
ur,ur,ur,ub,ug,ug,ug,ug,ug,ug,ug,ub,ur,ug,ug,ug,ug,ug,ug,ub,ub,ur,ur
ur,ur,ur,ub,ug,ug,ug,ug,ug,ug,ub,ub,ur,ux,ug,ug,ug,ug,ug,ub,ub,ur,ur
ub,ub,ub,ub,ub,ub,cg,ur,ug,ug,ug,ug,ur,ux,ug,ug,ug,ug,ug,ug,ub,ur,ur
ub,ug,ux,ug,ux,ux,ux,ug,ug,ug,ux,ug,ur,ux,ux,ub,ug,ug,ug,ug,ub,ur,ur
ub,ug,ux,ug,ux,ux,ux,ug,ug,ug,ug,ux,ur,ux,ux,ub,ub,ub,ub,ub,ub,ur,ur
ub,ur,ur,ug,ur,ur,ux,ux,ub,ub,ub,ug,ur,ub,ub,ub,ux,ub,ub,ub,ub,ur,ur
ub,ug,ux,ug,ug,ux,ux,ux,ub,ub,ub,ux,ur,ub,ub,ub,ub,ub,ux,ub,ub,ur,ur
ub,ug,ux,ux,ug,ug,ug,cb,ub,ub,ub,ub,ub,ub,ub,ur,ur,ur,ur,ur,ur,ur,ur
ub,ub,ub,ub,ub,ub,ub,ub,ub,ur,ur,ur,ur,ur,ur,ur,ub,ur,ur,ur,ur,ur,ur
cb,ux,ux,ux,ux,ux,ux,ux,ub,ub,ub,ub,ub,ub,ub,ub,ub,ux,ux,ux,ux,cb,ur