ux,ur,cr,cr,ub,ur,ur,ur,ur,ur,ur,ur,ur,ur,ur,ur,ur,ur,ur,ur,ur,ur,ur
ur,ur,ur,ur,cb,ur,ur,ur,ux,ur,ur,ur,ur,ur,ur,ur,ur,ur,ux,ur,cr,ur,ur
ur,ur,ur,ur,ur,ur,cb,ur,ux,ur,ur,ur,ur,ur,ur,ur,ur,ur,ur,ur,ur,ur,ur
ur,ur,ur,ur,ur,cr,ub,ur,ur,ur,ur,ur,ur,ur,ur,ur,ur,ur,ur,ur,ur,ur,ur
ur,ur,ur,ur,ur,ur,ur,ur,ur,ur,ur,ur,ur,ur,ur,ur,ur,ur,ur,ur,ur,ur,ur
ur,ur,ur,ur,ur,ur,ur,ux,ur,ur,ur,ur,ur,ur,ur,ur,ur,ur,ur,ur,ur,ur,ur
ur,ub,ub,ub,ug,ug,ug,ug,ug,ur,ur,ub,cr,ur,ug,ug,cg,ub,cb,ur,ur,ur,ur
ur,ub,ub,ub,ug,ub,ub,ub,ug,ub,ub,ub,ub,ug,ug,ug,ub,ur,ur,ur,ur,ur,ux
cg,ub,ub,ur,ug,ub,ub,ub,ug,ub,ub,ub,ub,ug,ug,ug,ub,ur,ug,ug,ug,ux,ux
ur,ub,ub,ug,ug,ub,ub,ub,ug,ug,cb,ub,ug,ug,ug,ub,ub,ur,ug,ug,ug,ux,ux
ur,ub,ub,ug,ub,ub,ub,ub,ug,ub,ub,ub,ub,ur,ur,ur,ur,ur,ux,ux,ug,ux,ux
ux,ux,ug,ug,ub,ub,ub,ub,ug,ub,ug,ux,ux,ux,ug,ug,ur,ur,ux,ur,ug,ux,ux
ux,ub,ug,ub,ub,ub,ub,ug,ug,ub,ug,ug,ux,ux,ug,ug,ur,ur,ur,ur,ug,ux,ux
ux,ub,cg,ub,ub,ub,ub,ug,ug,ub,ub,ug,ux,ux,ug,ub,ur,ux,ux,ux,ug,ux,ux
cg,cb,ub,ub,ub,ub,ub,ux,ug,ub,ub,ug,ux,ug,ug,ug,ur,ug,ug,ux,ug,ux,ux
ub,ub,ub,ub,ux,ux,ug,ug,ug,ug,ug,ug,ug,ug,ug,ug,ur,ub,ug,ux,ug,ux,ux
ub,ub,ub,ux,ux,ub,ug,ub,ug,ux,ub,ug,ub,ub,ug,ug,ur,ug,ug,ux,ug,ux,ux
ux,ux,ub,ub,ub,ub,ug,ug,ug,ug,ug,ug,ug,ug,ug,ug,ur,ur,ur,ur,ur,ur,ur
ux,ux,ub,ub,ux,ux,ux,ux,ug,ug,ug,ug,ug,cg,ug,ux,ux,ug,ug,ug,ug,ux,ur
ur,ur,ug,ug,ug,ug,ug,ub,ub,ug,ug,ug,ug,ug,ug,ug,ug,ug,ub,ub,ub,ux,cr
ur,ug,ub,ub,ub,ub,ub,ub,ug,ux,ux,ub,ub,ug,ux,ux,ub,ub,ux,ub,ub,ux,ux
ur,ub,ub,ux,ux,ux,ux,ux,ug,ux,ux,ub,ux,ug,ug,ug,ub,ub,ur,ub,ub,ux,cb
cb,ub,ug,ug,ug,ug,ug,ug,ug,cg,ux,ux,ux,ux,ux,ux,ub,ub,ur,ub,ub,ux,ux