ux,ur,ur,ur,ur,ur,ur,ur,ur,ur,cr,ub,ub,cb,ur,cr,ub,ub,ub,ub,ub,ub,ux
ux,ur,ur,ur,ur,ur,ur,ur,ur,ur,ur,ur,ur,ur,ur,ur,ur,ur,ug,ug,ug,ug,ux
ux,ux,ux,ur,ur,ur,ur,ur,ur,ur,ur,ur,ur,ur,ur,ur,ur,ur,cr,ux,ur,ug,ub
ux,ug,cg,ur,ur,ur,ur,ur,ur,ur,ur,ur,ur,ur,ur,ur,ug,ug,ug,ux,ur,ug,ub
ur,ur,ug,ug,ug,ur,ur,ur,ur,ur,ur,ur,ur,ur,ur,ur,ur,ur,ux,ux,ur,ug,ub
ur,ur,ur,ur,ug,ug,ur,ur,ur,ur,ur,ur,ur,ur,ur,ur,ur,ur,ux,ux,ub,cg,ub
ur,cb,ur,ur,ur,ug,ur,ur,ub,cr,ur,ur,ux,ug,ug,ug,ug,ug,cb,ub,ub,ub,ub
ur,ub,cr,ur,ur,ug,ug,ug,ug,ub,ur,ub,ub,ug,ub,ub,ux,ux,ub,ub,ub,ub,ub
cg,ur,ur,ur,ug,ug,ug,ug,ub,ub,ub,ub,ub,ub,ub,ub,ux,ur,ub,ub,ub,ub,ub
ur,ur,ur,ur,ug,ux,ug,ug,ub,ub,ub,ub,ub,cg,ug,ug,ux,ub,ub,ub,ub,ub,ub
ur,ur,ur,ur,ug,ug,ug,ur,ur,ub,ub,ub,ub,ur,ug,ur,ub,ub,ub,ub,ub,ub,ub
ub,ub,ug,ur,ux,ux,ux,ug,ub,ug,ub,ub,ub,ug,ug,ug,ug,ug,ub,cb,ur,ur,ub
ub,ub,ug,ur,ub,ux,ub,ub,cb,ub,ub,ub,ub,ur,ug,ug,ug,ug,ur,ug,ur,ur,ub
ub,ub,ug,ur,ub,ux,ub,ub,cr,ub,ub,ub,ub,cb,ug,ug,ux,ug,ug,ug,ur,ur,ub
cg,ub,ug,ur,ub,ux,ub,ub,ur,ub,ub,ub,ub,ux,ux,ug,ux,ug,ug,ux,ur,ur,ub
ub,ub,ug,ur,ub,ug,ub,ub,ur,ub,ub,ub,ub,ug,ug,ug,ug,ug,ug,ux,ur,ur,ub
ub,ub,ub,ur,ub,ub,ub,ub,ur,ub,ub,ux,ux,ug,ug,ug,ug,ug,ug,ux,ur,ur,ub
ux,ux,ub,ur,ux,ub,ub,ub,ur,ub,ub,ub,ub,ug,ug,ug,ug,ug,ug,ux,ur,ur,ub
ux,ux,ux,ur,ux,ug,ux,ux,ur,ux,ux,ux,ub,ug,ux,ux,ug,ug,ur,ux,ur,ur,ub
ux,ux,ux,ur,ux,ug,ug,ug,ur,ug,ug,ug,ub,ux,ux,ux,ug,ug,ur,ur,ur,ur,ub
ux,ux,ux,ur,ux,ux,ux,ux,ur,ux,ux,ux,ub,ub,ub,ub,ub,ub,ub,ub,ub,ur,ub
ux,ux,ux,ur,ux,ux,ux,ux,ur,ux,ux,ux,ux,ux,ux,ur,ur,ur,ur,ur,ub,ub,ub
ux,ux,ux,ur,ur,ur,ur,ur,ur,cg,ux,ux,ux,ux,ux,ux,ux,ux,ux,ux,ux,ub,ub