ux,ux,ur,ur,ur,ur,ur,ur,ur,ur,ur,ur,ux,ux,ux,ux,ux,ux,ur,ur,ur,ur,ux
ux,ux,ux,ur,ur,ur,ur,ur,ux,ux,ux,ur,ux,ux,ux,ux,ur,ur,ur,ur,ur,ur,ur
ux,ur,ur,ur,ur,ur,ur,ur,ux,ux,ux,ur,ux,ux,ux,ux,ur,ub,cr,ub,ub,ub,ub
ux,ur,ur,ug,ur,ur,ur,ur,ux,ux,ux,ur,ux,ux,ux,ux,ur,cb,ur,ub,ub,ur,ub
ux,ur,ur,ug,ur,ur,ur,cr,cg,ug,ug,ur,cg,ux,ur,ux,ur,ur,ub,ub,ub,ub,ub
ur,ur,ux,ur,ur,ur,ur,ur,ug,ug,ug,ug,ug,ur,ur,ur,ur,ur,ur,ur,ub,ub,ub
ur,ur,ux,ur,ur,ur,ur,ug,ug,ur,ur,ur,ur,ur,ur,ur,ur,ur,ur,ur,ub,ub,ub
ur,ur,ur,ur,ur,ur,ur,cr,ug,ur,ur,ur,ur,ur,ur,ub,ub,ur,ur,ur,ub,ub,ub
cg,ur,ur,ur,ur,ur,ur,ur,ug,ur,ur,ur,ur,ur,ub,ub,ub,ub,ub,ub,ub,ub,ub
ur,ur,ur,ur,ur,ur,ur,ur,ug,ub,cr,ub,ur,ur,ub,ug,ub,ub,ub,ub,ub,ub,ub
ur,ur,ur,ur,ur,ur,ur,ub,cb,cb,ur,ur,ur,ub,ub,ub,ub,ub,ur,ur,ur,ur,ub
ur,ur,ur,ur,ur,ur,ur,cr,ug,ub,ub,ub,ub,ub,cb,ug,ug,ub,ub,ub,ub,ub,ub
ur,ur,ur,ur,ur,ur,ur,ur,ur,ur,ur,cr,ub,ub,cg,ug,ug,ub,ub,ux,ux,ux,ux
ur,ur,ur,ur,ur,ur,ur,ur,ub,ub,ux,ux,ub,ub,ub,ug,ux,ub,ub,ub,ub,ub,ub
cg,ur,ux,ux,ux,ux,ub,ub,cb,ub,ux,ux,ub,ux,ug,ug,ux,ub,ux,ux,ux,ub,ub
ug,ur,ug,ug,ug,ug,ub,ub,ub,ug,ug,ux,ub,ub,ub,ub,ub,ub,ux,ux,ux,ub,ub
ug,ur,ug,ug,ug,ug,ub,ub,ub,ub,ug,ux,ub,ub,ub,ub,ub,ub,ux,ux,ux,ux,ub
ug,ur,ug,ux,ug,ug,ub,ub,ub,ub,ub,ub,ub,ux,ug,ug,ug,ub,ux,ux,ux,ux,ub
ub,cb,ug,ug,ug,ug,ub,ub,ug,ux,ub,ub,ux,ux,ug,ug,ug,ub,ux,ux,ux,ux,ub
ub,ub,ug,ug,ug,ug,ub,ub,ug,ug,ug,ux,ux,ux,ux,ux,ux,ub,ux,ux,ux,ux,ub
ub,ub,ug,ug,ug,ug,ug,ur,ur,ug,ug,ug,ug,ug,ug,ux,ub,ub,ux,ux,ux,ux,ub
ub,ub,ub,ub,ub,ub,ub,ub,ub,ub,ub,ub,ux,ux,ux,ux,ub,ux,ux,ux,ux,ux,cb
ub,ub,ur,ur,ur,ur,ur,ur,ur,cg,ux,ub,ub,ub,ub,ub,ub,ux,ux,ux,ux,ux,ux