ur,ur,cb,ur,ur,ur,ur,ur,ur,cg,ug,ug,ug,ug,ug,ur,ur,ur,ur,cg,ug,ug,ug
ur,ur,ur,ur,cr,ur,ur,ur,ur,ub,ur,ur,ug,ur,ug,ur,ur,ur,ur,ur,ur,ug,ur
ur,ur,ur,ur,ux,ur,cr,ur,ub,ub,ur,ug,ug,ug,ug,ur,ur,ur,ur,ur,ur,ur,cr
ur,ur,ur,ur,ur,ur,ub,ub,cr,ur,ur,ug,ur,ur,ug,ur,ur,ur,ur,ub,ur,ug,ug
ur,ur,ur,ur,ur,ur,ub,ug,ur,ur,ur,ug,ur,ug,ug,ug,ug,ug,ub,ux,ur,ux,ug
ur,ur,ur,ur,ur,ur,ur,cr,ur,ur,ur,ug,ur,ug,ur,ug,ux,ug,ux,ux,ur,ux,ug
ur,ur,ur,ux,ux,ux,ub,ub,cb,ur,ur,ur,ug,ug,ur,ug,ux,ug,ux,ux,ur,ux,ug
ur,ur,ur,ur,ur,ur,ur,ur,ur,ur,ub,ub,ub,ub,ub,ug,ux,ug,ux,ux,ur,ux,ug
ur,ur,ur,ur,ur,ur,ur,ur,ur,ur,cb,ub,ub,ub,ub,ug,ub,ug,ub,ux,ur,ux,ug
ur,ur,ur,ur,ur,ur,ur,ur,ur,ur,ug,ub,ub,ub,ub,ug,ub,ug,ub,ux,ur,ux,ug
ur,ur,ur,ur,ur,ur,ur,ur,ug,ug,ug,ub,ub,ub,ub,ug,ug,ug,ub,ub,ur,ub,ub
ur,ur,ur,ur,ux,ux,ug,ug,ug,ub,ug,ug,ub,ub,ub,ug,ug,ug,ux,ug,ur,ug,ub
cg,ux,ux,ux,ux,ux,ug,ug,ug,ux,ug,ug,ub,cg,ug,ug,ug,ug,ub,ub,ur,ug,ub
ux,ux,ux,ux,ux,ux,ug,ux,ug,ug,ug,ub,cb,ug,ub,ug,ug,ug,ub,ub,ur,ug,ub
ux,ux,ux,ux,ux,ux,ug,ug,ug,ug,ub,ub,ub,ug,ub,ug,ug,ug,ub,ub,ur,ug,ub
ux,ux,ux,ux,ux,ux,ux,ux,ux,ug,ux,ub,ub,ug,ug,ub,cg,ug,ub,ub,ur,ug,ub
ux,ux,ug,ug,ug,ug,ug,ug,ug,ux,ux,ub,ub,ub,ug,ug,ug,ug,ug,ug,ur,ug,ub
cg,ux,ug,ux,ux,ux,ux,cb,ub,ux,ux,ub,ub,ub,ub,ub,ug,ug,ug,ug,ub,ub,ub
ux,ux,ug,ux,ux,ux,ux,ux,ub,ux,ux,ub,ub,ub,ub,ub,ub,ub,ux,ux,ub,ub,ub
ux,ux,ug,ux,ux,ux,ux,ux,ub,ub,ug,ux,ub,ub,ub,ub,ub,ub,ub,ub,ub,ub,ub
cr,ux,ug,ux,ux,ux,ux,ux,ub,ux,ug,ug,ug,ub,ub,ub,ub,ub,ub,ub,ub,ub,ub
cg,cb,ur,ur,ur,ur,ur,ur,ub,cg,ug,ug,ug,ub,ub,ub,cb,ub,ub,ub,ub,cb,cr
cr,ux,ur,ur,ur,ur,ur,ur,ur,cr,ub,ub,ug,ug,ug,ug,ub,ub,ub,ub,cb,ux,cr