ur,ur,ur,ur,ur,cr,ub,ub,ub,ub,ub,cb,ur,ur,ur,ur,ur,ur,ur,ur,ux,ux,ux
ur,ur,ur,ur,ur,cr,cr,ub,ub,cb,ur,ur,ur,ur,ur,ur,ur,ur,ur,ur,ur,ur,ux
ur,ur,ur,ur,ur,ur,ur,ur,ur,ur,ur,ur,ur,ur,ur,ur,ur,ur,ur,ur,ux,ur,ux
ur,ur,ur,ur,ur,ur,ur,ur,ur,ur,ur,ur,ur,ur,ur,ur,ur,ur,ur,ur,ux,ur,cb
ur,ur,ur,ur,ur,ur,ur,ur,ur,ur,ur,ur,ur,ur,ur,ur,ur,ur,ug,ur,ux,ur,cg
ur,ur,ur,ur,ur,ur,cr,ug,ug,ur,ur,ur,ur,ur,ur,cr,ug,ur,ug,ur,ux,ur,ug
ur,ur,ur,cg,ug,ug,ur,ur,ur,ur,ur,cb,ub,ug,ug,ur,ug,ur,ux,ux,ux,ux,ug
ur,ur,ux,ug,ug,ug,ur,ur,ur,ur,ur,ur,ub,ur,ug,ur,ug,ur,ux,ux,ux,ux,ug
cg,ux,ux,ug,ug,ug,ur,ug,ug,ug,ug,ug,ub,ur,ug,ug,ug,ur,ux,ux,ux,ux,ug
ux,ux,ux,ug,ug,ug,ur,ug,ug,ub,ub,ub,ub,ub,ug,ug,ug,ur,ux,ux,ux,ux,ug
ux,ux,ux,ug,ug,ug,ur,ur,ug,ub,ug,ub,ub,ub,ux,ux,ux,ur,ur,ux,ux,ux,ug
ux,ux,ux,ug,ug,ug,ug,ur,ur,ub,ur,ub,ug,ug,ug,ug,ug,ug,ur,ur,ur,ur,ug
ux,ur,ur,ug,ug,ur,ug,ug,ub,ub,ub,ub,ub,ub,ub,ub,ub,ub,ub,ub,ub,ub,ug
ur,ur,ur,ur,ur,ur,ug,ug,ub,ug,ug,ub,ub,cb,ub,ub,ub,ub,ub,ux,ux,ux,ug
cg,ur,ur,ur,ur,ur,ug,ux,ug,ug,ug,ug,cg,ub,ub,ub,ub,ub,ub,ux,ux,ux,ug
ux,ux,ux,ux,ux,ux,ug,ug,ug,ux,ug,ug,ub,ub,ub,ub,ub,ub,ux,ux,ux,ux,ug
ux,ux,ux,ux,ux,ux,ux,ux,ub,ux,ug,ux,ub,ub,ub,ug,ub,ub,ub,ub,ux,ux,ug
ux,ux,ux,ux,ux,ug,ug,ug,ub,ug,ub,ub,ub,ux,ub,ug,ub,ub,ux,ux,ux,ux,ug
ux,ux,ux,ux,ug,ug,ug,ux,cr,ub,ub,ux,ux,ux,ub,ug,ug,ub,ux,ux,ux,ux,ug
ux,ux,ux,ux,ug,ug,ug,ux,ur,ux,ux,ux,ux,ux,ux,ug,ux,ux,ux,ux,ux,ux,ug
ub,ub,ub,ub,ub,ub,ub,ub,cb,ub,ub,ub,ub,ub,ub,ug,ug,ug,ug,ug,ug,ug,ug
ub,ux,ux,ux,ug,ug,ug,ux,ub,ux,ug,ug,ug,ug,ug,ug,ux,ux,ux,ux,ux,ux,cb
ub,ub,ub,ub,ub,ub,ub,ub,ub,cg,ux,ux,ux,ux,ux,ux,ux,ux,ux,ux,ux,ux,ux