ur,ur,cb,ur,ur,ur,ur,ur,ur,ur,ur,ur,ur,cr,ub,ub,ub,ub,ub,cg,ug,ug,ug
ur,ur,ur,ur,ur,ur,ur,ur,ur,ur,ur,ux,ux,ur,cb,ub,ub,ub,ub,ur,ur,ug,cr
ur,ur,ur,ur,ux,ur,ur,ur,ur,ur,ur,ug,ug,ug,ug,ur,ur,ur,ur,ur,ur,ur,ur
ur,ur,ur,cr,ur,cr,ur,ur,ur,ur,ur,ug,ur,ur,ug,ur,ur,ur,ur,ub,ur,ug,ug
ur,ur,ur,ux,ur,ux,cg,ug,ug,ug,ur,ug,ur,ug,ug,ug,cg,ub,ub,ux,ur,ux,ug
ur,ur,ur,ur,ur,ur,ur,ur,ur,ug,ug,ug,ur,ug,ur,ug,ux,ub,ux,ux,ur,ux,ug
ur,ur,ur,ur,ur,ur,ur,ur,ur,ur,ur,ur,ug,ug,ur,ug,ux,ux,ux,ux,ur,ux,ug
ur,ur,ur,ur,ur,ur,ur,ur,ur,ur,ug,ur,ug,ur,ub,ug,ug,ux,ux,ux,ur,ug,ug
ur,ur,ur,ur,ur,ur,ur,ur,ur,ug,ug,ub,ub,ug,ug,ug,ub,ub,ub,ux,ur,ur,ug
ur,ur,ur,ur,ur,ur,ur,ug,ug,ug,ug,ub,ub,ub,ug,ug,ub,ub,ub,ux,ur,ur,ug
ux,ux,cr,ux,ux,ux,ug,ug,ug,ug,ug,ub,ub,ub,ub,ug,ub,ub,ub,ub,ur,ub,ub
ux,ux,ux,ux,ux,ux,ug,ug,ug,ub,ug,ub,ub,cb,ub,ub,ub,ub,ux,ug,ur,ug,ub
cg,ux,ux,ux,ux,ux,ug,ug,ug,ux,ub,ug,ub,ub,ub,ub,cb,ub,ub,ub,ur,ug,ub
ux,ux,ux,ux,ux,ux,ug,ux,ux,ub,ub,ub,ub,ub,ux,ug,ub,ux,ub,ub,ur,ug,ub
ux,ux,ux,ux,ux,ux,ug,ug,cg,ug,ub,ub,ub,ub,ub,ug,ub,ub,ub,ub,ur,ug,ub
ux,ux,ux,ux,ux,ux,ux,ux,ux,ug,ux,ub,ub,ug,ug,ug,ub,ub,ub,ub,ur,ug,ub
ux,ux,ug,ux,ux,ux,ux,ux,ux,ux,ux,ub,ub,ug,ub,ub,ub,ub,ug,ug,ur,ug,ub
cg,ux,cg,ux,ux,ux,ux,ux,ux,ux,ux,ub,ub,ug,ub,ug,ub,ub,ug,ug,ub,ub,ub
ux,ux,ug,ux,ux,ux,ux,ux,ux,ux,ux,ub,ub,ug,ub,ug,ug,ub,ug,ug,ub,ub,ub
ux,ux,ug,ux,ux,ux,ux,ux,ux,ux,ug,ug,ub,ub,ub,ub,ug,ug,ub,ub,ub,ub,ub
cr,ux,ug,ux,ux,ux,ux,ux,ux,ux,ug,ux,cb,ug,ub,ub,ug,ug,ub,ub,ub,ub,ub
cg,cb,ug,ug,ug,ug,ug,ug,ug,ug,ug,ux,ub,ub,ub,ub,ub,cr,ur,cb,ub,cb,cr
cr,ux,ug,ug,ug,ug,ug,ug,ug,ug,ug,ug,ug,ub,ug,ug,ub,ub,ub,ub,cb,ux,cr