cr,ub,ur,ur,ur,ur,ur,ur,ur,ur,ur,ux,ux,ur,ur,ur,ur,cb,ur,ur,ur,ur,ur
ur,ub,ur,ur,ur,ur,ur,ur,ur,ur,ug,ug,ug,ug,ux,ur,ur,ug,ug,ug,ug,ug,ur
cb,ub,ur,ur,ur,ur,ur,ur,ur,ur,ug,ug,ur,ug,ur,ur,ur,ur,ur,ur,ur,cr,ur
ur,cr,ur,cr,ur,ur,ur,ur,ur,ur,ux,ug,ug,ug,ug,ur,ug,ug,ub,ur,ug,ug,ur
ur,ur,ur,cr,ur,ur,ur,ur,ur,ur,cr,ug,ug,ub,ub,ur,ug,ug,ug,ug,ug,ug,ur
ur,ur,ur,ur,ur,cg,ug,ug,ur,ub,ur,ux,ug,ub,ub,ur,ug,ub,ug,ug,ug,ug,ux
ub,ur,ub,ub,ub,ur,ur,ug,ur,ub,ur,ub,ub,ub,ub,ur,ug,ub,ug,ug,ug,ug,ux
ub,ur,ub,ur,cb,ub,ug,ug,ur,ur,ur,ub,ub,ub,ub,ur,ug,ub,ug,ug,ug,ug,ux
ug,ur,ur,ur,ur,ur,ux,ur,ux,ur,ub,ub,ug,ub,ub,ur,ug,ug,ug,ug,ug,ug,ux
ug,ub,ub,ub,ub,ux,ux,ur,ur,ur,cb,ub,ub,ub,ug,ur,ub,ug,ux,ug,ug,ug,ux
ug,ub,ub,ub,ub,ug,ug,ug,ub,ub,ug,ub,ub,ug,ug,ur,ub,ub,ux,ug,ug,cg,ux
ub,ub,ub,ub,ub,ux,ux,ux,ux,ub,cg,ug,ub,ug,ug,ur,ub,ub,ux,ug,ug,ux,ux
ug,ug,ug,ug,ug,ug,ug,ug,ug,ug,ug,ug,ub,ub,ub,ub,ub,ub,ub,ub,ug,ux,cg
ug,ub,ub,ub,ub,ux,ux,ux,ub,ub,ug,ug,ug,ub,cb,ub,ub,ub,ub,ug,ug,ux,ux
ug,ug,ug,ug,ug,ug,ug,cg,ub,ub,ug,ub,ux,ux,ux,ur,ux,ux,ur,ug,ug,ux,ux
ug,ub,ub,ub,ub,ux,ux,ux,ub,ub,ub,cb,ug,ug,ub,ur,ux,ux,ug,ug,ug,ux,ux
ug,ug,ug,ub,ub,ug,ug,ug,ub,ug,ug,ug,ug,ug,ux,ur,ux,ux,ug,ux,ug,ux,ux
cg,ur,ur,ub,ug,ug,ug,ug,ug,ug,ub,ur,ur,ur,ur,ur,ur,ur,ug,ux,ug,ux,ux
ux,ur,ux,ub,ug,ug,ug,ug,ug,ug,ug,ug,ug,ug,ug,ur,ux,ur,ug,ug,ug,ux,ux
ux,ur,ux,ub,ux,ux,ux,ux,ux,ux,ux,ux,ux,ux,ux,ur,ux,ur,ug,ug,ux,ux,ux
ux,ur,ux,ub,ub,ub,ub,ub,ub,ub,ub,ub,ub,ub,ub,ub,ub,ub,cb,ug,ux,ux,ux
cr,ur,ux,ux,ux,ux,ux,ux,ux,ux,ux,ux,ux,ux,ux,ur,ux,ur,ur,ux,ux,ub,cb
cg,ur,ur,ur,ur,ur,ur,ur,ur,ur,ur,ur,ur,ur,ur,ur,ur,ur,ur,cg,cb,ux,ur