ux,ux,ux,ux,cr,ur,ur,ur,ur,ur,ur,ur,ur,ur,ur,ur,ur,cb,ur,ur,ur,ub,ub
ub,ub,ub,ux,ur,ur,ur,ur,ur,ur,ur,ur,ur,ur,ur,ur,ur,ur,ur,ur,ub,ub,ub
ub,ub,ub,cr,ub,ub,ur,ur,ur,ur,ur,ur,ur,ur,ur,ur,ur,ur,ur,ur,ub,ur,ub
ur,ub,ub,ur,ur,cb,cr,cr,ug,ur,ur,ur,ur,ur,ur,ur,ug,ub,ub,ur,ub,ub,ub
ub,ub,ur,ur,ur,ur,ur,ur,ug,ur,ug,ub,cr,ug,ug,ug,ug,ub,ub,ur,ur,ub,ur
ur,ub,ur,ur,ux,ur,ur,ur,ug,ug,cg,ub,ug,ug,ug,ub,ug,ub,ub,ur,ur,ub,ub
ur,ub,ub,ub,ub,ug,ug,ur,ur,ur,ur,ur,ub,ug,ug,ux,ux,ub,ub,ub,ub,ub,ub
ur,ub,ub,ub,ub,ug,ur,ur,ur,ur,ug,ur,ug,ug,ug,cb,ub,ub,ub,ub,ux,ug,ux
ur,ur,ur,ur,ub,ur,ub,cb,ug,cg,ug,ug,ug,ug,ug,ug,ux,ug,ux,ux,ug,ug,ux
ux,ux,ux,ub,ub,ub,ub,ug,ub,ux,ug,ub,ug,ug,ug,ug,ux,ug,ux,ug,ug,ux,ux
ux,ux,ug,ug,ug,ug,ug,ug,ub,ug,ug,ug,ug,ug,ug,ug,ub,ub,ub,ug,ux,ux,ux
ux,ux,ug,ux,ux,ux,ux,ug,ux,ug,ub,ub,cb,ug,ub,ug,ub,ug,ux,ux,ux,ux,ux
ux,ux,ug,ux,ux,ux,ux,ug,ux,ug,ug,ub,ug,ug,ug,ug,ug,ug,ux,ux,ur,ur,cg
ur,ur,ug,ug,ug,ug,ug,ug,ug,ug,ug,ub,ug,ug,ug,ug,ug,ug,ur,ur,ur,ur,ur
ur,ux,ux,ux,ux,ux,ux,ug,ub,ub,ub,ub,ub,ub,ug,ub,ux,ux,ug,ux,ur,ur,ur
ur,ux,ux,ux,ux,ux,ux,ug,ub,ub,ub,ub,ub,ub,ug,ub,ux,ub,ug,ug,ur,ur,ur
ur,ur,ur,ur,ug,ug,ug,ug,ug,ur,ur,ub,ur,ur,ur,ur,ur,ur,ur,ur,ur,ur,ur
cg,ux,ux,ux,ug,ux,ug,ub,cr,ur,ur,ur,cg,ur,ur,ur,ur,ur,ur,ur,ur,ur,ur
ux,ub,ub,ug,ug,ug,ug,ug,ug,ug,ux,ub,ug,ux,ux,ub,ug,ug,ug,ug,ur,ur,ur
ux,ub,ub,ug,ug,ug,ug,ux,ux,cg,ux,ux,ug,ux,ux,ux,ux,ux,ux,ux,ur,ur,ur
ux,ub,cb,ub,ux,ux,ug,ux,ux,ux,ux,ug,ug,ug,ug,ug,ux,ux,ux,ur,ur,ur,ur
cr,ub,ub,ub,ux,ux,ug,ux,ux,ux,ux,ug,ug,ug,ug,ug,ug,ug,ux,ur,ur,cb,cr
cg,ux,ub,ub,ux,ux,ug,ug,ug,ug,ug,ug,ug,cb,ug,ug,ug,ug,ux,cg,cb,ux,cr