cb,cb,cb,cr,cg,ur,ur,ur,ur,ur,ur,ur,ur,ur,ur,ur,cr,ur,ur,ur,ub,ub,cb
ur,ur,ur,cr,ug,ur,ur,ur,ur,ur,ur,ur,ur,ur,cr,ur,ur,ux,ux,ur,ub,ub,ub
ur,ur,ur,ub,ub,cb,ur,ur,ur,ur,ur,ur,ur,ur,ux,ux,ux,ux,cb,ub,cb,ub,ub
ur,ur,ur,ub,ub,cr,ur,ur,ur,ur,ub,ux,ux,ux,ux,ux,ux,ux,ux,ux,ub,ub,ub
ub,ub,ub,ug,ub,ug,ub,ux,ux,ux,ux,ux,ux,ux,ux,ux,ux,ux,ux,ux,ub,ub,ub
ub,ub,ub,ub,cg,ug,ub,ux,ux,ux,ux,ux,ux,ux,ux,ux,ux,ux,ux,ux,ub,ub,ub
ub,ub,ub,ub,ug,ug,ub,ux,ux,ux,ux,ux,ux,ux,ux,ux,ux,ux,ux,ux,ub,ub,ub
cb,ub,ub,ux,ux,ux,ub,ub,ub,ub,ub,ux,ug,ug,ux,ux,ux,ux,ux,ux,ub,ub,ub
ub,ub,ub,ux,ux,ux,ux,ux,ux,ux,ub,ux,ug,ug,ug,ug,ug,ux,ux,ux,ub,ub,ub
ub,ub,ub,ux,ux,ux,ux,ux,ux,ux,ug,ug,ug,ug,ug,ux,ug,ux,ux,ux,ub,ub,ub
ub,ub,ub,ux,ux,ux,ux,ux,ux,ux,ug,ug,ug,ug,ug,ug,ug,cg,ux,ux,ub,ub,ub
ub,ug,ub,ub,ux,ux,ux,ux,ux,ux,ug,ug,ug,ug,ug,ug,ug,ux,ux,ux,ub,ub,ub
cb,ub,ub,cr,ub,ub,ux,ux,ux,ux,ub,ug,ug,ug,ug,ug,ug,ux,ur,ux,ub,ub,ub
ug,ug,ug,ur,ub,ub,ux,ux,ux,ug,ug,ug,ug,ug,ug,ug,ug,ux,ur,ux,ub,ub,ub
ug,ur,ur,ur,ub,ux,ux,ux,ux,ug,ug,ug,cb,ug,ug,ux,ug,ux,ur,ux,ub,ub,ub
ug,ug,ug,ur,ub,ub,ux,ux,ux,ug,ux,ub,ub,ug,ug,ug,ug,ux,ur,ux,ub,ub,ub
ur,ug,cg,ur,ux,ub,ux,ux,ux,ug,ug,ub,ug,ug,ux,ux,ux,ux,ur,ux,ub,ur,ub
cr,ur,ur,cr,ux,ub,ub,ub,ub,ub,ux,ub,ub,ux,ux,ux,ux,ux,ur,ux,ub,ur,ub
cg,ur,ur,ur,ur,ur,ur,ur,cg,ug,ug,ug,ug,ug,ug,ug,ur,ur,ur,ug,ub,cb,ub
cb,ur,ur,ur,ur,ur,ux,ux,ub,ub,ux,ug,ug,ug,ug,ug,ux,ux,ux,ug,ub,ub,ub
ur,ur,ur,ur,ur,ur,ub,ux,ub,ub,ux,ug,ug,ug,ug,ug,ug,ug,ug,ug,ub,ur,cr
cr,ur,ur,ur,ur,ur,ub,ub,ub,ug,ug,ux,ub,ub,ub,ub,ub,cb,cg,ug,cb,ug,cr
cg,cb,cg,cb,ur,ur,ub,ug,ur,ub,ug,ug,ug,ug,ug,cg,ug,ug,ug,cg,cg,ug,cr