ur,ur,ur,ur,ur,ur,ur,ur,ur,ub,ub,ub,ub,ub,ur,ur,ur,ur,ur,ur,cr,ur,ur
ur,ur,ur,ur,ur,ur,ur,ur,cr,cr,ub,ub,ub,ub,ur,ur,ur,ur,ur,ur,ur,ur,ur
ur,ur,cg,ug,ug,ur,ur,ur,ur,ur,cb,ur,ur,ub,ur,ur,ur,ur,ur,ur,ur,ur,ur
ur,ur,ur,ug,ug,ur,ur,ur,ur,ur,ub,ub,ub,cb,ug,ur,ur,ur,ur,ur,ur,ur,ur
ur,ur,ur,ug,ug,ug,ug,ug,ug,ub,cr,ub,ub,ur,ur,ur,ur,ub,ur,ur,ur,ur,ur
ur,ur,ur,ug,ug,ug,ur,ur,ur,ub,ur,ub,ub,cr,ub,ub,ur,cr,ur,ur,ur,ur,ur
ur,ur,ur,ug,ug,ug,ur,ur,ur,ub,ur,ur,ur,ur,ur,ur,ur,ur,ur,ur,ur,ur,ur
ur,ur,ur,ur,ug,ug,ug,ug,ur,ur,ur,ur,ur,ur,ur,ur,ur,ub,ux,ux,ur,ux,ur
cg,ux,ux,ux,ux,ux,ux,ug,ug,ub,ub,cg,ub,ub,ub,ug,cg,ug,ug,ux,ur,ux,ur
ub,ub,ub,ub,ux,ux,ux,ux,ux,ug,ug,ug,ub,ub,ub,ug,cb,ug,ug,ur,ur,ux,ur
ub,ub,ub,ub,ux,ux,ux,ub,ug,ug,ux,ub,ub,ub,ub,ub,ub,ug,ur,ur,ur,ux,ur
ub,ub,ug,ug,ug,ug,ug,ug,ug,ub,ub,ug,ub,ug,ug,ug,ub,ug,ur,ur,ur,ux,ur
cb,ub,ug,ub,ub,ub,ub,ux,ub,ub,ub,ub,cb,ub,ub,ub,ub,ub,ub,ub,ub,ub,ur
ub,ub,ug,ug,ux,ub,ub,ub,ub,ub,ub,ub,ux,ub,ub,ub,ub,ub,ug,ub,ug,ux,ur
cg,ux,ux,ug,ux,ux,ux,ux,ug,ux,ux,ur,ux,ub,ux,ub,ub,ub,ug,ub,ug,ub,ur
ub,ub,ub,ub,ub,ub,ux,ux,ug,ux,ux,ur,ux,ub,ub,ub,ug,ub,ux,ub,ug,ux,ur
ub,ub,ub,ug,ux,ub,ub,ub,ub,ub,ub,ub,ug,ug,ug,ug,ug,ub,ub,ub,ug,ux,ur
ub,ub,ub,ug,ux,ux,ux,ux,ux,ug,ug,ub,ub,cb,ux,ux,ux,ur,ux,ux,ug,ux,ur
ub,ub,ub,ug,ub,ux,ux,ux,ux,ux,ug,ug,ug,ug,ug,ug,ug,ug,ux,ux,ug,ux,ur
ub,ub,ub,ug,ug,ux,ux,ug,ug,ug,ug,ug,ux,ux,ux,ux,ux,ug,ux,ux,ug,ux,ur
ub,ub,ub,ux,ug,ug,ug,ug,ub,ub,ug,ug,ug,ug,ug,ug,ug,ug,ux,ux,ug,ux,ur
ub,ub,ub,ux,ux,ux,ux,ub,ub,ub,ug,ub,ub,ux,ux,ux,ux,ur,ux,ux,ug,ux,ur
ub,ub,ub,ub,ub,ub,ub,ub,ux,cg,ug,ug,ug,ug,ug,ug,ug,ur,ur,ur,ur,ur,ur