cb,ur,cb,ur,ur,cr,ur,ur,ur,ur,ur,ur,ur,ur,ur,ur,ur,ur,ur,cg,ur,ur,ur
ub,cr,ur,ur,ux,ux,ur,ux,ur,ur,ur,ur,ur,ur,ur,ur,ur,ur,ur,ur,ur,ur,ur
ur,ur,ur,ux,ux,ux,ur,ur,ur,ux,ur,ur,ur,ur,ur,ur,ur,ur,ur,ub,cr,ur,ur
ur,ur,ur,ux,ux,ux,ux,ux,ux,ux,ur,ur,ur,ur,ur,ur,ur,ur,ur,cb,ur,ur,ur
ur,ur,ur,ug,ux,ux,ux,ux,ux,ux,ur,ur,ur,cr,ug,cg,ur,ur,ur,ur,ur,ur,ur
ug,ug,ur,ug,ug,ug,ur,ux,ur,ur,ur,ur,ur,ur,ur,ur,ur,ur,ur,ur,ur,ur,ur
ug,ug,ug,ux,ux,ug,ug,ur,ur,ur,ur,ur,ur,ur,ur,ur,ur,ur,ur,ur,ur,ur,ur
ux,ug,ug,ux,ur,ur,ug,ug,ug,cr,ur,ur,ur,ug,ug,ub,ur,ur,ur,ur,ur,ur,ur
ur,ug,ur,ur,ug,ug,ur,ug,ug,ug,ug,ug,ug,ug,ub,ub,ub,ub,ur,ur,ug,ug,ux
ux,ug,ux,ux,ug,ur,ur,ug,ug,ub,ur,ur,ug,ur,ur,ur,ub,ub,cb,ux,ug,ug,ux
cg,ug,ux,ux,ug,ub,ur,ug,ug,ug,ug,ur,ug,ur,ur,ur,ur,ur,ur,ur,ur,ur,ur
ux,ux,ux,ux,ux,ub,ub,ub,cg,ug,ug,ug,ug,ub,ug,ug,ug,ug,ux,ug,ug,ug,ur
cg,ux,ux,ux,ux,ub,ub,ub,ub,ub,ug,ub,ug,ub,ux,ug,ug,ux,ux,ug,ug,ug,ur
ux,ux,ug,ug,ug,ug,ug,ux,cb,ub,ug,ug,ug,ug,ug,ug,ug,ux,ux,ug,ug,ux,ur
ux,ug,ub,ub,ug,ug,ub,ub,ug,ug,ug,ug,ug,ug,ug,ug,ug,ux,ux,ug,ug,ux,ur
ux,ug,ub,ub,ub,ub,ub,ub,ug,ug,ug,ug,ug,ug,ug,ug,ug,ug,ug,ug,ug,ux,ur
ux,ug,ub,ub,ub,ub,cb,ub,ug,ug,ug,ub,ug,ub,ug,ug,ug,ug,ug,ux,ug,ux,ur
cg,ug,ub,ub,ub,ub,ub,ub,ug,ug,ug,ug,ug,ub,cb,ub,ug,ux,ux,ux,ug,ux,ur
ux,ug,ug,ub,ug,ug,ub,ub,ug,ug,ug,ub,ub,ub,ub,ug,ug,ux,ug,ug,ug,ux,cr
ux,ux,ug,ub,ug,ug,ug,ub,ub,ug,ug,ug,ug,ug,cg,ub,ug,ux,ug,ug,ug,ux,ux
cr,ux,ux,ux,ug,ug,ug,ug,ug,ug,ug,ug,ub,ug,ug,ub,ug,ug,ug,ux,ur,ux,ux
cg,ur,ur,ur,ur,ur,ur,ur,ug,ug,ur,ub,ub,ub,ub,ub,ur,ur,ur,ur,ur,cb,cr
cr,ur,ur,ur,ur,ur,ur,ur,ur,ur,ur,ub,ub,ub,ux,ux,ux,ux,ux,ux,cb,ux,cr