ur,ur,ur,cb,ur,ur,ur,ur,ur,ur,ur,ur,ur,ur,ur,ur,ur,ur,ur,ur,ur,ur,ur
ur,ur,ur,ub,cr,ur,ur,ur,ux,ur,ur,ur,ur,ux,ux,ux,ux,ux,ux,ur,ur,ur,ur
ur,ur,cr,ur,ur,ur,ur,ur,ux,ur,ur,ur,ur,ur,ur,ur,ur,ur,ur,ur,ur,ur,ur
ur,ur,ur,ur,ur,ur,ur,ur,ur,ur,ur,ur,ur,ur,ur,ur,ur,ur,ur,cr,ug,ur,ur
ur,ur,ur,ur,ur,ur,ur,ur,ur,ur,ub,cb,ur,ur,cr,ur,ux,ug,ug,ug,ug,ur,ur
ur,ur,ur,ur,ur,cr,ur,ur,ur,ur,ub,ur,ur,ur,ug,ur,ug,ug,ug,ug,ug,ur,ur
ur,ub,ub,ub,cb,ub,ub,ub,ur,cr,ub,ug,ug,ur,ur,ur,ur,ur,ug,ug,ug,ur,ur
ur,ub,ub,ub,ub,ub,ub,ub,ur,ub,ub,ub,ug,ub,ub,ur,ur,ur,ug,ug,ug,ur,ur
cg,ub,ub,ur,ur,ub,ub,ub,ur,ub,ug,ub,ub,ub,ug,ub,ur,ur,ug,ug,ug,ur,ur
ur,ub,ub,ub,ub,ub,ub,ub,ur,ub,cb,ub,ur,ug,ug,cg,ur,ur,ug,ug,cg,ur,ur
ur,ub,ub,ub,ub,ub,ub,ub,ur,ub,ub,ub,ub,ug,ug,ug,ub,ur,ur,ur,ur,ur,ur
ux,ux,ub,ub,ub,ub,ub,ub,ur,ub,ug,ur,ur,ur,ug,ug,ug,ur,ur,ur,ur,ur,ur
ux,ub,ub,ub,ub,ub,ub,ug,ur,ub,ug,ug,ug,ub,ug,ug,ux,ur,ur,ur,ub,ux,ur
ux,ub,ub,ub,ub,ub,ub,ug,ur,ub,ub,ug,ug,ub,ug,ub,ux,ux,ux,ux,ub,ux,ur
cg,cb,ub,ub,ub,ub,ub,ux,ur,ub,ub,ug,ux,ug,ug,ug,ug,ug,ug,ux,ub,ux,ur
ub,ub,ub,ub,ux,ux,ug,ug,ur,ug,ug,ug,ug,ug,ug,ug,ug,ub,ug,ux,ub,ux,ur
ub,ub,ub,ux,ux,ub,ug,ub,ur,ux,ub,ug,ub,ub,ug,ug,ug,ug,ug,ux,ub,ux,ur
ux,ux,ub,ub,ub,ub,ug,ug,ur,ug,ug,ug,ug,ug,ug,ug,ug,ug,ug,ur,ub,ur,ur
ux,ux,ub,ub,ux,ux,ux,ux,ur,ux,ux,ug,ub,ub,ug,ux,ur,ur,ur,ur,ub,ux,ux
ur,ur,ug,ug,ug,ug,ug,ug,cg,ug,ug,ug,ur,ur,ur,ur,ur,cb,ub,ub,ub,ux,ux
ur,ug,ug,ux,ux,ux,ux,ux,ug,ux,ux,ub,ub,ug,ub,ux,ur,ug,ux,ub,ub,ux,ux
ur,ug,ux,ux,ux,ux,ux,ux,ug,ux,ux,ub,ux,ug,ug,ug,ug,ug,ur,ub,ub,ux,cb
ur,ug,ug,ug,ug,ug,ug,ug,ug,cg,ux,ux,ux,ux,ux,ux,ug,ug,ur,ub,ub,ux,ux