ux,ux,ux,ux,ux,ux,ur,cr,ur,ur,ur,ur,ur,ur,ur,ur,ur,ur,ur,ur,ur,ur,ur
ur,ux,ux,ux,ur,ur,ur,ur,ur,ur,ux,ux,ux,ux,ur,ur,ur,ur,ur,ur,ur,ur,ur
ur,ur,ur,ur,ur,ur,ur,ur,ur,ur,ur,ur,ur,ur,ur,ur,ux,ux,ux,ur,ur,ur,ur
ur,ux,ur,cg,ug,ur,ur,ub,ub,ur,ur,ur,ur,ur,ur,ur,ug,ug,ug,ug,ur,ur,cb
ur,ux,ur,ur,ug,ug,ur,cb,ub,ub,ub,ub,ub,ub,ub,ub,ub,ub,ub,ur,ur,ur,ux
ur,ur,ur,ur,ur,ug,ur,ur,ur,ur,ur,ur,ur,ur,ur,ur,ur,ur,ub,ub,ur,ur,ub
ur,ur,ur,ur,ur,ur,ur,ur,ur,ur,ur,ur,ur,ur,ur,ur,ur,ur,ur,ub,ux,ub,ub
ur,ur,ur,ur,ur,ur,ur,ur,ur,ur,ur,ur,ub,cr,ux,ug,ux,ux,ug,ub,ub,ub,ub
cg,ur,ur,ur,ur,ur,ur,ur,ur,ur,ur,cb,ub,ug,ux,ug,ug,ux,ug,ub,ub,ub,ub
ur,ur,ur,ur,ur,ur,ur,ur,ur,ur,cr,ub,ub,ug,ux,ug,ux,ux,ug,ub,ub,ub,ub
ur,ur,ur,ur,ur,ur,ur,ur,ur,ur,ub,ub,ub,ub,ub,ug,ux,ux,ug,ub,ub,ub,ub
ur,ur,ur,ur,ur,ur,ur,ur,ur,ur,ug,ug,ug,cb,ub,ug,ug,ux,ux,ub,ub,ub,ub
ur,ur,ur,ur,ur,ur,ur,ur,ur,ur,ug,ug,ug,ub,ub,ub,ub,ug,ug,ub,ub,ub,ub
ur,ur,ur,ur,ux,ux,ur,ur,ur,ub,ug,cg,ug,ug,ug,ub,cr,ug,ug,ub,ug,ub,ub
cg,ur,cr,ux,ux,cr,ur,ur,ub,ub,ug,ub,ug,ug,ug,ub,ur,ux,ux,ub,ux,ub,ux
ux,ux,ux,ux,ux,ux,ug,ug,ug,ub,ug,ub,ub,ug,ug,cb,ur,ug,ux,ub,ux,ub,ub
ux,ux,ux,ux,ux,ux,ug,ug,ug,ub,ug,ub,ub,ub,ub,ub,ur,ug,ux,ub,ux,ub,ub
ux,ux,ux,ux,ux,ux,ur,ug,ug,ug,ug,cg,ub,ub,ub,ub,ur,ug,ug,ub,ux,ub,ux
ux,ux,ux,ux,ux,ux,ur,ur,ur,ur,ur,ur,ur,ur,ub,ub,ur,ub,ux,ub,ux,ub,ub
ux,ux,ux,ux,ux,ux,ur,ux,ub,ub,ub,ub,ux,ux,ub,ub,ur,ub,ub,ub,ub,ub,ub
ur,ur,ur,ur,ur,ur,ur,ur,ub,ur,ub,ux,ux,ub,ub,ub,ur,ug,ug,ub,ub,ux,ux
ur,ux,ub,ub,ub,ur,ux,ub,ub,ux,ub,ub,ub,ub,ur,ub,ur,ur,ur,ur,ur,ur,cb
ur,ur,ur,ur,ur,ur,ub,ub,ux,cg,ub,ub,ub,ub,ux,ub,ub,ub,cb,ur,ur,ur,ur