ur,ur,cb,ur,ur,cg,ug,ur,ur,ur,ur,ur,ur,ur,ur,ug,ur,ur,ur,cg,ug,ug,ug
ur,ur,ur,ur,ur,ur,ug,ur,ur,ur,ur,cr,ug,ur,ur,ur,ur,ur,ur,ub,ug,ug,ug
ur,cb,ur,ur,ur,ur,ug,ug,ug,ur,ug,ur,ur,ur,ur,ur,ux,ug,ug,ug,ug,ug,ug
ur,ub,cr,ur,ur,ur,ur,ur,ug,ug,ug,ur,ug,ub,ur,ub,ub,ug,ub,ub,ur,ug,ug
cr,ub,cr,ub,ur,ur,ur,ur,ur,ur,ur,ur,ur,ur,cr,ux,ur,ug,ug,ug,ug,ub,ug
ur,ur,ur,ug,ug,ug,ug,ug,ug,ug,ug,ug,ur,ur,ug,ug,ug,ug,ug,ur,ug,ur,ug
ub,ub,ub,ur,ur,ur,ur,ur,ur,ur,ur,ug,ur,ur,ux,ux,ur,ur,ur,ur,ug,ug,ug
ub,ub,ub,ur,ub,ub,ur,ur,ur,ur,ur,ug,ur,ur,ur,ur,ur,ub,ub,ur,ux,ux,ux
ub,ub,ub,ub,ub,ub,ur,ug,ug,ug,ug,ug,ub,ub,ub,ub,ub,ub,ub,ur,ur,ur,ur
ub,cb,ug,ur,ug,ub,ub,ub,ub,ub,ug,ub,ug,ub,ub,ug,ug,ug,ub,ur,ux,ux,ur
ur,ur,ug,ur,ug,ub,cg,cb,ux,ub,ug,ux,ug,ub,ub,ug,ug,ug,ug,ur,ux,ux,ur
ur,ur,ug,ur,ug,ub,ug,ux,ux,ub,ub,ub,ub,ub,cb,ug,ug,ug,ug,ur,cr,ux,ur
cg,ux,ug,ug,ug,ug,ug,ux,ux,ub,ub,ug,ug,ug,ub,ug,ug,ug,ug,ur,ur,ux,ur
ux,ux,ug,ug,ux,ug,ug,ux,ux,ub,ub,ub,ub,ub,ub,ub,ug,ug,ug,ur,ur,ux,ur
ux,ux,ug,ug,ug,ug,ug,ux,ux,ub,ug,ub,ub,ub,ub,ub,ug,ug,cg,ur,ur,ux,ur
ux,ux,ug,ug,ug,ug,ug,ux,ux,ub,ub,ub,ub,ub,ub,ug,ug,ug,ug,ur,ur,ug,ur
ux,ux,ug,ug,ug,ug,ug,ux,ux,ub,ub,ub,ub,ub,ux,ux,ux,ux,ux,ur,ur,ug,ur
cg,ub,ug,ub,ug,ug,ug,ub,ug,ug,ug,ug,ug,ug,ug,ug,cg,ux,ux,ur,ur,ug,ur
ub,ub,ug,ug,ug,ub,ux,ug,ug,ub,ux,ub,ug,ub,ub,ux,ux,ux,ux,ur,ur,ux,ur
ub,ub,ug,ug,ug,ug,ug,ug,ub,ub,ux,ub,ug,ug,ux,ux,ux,ux,ux,ur,ur,ux,ur
cr,ux,ux,ug,ub,ur,ux,ub,ub,ub,ux,ub,ux,ug,ux,ux,ux,ux,ux,ur,ur,ur,ur
cg,cb,ux,ug,ub,ub,ux,ub,ub,ub,ub,ub,ux,ug,ux,ux,ux,ux,ux,ur,ur,cb,cr
cr,ug,ug,ug,ug,ub,ub,ub,cb,ub,ub,ur,ur,ur,ur,ur,ur,ur,ur,ur,cb,ux,cr