ur,cb,ub,ub,ub,ub,ub,cr,ur,ur,ur,ur,ur,ur,ur,ur,ur,ur,ur,ur,ur,ur,ur
ur,ur,ur,ur,ur,ur,ur,ur,ug,ur,ur,ur,ur,ur,ur,ur,ur,ur,ur,ux,ux,ux,ur
ur,ug,ur,ur,ur,ur,ur,ur,ur,ur,ur,ur,ur,ur,ur,ur,ux,ub,ur,ub,ub,ub,ub
ur,cr,ur,ur,ur,ur,ur,ur,ur,ug,ur,ur,ur,ur,cb,ub,ub,ub,ur,ux,ux,ux,ub
ur,cr,ub,ub,cr,ur,ur,cr,ug,ug,ur,ur,ur,ux,ux,ux,ub,ub,ur,ux,ux,ux,cg
ur,ur,ur,ub,ug,ub,ug,ug,ug,ug,ug,ug,ug,ub,ub,ub,ub,ub,cr,ux,ux,ux,ug
ur,ur,ub,cb,ug,ub,ur,ub,ub,ub,ug,ug,ug,ub,ug,ug,ux,ux,ux,ux,ux,ux,ug
ub,ur,ub,ux,cg,ux,ur,ux,ug,ug,ug,ug,ub,ub,ub,ub,ub,cb,ux,ux,ux,ux,ug
cg,ur,ur,ur,ur,ur,ur,ux,ug,ub,ug,ug,ub,ub,ub,ub,ub,ub,ux,ux,ux,ux,ug
ux,ux,ux,ux,ux,ux,ub,ub,ug,ug,ug,ug,ub,ub,ub,ub,ub,ub,ub,ux,ux,ux,ug
ux,ux,ux,ux,ux,ux,ub,ub,ub,ub,ug,ug,ug,cg,ub,ux,ux,ux,ub,ub,ub,ub,ug
ux,ux,ux,ux,ux,ux,ub,ub,cb,ub,ub,ub,ub,ub,ub,ub,ux,ux,ux,ux,ux,ux,ug
ux,ux,ux,ux,ux,ux,ub,ub,ub,ub,ub,ub,ub,ub,ub,ub,ux,ux,ux,ug,ug,ux,ug
ux,ux,ux,ux,ub,ux,ux,ux,ux,ux,ub,ub,ub,ub,ub,ub,ux,ux,ux,ug,ux,ux,ug
ux,ux,ux,ux,ub,ub,ub,ub,ub,ug,ug,ug,ub,ux,ux,ux,ux,ux,ux,ug,ux,ux,ug
ug,ug,ug,ug,ug,ub,ub,ug,ub,ug,ug,ug,ux,ux,ux,ux,ux,ux,ux,ug,ux,ux,ug
ug,ux,ux,ux,ux,ux,ub,ub,ub,ug,ug,ux,ux,ux,ux,ux,ux,ux,ux,ug,ux,ux,ug
ug,ur,ur,ur,ur,ur,ub,ur,ug,ux,ug,ug,ug,ug,ux,ux,ux,ux,ug,ug,ux,ux,ug
ug,ur,ur,ur,ur,ur,ub,ur,ug,ux,ux,ux,ux,ug,ug,ug,ug,ug,ug,ux,ux,ux,ug
ug,ur,ur,ur,ur,ur,ub,cb,ug,ux,ux,ux,ux,ux,ux,ux,ux,ux,ux,ux,ux,ux,ug
ug,ub,ub,ub,ur,ur,ux,ur,ug,ux,ux,ux,ux,ux,ux,ux,ub,ub,ub,ub,ux,ux,ug
ug,ur,ur,ub,ur,ur,ux,ur,ug,ub,ub,ub,ub,ub,ub,ub,ub,ux,ux,ux,ux,ux,ug
ug,ug,ug,ug,ug,ug,ug,ug,ug,ug,ug,ug,ug,ug,ug,ug,ug,ug,ug,ug,ug,ug,ug