ub,cb,cb,ur,ur,ur,ur,ur,ur,ur,ur,ur,ur,ur,ur,ur,ur,ur,ur,cg,ub,ub,ub
cr,ur,ur,ur,ur,ur,ur,cr,ur,ur,ur,ur,ur,ur,ur,ur,ub,ub,cb,ub,ub,ub,ub
ur,ur,ur,ur,ur,ur,ur,ug,ur,ur,ur,ur,ur,ur,ub,ub,ub,ub,ub,ub,ub,ux,ub
ur,ur,ur,ur,ur,ur,ur,cg,ur,ur,ur,ur,ur,ux,ux,ux,ux,ux,ux,ux,ux,ux,ub
ur,ur,ur,ur,ur,ur,ur,ur,ur,ur,ux,cr,ub,ub,ub,ub,ub,ub,ub,ub,ub,ub,ub
ur,ur,ur,ur,ur,ur,ur,ur,ur,ur,ur,ur,ur,ur,ug,ux,ug,ug,ug,ux,ux,ux,ur
ur,ur,ur,ur,ur,ur,ur,ur,ur,ur,ur,ur,cr,ug,ug,ug,ug,ug,ug,ux,ux,ux,ur
ur,ur,ur,ur,ug,ug,ur,ux,ub,ug,ub,ub,ug,ug,ug,ug,ug,ug,ug,ur,ur,ur,ur
ux,cr,ux,ur,ug,ug,ug,ug,ub,ub,ub,ub,ug,ug,ug,ug,ug,ug,ug,ug,ux,ur,ur
ux,ur,ur,ur,ug,ug,ug,ug,ub,ub,ub,ub,ug,ug,ug,ug,ug,ug,ug,ug,ux,ur,ur
ux,ur,ur,ur,ur,ur,ug,ug,ub,ub,ub,ug,ug,ug,ug,ux,ux,ug,ug,ug,ux,ur,ur
ur,ur,ur,ur,ur,ug,ug,ug,ub,ub,ub,ug,ug,ug,ug,ux,ux,ug,ug,ux,ux,ur,ur
cg,ur,ur,ug,ur,ug,ug,ub,ub,cb,ur,ur,ur,ur,ug,ug,ug,ug,ug,ux,ux,ur,ur
ur,ur,ur,ur,ub,ub,ub,ub,ub,ub,cb,ux,ux,ux,ux,cg,ug,ug,ug,ux,ux,ur,ur
ur,ur,ur,ub,ur,ug,ug,ug,ug,ur,ur,ux,ux,ux,ux,ux,ux,ug,ug,ux,ux,ur,ur
ur,ur,ur,ub,ug,cg,cr,ur,ur,ur,ur,ur,ur,ur,ur,ur,ur,ur,ur,ur,ur,ur,ur
ur,ur,ur,ur,ug,ub,cb,ub,ub,ur,ur,ug,ug,ug,ug,ug,ug,ur,ur,ur,ur,ur,ur
cg,ub,ub,ur,ug,ub,ub,ub,ub,ub,ug,ug,ux,ux,ux,ub,ug,ug,ug,ug,ug,ug,ur
ux,ub,ub,ur,ug,ub,ub,ug,ug,ug,ug,ub,ub,ux,ux,ub,ux,ux,ux,ur,ux,ug,ux
ub,ub,ub,ur,ug,ub,ub,ug,ub,ug,ug,ub,ug,ug,ug,ub,ux,ux,ux,ug,ug,ug,ux
cr,ux,ux,ur,ug,ug,ub,ub,ub,ug,ug,ub,ub,ub,ug,ug,ug,ug,ug,ug,ux,ux,ux
cg,ux,ux,ur,ux,cg,ug,cb,ub,ux,ux,ux,ux,ug,ux,ug,ux,ug,ug,ug,ux,cb,cr
cr,ux,ux,ur,ur,ub,ug,ug,ug,ug,ug,ug,ug,ug,ug,ug,ug,ug,ug,ug,cb,ux,cr