ur,ur,ur,ur,ur,ur,ur,ur,ur,ur,cr,ur,ur,ur,cb,ub,ub,ub,ub,ub,ub,ur,cb
ur,ur,ur,ur,ur,ur,ur,ur,ur,ur,ug,ug,ug,ur,ur,ur,ur,ur,ur,ur,ub,ur,ur
ur,ur,ur,ur,ur,ur,ur,ur,ur,ur,ub,ub,ug,ug,ug,ug,cg,ub,ub,ub,ub,ur,ur
ur,ur,ur,ur,ur,ur,ur,ur,ur,cr,ur,ur,ur,ug,ur,ur,ug,ur,ux,ur,ur,ux,ur
ur,ur,ur,ur,ur,cr,cr,ur,ug,ur,ug,ug,ub,ug,ux,ug,ug,ur,ur,ur,cr,ur,ur
ur,ub,ug,ug,ur,ur,ub,ur,ur,ur,ug,ug,ub,ug,ux,ug,ug,ug,ux,ux,ux,ur,ux
ub,ub,ug,ug,ug,cb,cb,ug,ub,ub,ub,ub,ub,ub,ub,ub,ug,ug,ux,ux,ux,ux,ux
ub,ub,ug,ug,ur,ub,ub,ub,ux,ub,ug,ug,ug,ug,ux,ub,ug,ug,ux,ux,ux,ux,ux
cg,ub,ug,ub,ub,ub,ub,ub,ux,ub,ub,ub,ug,ub,ub,ub,ug,ug,ux,ux,ux,ux,ux
ur,ur,ug,ug,ur,ur,ub,ub,ub,ub,ub,ub,ur,ur,ur,ur,ur,ur,ur,ur,ur,ur,ur
ur,ub,ux,ug,ug,ux,ux,ux,ub,ub,ub,ub,ub,ub,ub,ug,cg,ux,ub,ub,ux,ux,ur
ur,ux,ux,ug,ug,ux,ux,ux,ux,ug,ub,ub,ub,ub,ug,ug,ug,ub,ub,ub,ux,ux,ur
ur,ux,ux,ug,ug,ux,ug,ug,ug,ug,cb,ub,ub,ub,ug,ub,ub,ub,ub,ub,ub,ux,ur
ur,ux,ux,ug,ug,ub,ug,ug,ug,ug,ub,ub,ub,ug,ug,ug,ub,cb,ub,ux,ub,ux,ur
ur,ux,ux,ug,ug,ub,ug,ug,ug,ug,ug,ub,ug,ug,ug,ug,ug,ub,ub,ux,ub,ux,ur
ur,ux,ux,ug,ug,ub,ug,ug,ug,ug,ug,ug,ug,ug,ug,ug,ug,ub,cr,ur,ur,ur,ur
ur,ux,ux,ug,ug,ur,ug,ur,ub,ug,ug,ug,ug,ug,ug,ug,ug,ub,ub,ub,ub,ub,ur
ur,ux,ux,ug,ug,ux,ug,ug,ug,ug,ug,ug,ug,ug,ug,ug,ug,ux,ub,ub,ug,ub,ur
ur,ur,ur,ug,ug,ug,cg,ur,ur,ur,ur,ur,ur,ur,ug,ug,ug,ur,ur,ur,ur,ub,ub
ur,ur,ux,ub,ux,ux,ux,ux,ux,ux,ux,ux,ux,ux,ux,ug,ug,ug,ug,ug,ux,ux,ub
ur,ur,ub,ub,ux,ux,ux,ux,ux,ux,ux,ux,ux,ux,ux,ux,ux,ux,ux,ux,ux,ux,ux
ur,ur,ub,ux,ux,ux,ux,ux,ux,ux,ux,ux,ux,ux,ux,ux,ux,ux,ux,ux,ux,ux,ux
ur,ur,ux,ux,ux,ux,ux,ux,ux,ux,ux,ux,ux,ux,ux,ux,ux,ux,ux,ux,ux,ux,ux