ur,ur,ur,ur,ur,ur,ur,ur,ur,cg,ur,ub,ub,ub,ub,ug,ur,cb,ub,ux,ux,ux,ux
ur,ur,ur,cg,ug,ur,cr,ur,ur,ub,ur,cr,ub,ub,ub,ug,ug,ug,ug,ug,ug,ug,ug
ur,ur,ur,ur,ur,cr,ur,ur,ur,ur,ur,cb,ub,ub,ub,ug,ub,ub,ux,ux,ux,ux,ug
ur,ur,ur,ur,ub,ur,ur,ug,ub,cr,ub,ub,ub,ub,ub,ug,ux,ux,ux,ux,ux,ux,ug
ur,ur,ur,ur,ur,ur,ug,ub,ub,ub,ub,ub,ub,ub,ub,ug,ug,ug,ug,ug,ux,ub,cg
ur,ur,ur,ur,ug,ug,ug,ug,ug,ux,ub,ub,ub,cb,ug,ux,ux,ux,ux,ug,ux,ub,ux
ur,ur,ur,ur,cr,ub,ub,ub,cb,ub,ub,ub,ub,ub,ub,ub,ub,ux,ux,ug,ux,ub,ux
ur,ub,ub,ub,cb,ub,ub,ub,ub,ub,ub,ub,ub,ub,ub,ub,ub,ug,ux,ug,ux,ub,ux
ur,ub,ur,ur,ur,ub,ub,ub,ub,ub,ub,ub,ub,ub,ub,ub,ub,ug,ux,ug,ux,ub,ux
ub,ub,ub,ub,ug,ug,ug,ub,ub,ub,ub,ub,ub,ug,ug,ug,ug,ux,ux,ug,ux,ub,ux
ub,ub,ur,ux,ug,ug,ug,ur,ur,ur,ur,ub,ub,ug,ug,ug,ug,ug,ug,ug,ub,ub,ux
ub,ub,ur,ur,ug,ug,ug,ub,ug,ub,ub,ub,ub,ug,ug,ug,ux,ug,ub,ub,ux,ux,ux
ub,ub,ux,ur,ug,ug,ug,ub,ug,ub,ub,ub,ub,ub,ug,ug,ug,ug,ug,ug,ug,ug,ug
ub,ub,ub,ub,ug,ug,ug,ub,ug,ug,ub,ub,cg,cg,ug,ug,ur,ur,ur,ur,ur,ur,ur
ub,ux,ux,ux,ug,ub,ug,ub,ub,ub,ub,cb,ug,ug,ug,ug,ur,ur,ur,ur,ur,ur,ur
ub,ux,ux,ux,ub,ub,ug,cg,ub,ug,ug,ug,ub,ub,ur,ug,ug,ug,ug,ux,ux,ux,ux
ub,ub,ub,ub,ub,ug,ug,ug,ux,ug,ug,ug,ug,ug,ur,ux,ux,ux,ux,ux,ux,ux,ux
ug,ub,ux,ub,ub,ug,ug,ug,ub,ub,ug,ug,ux,ux,ur,ux,ux,ux,ux,ux,ux,ux,ux
ub,ub,ux,ux,ub,ux,ug,ug,ub,ub,ux,ub,ux,ux,ur,ux,ux,ux,ux,ux,ux,ux,ux
ub,ux,ux,ux,ub,ub,ub,ub,ux,ux,ub,ub,ux,ux,ur,ux,ux,ux,ux,ux,ux,ux,ux
ub,ub,ub,ub,cb,ub,ur,ub,ux,ux,ub,ub,ux,ux,ur,ux,ux,ux,ux,ux,ux,ux,ux
cr,ux,ux,ub,ub,ub,ub,ub,ux,ux,ux,ub,ux,ux,ur,ux,ux,ux,ux,ux,ux,ux,cb
cg,ux,ux,ux,ub,ub,ub,ub,ux,ux,ux,ux,ux,ux,ur,ur,ur,ur,ur,cr,ux,ux,ux