ur,ur,ur,ur,ur,ur,ux,ux,ux,ur,ur,ur,ur,ur,ur,ur,cb,ub,ux,ub,ub,ux,ux
ur,ur,ur,ur,ur,ur,ur,ur,ur,ub,ub,ur,ur,ur,ur,ur,ub,ub,ub,ub,ux,ux,ux
ur,cr,ur,ur,ur,ur,ur,ub,ub,ub,ub,ug,ug,ug,ux,ur,ur,ur,ub,ub,ur,ur,ur
ur,ub,cb,cr,ug,ur,ur,ub,ur,ub,ub,ux,ur,ug,ub,ub,ub,ub,ub,ub,ub,ub,ur
ur,ub,ux,ur,ur,ur,cb,ub,ug,ub,ug,ug,ug,ug,ub,ug,ug,ub,ux,ub,ub,ub,ur
ux,ub,ur,ur,ug,ur,ur,ur,cr,ug,ug,ub,ub,ub,ub,ug,ug,ub,ub,ux,ux,ux,ur
ub,ub,ur,ur,ur,ur,ur,cr,ug,ug,ug,ug,ug,ur,ub,ug,ug,ub,ub,ub,ux,ux,ur
ub,ub,ur,ur,ur,ur,ur,ur,ur,ub,ug,ub,ug,ux,ub,ug,ug,ub,ux,ux,ux,ux,ur
cg,ub,ur,ur,ur,ug,ur,ur,cg,ug,ug,ub,ug,ux,ub,ub,ub,ub,ux,ux,ux,ux,ur
ub,ub,ur,ur,ur,ug,ug,ug,ug,ub,ub,ub,ug,ub,ux,ux,ux,ub,ub,ux,ux,ux,ur
ub,ur,cr,ux,ur,ur,ur,ur,ug,ug,ub,ub,ub,ub,ux,ux,ux,ub,ub,ux,ux,ux,ur
ub,ux,ur,ur,ur,ur,ur,ur,ub,cg,ub,ub,ub,ub,ub,ux,ub,ub,ub,ub,ux,ux,ur
ub,ub,ur,ux,ux,ug,ug,ub,ux,ug,ub,ub,cb,ub,ub,ub,ub,ub,ub,ub,ux,ux,ur
ub,ub,ug,ux,ug,ug,ux,ub,ub,ub,ug,ub,ub,ub,cb,ub,ub,ub,ux,ux,ux,ux,ur
ub,ub,ub,ux,ug,ux,ug,ub,ub,ub,ug,ux,ub,ux,ug,ug,ug,ub,ux,ux,ux,ux,ur
ub,ub,ub,ux,ug,ux,ug,ub,ub,ug,ug,ug,ug,cg,ug,ug,ug,ub,ux,ub,ub,ub,ur
ub,ub,ug,ux,ug,ug,ux,ug,ub,ug,ug,ug,ux,ux,ug,ug,ub,ub,ux,ub,ux,ub,ur
ub,ub,ug,ux,ux,ug,ub,cb,ub,ux,ug,ug,ux,ux,ug,ug,ug,ub,ub,ub,ux,ub,ur
ub,ub,ub,ub,ub,ub,ub,ub,ub,ub,ub,ub,ub,ub,ub,ub,ub,ub,ub,ub,ub,ub,ur
ub,ub,ub,ub,ub,ub,ub,ub,ub,ub,ub,ub,ub,ub,ub,ux,ux,ub,ux,ux,ux,ux,ur
ub,ub,ub,ub,ub,ub,ub,ub,ub,ub,ub,ux,ug,ug,ug,ux,ux,ub,ux,ux,ux,ux,ur
ug,ux,ux,ux,ub,ub,ub,ub,ub,ub,ub,ub,ub,ub,ub,ub,ub,ub,ux,ux,ux,ux,ur
cr,ur,ur,ur,ur,ur,ur,ur,ur,ur,ur,ur,ur,ur,ur,ur,ur,ur,ur,ur,ur,ur,ur