ur,ur,ur,ur,ur,ur,ur,ur,ur,ur,ur,ur,ur,ur,ur,ur,ur,ur,ur,ur,ur,ur,ur
ur,ur,ur,ur,ur,ur,ur,ur,ur,ur,ur,ur,ur,ur,ur,ur,ur,ur,ur,ur,ur,ur,ur
ur,ur,ur,ur,ur,ur,ur,ux,ur,ur,ur,ur,ur,ur,ur,ur,ur,ur,ur,ur,ur,ur,ur
ur,ur,ur,ur,ur,ur,ur,ur,ur,ur,ur,ur,ur,ur,cb,ub,ur,ur,ur,ur,ur,cr,cr
ur,ur,ur,ur,ur,ur,ur,ur,ur,ur,ur,ur,cr,ub,ur,ub,ur,ur,ur,ur,ur,ur,ub
ur,ur,ur,ur,ur,ur,ur,ur,ur,ur,ur,ur,cr,ub,ur,ub,ur,ur,ur,ub,ub,ub,ub
ur,ur,ur,ur,ug,ur,ug,ug,ug,ug,ub,ub,ub,cb,ur,ub,ur,ub,ux,ub,ub,ub,ub
ur,ur,ur,ug,cr,ur,ug,ug,ux,ur,ub,ub,ub,ub,ub,ub,ux,ub,ux,ub,ub,ub,ub
ur,ur,ur,ur,ug,ur,ug,ug,ug,ug,ug,cb,ub,ub,ub,ub,ux,ub,ux,ub,ub,ub,ub
ur,ur,ur,ug,ug,ug,ug,ug,ug,ug,ux,ug,ug,ub,ub,ub,ub,ub,ux,ub,ub,ub,ub
ur,ur,ur,ug,ug,ug,ur,ug,ub,ub,ug,ug,ug,ub,ub,ug,ub,ub,ug,ub,ub,ub,ub
ur,ur,ur,ug,ug,ug,ux,ug,ug,ub,ub,ub,ub,ub,ug,ug,ub,ub,ug,ub,ub,ub,ub
ur,ub,ub,ub,ug,ug,ux,ug,ub,ub,ub,ub,ub,ub,ug,ux,ub,ub,ug,ub,ub,ub,ub
ur,ub,ub,ub,ug,ug,ux,ug,ub,ux,ub,ub,ub,ub,ug,ux,ub,ub,ug,ub,ub,ub,ub
ux,ub,ub,ub,ug,cg,ux,ub,ub,ub,ug,ub,ub,ub,ug,ux,cg,ub,ug,cg,ub,ub,ub
ux,ux,ub,ub,ug,ug,ug,ub,ub,ub,ub,ub,ub,ub,ug,ux,ug,ub,ug,ug,ub,ub,ub
ux,ux,ub,ug,ux,ub,ub,ub,ub,ub,cb,ub,ub,ub,ug,ug,ug,ub,ux,ug,ub,cb,ub
ux,ux,ub,ug,ub,ub,ub,ub,ub,ub,ub,ug,ug,ub,ux,ux,ux,ux,ux,ug,ug,ur,ug
ux,ux,ux,ug,ub,ug,ub,ux,ux,ub,ub,ub,ux,ub,ux,ux,ux,ux,ux,ug,ub,ur,ug
ux,ux,ux,ug,ux,ug,ub,ub,ug,ub,ug,ug,ug,ug,ug,ug,ug,ug,ug,ug,ub,cr,ug
ux,ux,ux,ug,ub,ux,ux,ub,ub,ub,ub,ux,ux,ub,ux,ux,ux,ug,ug,ug,ug,ug,ug
ux,ux,ux,ug,ub,ux,ux,ux,ub,ub,ub,ux,ux,ux,ux,ux,ux,ug,ux,ub,ub,ux,ub
cb,ux,ux,ug,ug,ug,ug,ug,ub,ub,ug,ug,ug,ug,ug,ug,ug,ug,ub,ub,ub,ub,ub