ur,cr,cr,ur,ur,ur,ur,ur,cg,ug,ug,ug,ug,ug,ug,ug,ug,ug,ug,ug,ug,ug,ug
ur,ur,ub,ur,ur,ur,ur,ur,ug,ur,ur,ur,ur,ur,ur,cr,ur,ur,ur,ux,ux,ux,ug
ub,ub,ub,ub,ur,ur,ur,ur,ur,ur,ur,ur,ur,ur,ur,ur,ur,cb,ur,ub,ub,ub,ug
cb,ur,ur,ur,ur,ur,ur,ur,ur,ub,ub,ub,ub,ub,ub,ub,ub,ub,ur,ux,ux,ux,ug
ur,ur,ur,ur,ur,ur,ur,ur,ur,cr,ub,ub,ub,ux,ux,ux,ub,ub,ur,ux,ux,ux,ug
ur,ur,ur,ur,ur,ur,ur,ur,ur,ur,ug,ub,ub,ub,ub,ub,ub,ub,ur,ux,ux,ux,ug
ur,ur,ur,ur,ur,ur,ur,ur,ur,ur,ug,ug,ug,ub,ug,ug,ux,ux,ur,ux,ux,ux,ug
ub,ur,ur,ur,ur,ur,ur,ur,ug,ug,ug,ug,ub,ub,ub,ub,ub,ub,ur,ux,ux,ux,ug
cg,ur,ur,ur,ub,ur,ur,ub,ub,ub,ug,ug,ub,ub,ub,ub,ub,ub,ub,ub,ur,ur,ur
ux,ux,ux,cr,ur,ur,ub,ub,ub,ub,ug,ug,ub,ub,ub,ub,ub,ub,ub,ux,ux,ux,ur
ux,ux,ux,ux,ub,ub,ub,ub,ub,cb,ug,ug,ug,ug,ub,ub,ub,ux,ub,ub,ub,ub,ur
ux,ux,ux,ux,ux,ub,ub,ub,ub,ub,cb,ug,cg,ug,ub,ub,ux,ux,ux,ux,ux,ux,ur
ux,ux,ux,ux,ux,ux,ub,ub,ub,ub,ub,ub,ub,ug,ub,ub,ux,ux,ux,ux,ux,ux,ur
ux,ux,ux,ux,ub,ux,ux,ux,ug,ug,ug,ug,ug,ug,ub,cb,ux,ux,ux,ux,ux,ux,ur
ux,ux,ux,ux,ub,ub,ub,ub,ug,ug,ug,ug,ug,ug,ux,ux,ux,ux,ux,ux,ux,ux,ur
ug,ug,ug,ug,ug,ub,ub,ug,ug,ug,ug,ug,ux,ux,ux,ux,ux,ux,ux,ux,ux,ux,ur
ug,ux,ux,ux,ux,ux,ub,ub,ug,ug,ug,ux,ux,ux,ux,ux,ux,ux,ux,ux,ux,ux,ur
ug,ux,ux,ux,ux,ur,ub,ub,cb,ug,ux,ux,ux,ux,ux,ux,ux,ux,ux,ux,ux,ux,ur
ug,ux,ur,ur,ux,ur,ub,ub,ub,cg,ux,ux,ux,ux,ux,ux,ux,ux,ux,ux,ux,ux,ur
ug,ux,ur,ux,ux,ur,ub,ub,ub,ub,ux,ux,ux,ux,ux,ux,ux,ux,ux,ux,ux,ux,cr
ug,ub,ub,ub,ux,ub,ub,ub,ub,ub,ux,ux,ux,ux,ux,ux,ux,ux,ux,ux,ux,ux,ug
ug,ux,ur,ub,ux,ub,ux,ub,ub,ux,ux,ux,ux,ux,ux,ux,ux,ux,ux,ux,ux,ux,ug
ug,ug,ug,ug,ug,ub,ub,ub,ug,ug,ug,ug,ug,ug,ug,ug,ug,ug,ug,ug,ug,ug,ug