ub,cb,cb,ux,ux,ux,ux,cr,ur,ur,ux,ux,ux,ux,ux,ux,ux,ux,ux,cg,ux,cb,ub
cr,ur,ux,ux,ux,ux,ux,ux,ux,ur,ux,ur,ur,ur,ur,ur,ur,ux,ux,ux,ux,ux,ub
ub,ux,ur,ur,ur,ux,ux,ux,ux,ur,ux,ur,ur,ux,ux,ur,ur,ux,ux,ux,ux,ux,ub
ub,ux,ur,ux,ur,ux,ux,ur,ux,ur,ux,ur,ur,ur,ur,ur,ux,ux,ux,ux,ux,ux,ub
ub,ub,ur,ur,ur,ur,ur,ur,ug,ur,ur,ur,ur,ur,ur,ur,ur,ur,ur,ux,ux,ux,ub
ub,ub,ur,ur,ur,ur,cg,ur,ug,ur,ur,ur,ur,ur,ug,ur,ur,ur,ur,ux,ux,ux,ub
ur,ur,ur,ur,ur,ug,ug,ur,ug,ur,cb,ub,ur,ur,ug,ur,ur,ur,ur,ur,ur,ur,cr
ur,ur,ur,ur,ur,ug,ug,ur,ug,ug,ug,ub,ub,ug,ug,ug,ug,ur,ur,ur,ur,ur,ur
ur,ur,ur,ur,ur,ur,ug,ur,ur,ur,ur,ub,ub,ug,ug,ur,ug,ur,ug,ug,ur,ur,ub
ur,ur,ur,ur,ur,ur,ug,ur,ur,cr,ur,ur,cg,ug,ug,ub,ug,cg,ug,ur,ur,ur,ub
ur,ur,ur,ur,ur,ur,ug,ug,ug,ug,ur,ur,ug,ug,ug,ur,ug,ug,ug,ur,ur,ux,ub
ur,ur,ur,ub,ub,cr,ug,ug,ur,ur,ur,ur,ur,ur,ug,ug,ug,ug,ug,ur,ur,ux,ub
cg,ur,ur,cb,ur,ur,ur,ur,ur,ur,ur,ur,ur,ur,ug,ux,ux,ux,ug,ur,ur,ux,ub
ur,ur,ur,ur,ur,ur,ur,ur,ur,ur,ur,ux,ug,ub,ub,ux,ux,ug,ug,ur,ur,ug,ub
ur,ur,ur,ub,ug,ug,ug,ur,ur,ur,ur,ub,ug,ug,ug,ug,ug,ug,ub,ub,ur,ug,ub
ur,ur,ur,ub,ug,ub,ug,ub,ub,ug,ug,ub,ub,ub,ux,ux,ug,ug,ug,ug,ug,ug,ub
ur,ur,ur,ur,ug,ub,ug,ug,ug,ur,ur,ur,ur,ur,ur,ur,ur,ur,ur,ur,ur,ur,ub
cg,ub,ub,ur,ug,ub,ub,ub,ub,cb,ub,ub,ux,ux,ux,ub,ub,ub,ub,ub,ub,ub,ub
ub,ub,ub,ur,cg,ub,ub,ub,ub,ub,ub,ub,ub,ux,ux,ub,ux,ub,ub,ub,ur,ub,ur
ub,ub,ub,ur,ux,ub,ub,ub,cb,ux,ub,ub,ug,ug,ug,ub,ux,ub,ub,ub,ur,ub,ur
cr,ub,ug,ur,ux,ub,ub,ux,ug,ug,ug,ub,ub,ub,ug,ug,ug,ug,ug,ur,ur,ur,ur
cg,ub,ug,ur,ux,ub,ub,ux,ub,ub,ub,ub,ug,ug,ub,ug,ub,ug,ug,ur,ur,cb,cr
cr,ub,ub,ur,ur,ur,ur,ur,cr,ub,ug,ug,ug,ub,ub,ug,ug,ug,ur,ur,cb,ux,cr