ur,ur,cb,ur,ur,ur,ur,ur,ur,ur,ur,ur,cb,ur,ur,ur,cr,ub,ub,cg,ug,ug,ug
ur,ur,ur,ur,ur,ur,ur,ur,ur,ur,ur,ux,ub,ub,ub,ub,ub,ub,ub,ur,ur,ug,ur
ur,ur,ur,ur,ux,cg,ur,ur,ur,ur,ur,ug,ug,ug,ug,ur,ur,ur,ur,ur,ur,ur,cr
ur,ur,ur,ur,cr,ug,ur,ur,ur,ur,ur,ug,ur,ur,ug,ur,ur,ur,ur,ub,ur,ug,ug
ur,ur,ur,cr,ur,ug,ug,ug,ug,ug,ur,ug,ur,ug,ug,ug,ug,ug,ub,ux,ur,ux,ug
ur,ux,ux,ur,ur,ur,ur,ur,ur,ug,ug,ug,ur,ug,ur,ug,ux,ug,ux,ux,ur,ux,ug
ur,ur,ur,ur,ur,ur,ur,ur,ur,ur,ur,ur,ug,ug,ur,ug,ux,cg,ux,ux,ur,ux,ug
ur,ur,ur,ur,ur,ur,ur,ur,ur,ur,ug,ur,ug,ur,ub,ug,ug,ux,ux,ux,ur,ug,ug
ur,ur,ur,ur,ur,ur,ur,ur,ur,ug,ug,ub,ub,ug,ug,ug,ub,ub,ub,ux,ur,ux,ug
ur,ur,ur,ur,ur,ur,ur,ug,ug,ug,ug,ub,cb,ub,ug,ug,ub,ub,ub,ux,ur,ux,ug
ur,ur,ur,ux,ux,ux,ug,ug,ug,ug,ug,ub,ub,ub,ub,ug,ub,ub,ub,ub,ur,ub,ub
cr,ux,ux,ux,ux,ux,ug,ug,ug,ub,ug,ub,ub,ub,ub,ub,ub,ub,ux,ug,ur,ug,ub
cg,ux,ux,ux,ux,ux,ug,ug,ug,ux,ub,ug,ub,cb,ub,ub,ub,ub,ub,ub,ur,ug,ub
ux,ux,ux,ux,ux,ux,ug,ux,ug,ug,cg,ub,ub,ub,ux,ug,ub,ux,ub,ub,ur,ug,ub
ux,ux,ux,ux,ux,ux,ug,ug,ug,ug,ub,ub,ub,ub,ub,ug,ub,ub,ub,ub,ur,ug,ub
ux,ux,ux,ux,ux,ux,ux,ux,ux,ug,ux,ub,ub,ug,ug,ug,ub,ub,ub,ub,ur,ug,ub
ux,ux,ug,ug,cg,ux,ux,ux,ux,ux,ux,ub,ub,ug,ub,ub,ub,ub,ug,ug,ur,ug,ub
cg,ux,ug,ux,ux,ux,ux,ux,ux,ux,ux,ub,ub,ug,ub,ug,ub,ub,ug,ug,ub,ub,ub
ux,ux,ug,ux,ux,ux,ux,ux,ux,ux,ux,ub,ub,ug,ub,ux,ug,ub,ug,ug,ub,ub,ub
ux,ux,ug,ux,ux,ux,ux,ux,ux,ux,ug,ug,ub,ub,ub,ub,ug,ug,ub,ub,ub,ub,ub
cr,ux,ug,ux,ux,ux,ux,ux,ux,ux,ug,ux,ub,ug,ub,ub,ug,cb,ub,ub,ub,ub,ub
cg,cb,ug,ug,ug,ug,ug,ug,ug,ug,ug,ux,cb,ub,cr,ur,ur,ub,ub,ub,ub,cb,cr
cr,ux,ug,ug,ug,ug,ug,ug,ug,ug,ug,ug,ug,ub,ug,ug,ub,ub,ub,ub,cb,ux,cr