ub,cr,ur,ur,ur,ur,ur,cr,ur,ur,ur,ur,ur,ur,ur,ur,ur,ur,ur,ur,ur,ur,ur
cb,ur,ur,ur,ur,cr,ur,cr,ux,ub,ur,ur,ur,ur,ur,ur,ub,ub,ub,ur,ur,ur,ur
ur,ur,ur,ur,ur,ur,ux,ux,ux,ub,ub,ur,ur,ur,ur,ur,ub,ub,ub,ur,ur,ur,ur
ur,ur,ur,ur,ur,ur,ur,ur,ur,ur,ub,ub,ub,ub,ub,ub,ub,ub,ub,ur,ur,ur,ur
ur,ur,ur,ur,ur,ur,ub,ub,ub,ur,ur,ur,ur,ur,ur,ur,ub,ub,ub,ur,ur,ub,ub
ur,ur,ur,ur,ur,ur,ur,ur,ub,ug,cg,ug,ug,ur,ur,ub,ub,ur,cb,ur,ub,ub,ub
ur,ur,ur,ux,ur,ur,ur,ur,ub,ug,ug,ug,ug,ug,ug,ub,ub,ub,ub,ub,ub,ub,ub
ur,ur,ur,ur,ur,cg,ug,cb,ub,ug,ug,ug,ug,ug,ug,ub,ub,ub,ub,ub,ug,ux,ux
cg,ur,ur,ur,ur,ur,ur,ub,ub,ug,ug,ug,ub,ub,ub,ub,ux,ux,ux,ux,ug,ux,ub
ur,ur,ur,ur,ur,ur,ur,ug,ug,ub,ub,ug,ub,ug,ub,ux,ux,ux,ux,ug,ug,ux,ub
ur,ur,ur,ur,cr,ub,ub,ub,ub,ub,cb,ub,ub,ug,ug,ug,ug,ug,ug,ug,ux,ux,ub
ur,ur,ur,ur,ur,ub,ub,ub,ub,ub,ub,ub,ub,ub,ub,ub,ug,ug,ub,ux,ux,ux,ub
ur,ur,ur,ur,ur,ub,ux,ub,ub,ub,ub,ub,ub,ub,ug,ug,ug,ug,ub,ux,ux,ux,ub
ux,ux,ux,ux,ux,ub,ub,ub,ub,ub,ub,ub,ub,ub,ub,ub,ug,ug,ug,ug,ug,ug,ug
cg,ux,ux,ux,ux,cb,ub,ub,ub,ub,ub,ux,ug,ug,ug,ug,ug,ub,ub,ux,ux,ux,ug
ug,ug,ug,ug,ug,ug,ub,ub,ug,ug,ug,ug,ug,ug,ug,ug,ug,ug,ug,ug,ug,ug,ug
cr,ux,ux,ux,ub,ub,ub,ub,ub,ux,ug,ug,ug,ux,ug,ug,ug,ux,ux,ux,ux,ux,ug
ur,ux,ux,ux,ub,ub,ub,ub,ub,ux,ug,ux,ug,ux,ug,ux,ux,ux,ux,ux,ux,ux,ug
cb,ux,ux,ux,ux,ub,ub,ub,ux,ug,ug,ux,ug,ug,ug,ux,ux,ux,ux,ux,ux,ux,ug
ub,ux,ux,ux,ux,ux,ux,ux,ux,ux,ux,ux,ux,ux,ux,ux,ux,ux,ux,ux,ux,ux,ug
ub,ub,ub,ub,ub,ub,ub,ub,ub,ub,ub,ub,ub,ub,ub,cg,ug,ug,ug,ug,ug,ug,ug
ur,ux,ux,ux,ux,ux,ux,ux,ux,ux,ux,ux,ux,ux,ux,ux,ux,ux,ux,ux,ux,ux,cb
ur,ux,ux,ux,ux,ux,ux,ux,ux,cg,ux,ux,ux,ux,ux,ux,ux,ux,ux,ux,ux,ux,ux