ug,ug,cr,ur,ub,cb,ur,ur,ur,cr,ug,ug,ug,ug,ug,ug,ug,ug,ug,ug,ug,ub,ub
ug,ur,ur,ur,ur,ub,ur,ur,ur,ub,ub,ub,ub,ur,ur,ur,ur,ur,ur,ur,ub,ub,ub
ug,ur,ur,ur,ur,ur,ur,ur,ur,ur,ur,ur,ub,ub,ub,ub,ub,ub,ub,ub,ub,ur,ub
ug,ur,ur,ur,ur,ur,ur,ur,ur,ur,ur,ur,ur,ur,ur,ur,ux,ur,ux,ux,ux,ub,ub
ug,ur,ur,ur,ur,ur,ur,ug,cr,ur,ur,ur,ur,ur,ug,ug,ur,ur,ux,ub,ub,ub,ug
ug,ur,ur,ur,ur,ur,ur,ug,ur,ur,ur,ur,ur,ur,ub,ug,ug,ur,ux,ub,ux,ux,ug
cg,ur,ur,ur,ur,ur,ur,cg,ur,ur,ur,cb,ub,ub,ug,ug,ug,ur,ur,ub,ub,ub,ub
ur,ur,ur,ur,ur,ur,ur,ur,ur,ug,cr,ug,ub,ub,ub,ub,ub,ur,ur,ur,ux,ub,ub
cg,ur,ur,ur,ur,ur,ur,ur,ur,ug,ub,ur,ur,ub,ur,ur,ug,ur,ur,ug,ub,ub,ug
ur,ur,ur,ur,ur,ur,ur,ur,ur,ug,ub,ub,ub,ub,ur,ug,ug,ub,ug,ug,ub,cb,ug
ur,ur,ur,ub,ur,ur,ur,ub,ub,ug,ub,ux,ub,ug,ug,ug,ug,ug,ug,ug,ux,ux,ug
ur,ur,ub,cb,ur,ub,ub,ub,cg,ug,ur,ur,ur,ur,ur,ur,ur,ur,ur,ur,cr,ux,ug
ur,cr,ub,ux,ub,ub,ub,ub,ug,ug,ub,ub,ub,ub,ub,ub,ub,ub,ub,cb,ux,ug,ug
ux,ux,ub,ub,ub,ux,ub,cb,ub,ub,ub,ub,ub,ug,ux,ux,ub,ug,ux,ug,ux,ug,ub
cg,ux,ux,ux,ur,ux,ub,ub,ub,ub,ub,ub,ub,ub,ub,ub,ub,ug,ux,ug,ux,ug,ub
ux,ux,ux,ux,ur,ux,ux,ux,ur,ub,ub,ux,ux,ug,ux,ub,ux,ug,ug,ug,ux,ug,ub
ux,ux,ux,ux,ur,ux,ux,ux,ur,ub,ub,ub,ux,ug,ux,ux,ux,ux,ux,ux,ux,ug,ub
ux,ux,ux,ux,ur,ux,ux,ux,ur,ux,ux,ub,ub,ug,ux,ux,ux,ux,ux,ux,ux,ug,ub
ux,ux,ux,ux,ur,ux,ux,ux,ur,ux,ux,ux,ux,ug,ub,ub,ub,ub,ub,ux,ux,ug,ub
ux,ux,ux,ux,ur,ux,ux,ux,ur,ux,ux,ux,ux,ug,ux,ux,ux,ug,ug,ug,ug,ug,ub
ux,ux,ux,ux,ur,ux,ux,ux,ur,ux,ux,ux,ux,ug,ug,ug,ug,ug,ux,ub,ub,ux,ub
ux,ux,ux,ux,ur,ux,ux,ux,ur,ux,ux,ux,ux,ux,ux,ux,ux,ux,ux,ux,ub,ub,ub
ux,ux,ux,ux,ur,ur,ur,ur,ur,cg,ux,ux,ux,ux,ux,ux,ux,ux,ux,ux,ux,ub,ub