ur,ur,ur,cr,ub,ub,ub,ub,ur,ur,ur,ur,ur,ur,ur,ur,ur,ub,ub,ub,ur,ur,ur
ur,ur,ur,ur,ur,ur,ur,cb,ur,ub,ur,ur,ub,ur,cr,ur,ur,ub,ub,ub,ur,ux,ur
ur,ur,ur,ur,ur,ur,ur,ur,ur,cr,cr,ur,ur,ur,ub,ub,ub,ub,ub,ub,ur,ur,ur
ur,ux,ur,ur,ur,ur,ur,ur,cr,ub,ub,ur,ub,ub,cg,ub,ub,ux,ur,ux,ur,ub,ur
ur,cb,ub,ub,ub,cg,ub,ub,ur,ub,ub,ur,ub,ub,ug,ub,ub,ux,ux,ux,ur,ux,ur
ur,ur,ux,ub,ur,ug,ub,ur,ur,ug,ub,ux,ux,ux,ug,ub,ub,ub,ub,ub,ur,ub,ur
ub,ub,ub,ub,ug,ug,ub,ur,ur,ux,cb,ux,ux,ux,ug,ux,cb,ux,ux,ub,cb,ub,ub
ub,ur,ur,ug,ug,ur,ub,ur,ur,ux,ub,ux,ux,ux,ug,ux,ub,ux,ux,ux,ub,ux,ub
ub,ur,ur,ug,ug,ur,ug,ur,ug,ug,ub,ub,ux,ub,ub,ub,ub,ux,ux,ux,ur,ux,ur
ub,ur,ur,ug,ug,ur,ur,ug,ug,cb,ub,ub,ub,ub,ug,ub,ur,ur,ur,ur,ur,ur,ur
ub,ur,ux,ug,ug,ug,ug,ug,ug,ug,ug,ub,ub,ub,ug,ug,ug,ug,ug,ug,ug,ur,ug
ub,ur,ux,ug,ug,ub,ub,ug,ug,ub,ug,ug,ub,ub,ug,ux,ux,ux,ux,ux,ux,ur,ug
ub,ur,ur,ug,ug,ub,ub,ub,ug,ub,ub,ub,ub,ub,ug,cg,ub,ux,ux,ux,ux,ur,ug
ub,ug,ux,ug,ug,ub,ub,ub,ub,ub,ub,ug,ug,ug,ug,ub,ub,ug,ug,ux,ux,ur,ug
ub,ug,ux,ug,ug,ug,ub,ub,ub,ug,ub,ug,ub,ux,ub,ub,ux,ux,ug,ux,ux,ur,ug
ub,ug,ux,ug,ug,ug,ub,ug,ug,ug,ub,ug,ux,ux,ux,ux,ux,ux,ug,ux,ux,ur,ug
ub,ug,ux,ug,ug,ug,ub,ug,ug,ug,ub,ug,ug,ug,ub,ub,ux,ux,ug,ux,ux,ur,ug
ub,ug,ux,ug,ug,ug,ub,ug,ug,ug,ug,ug,ub,ug,ug,ug,ug,ug,ug,ux,ux,ur,ug
ub,ug,ux,ug,ug,ub,ub,ug,ug,ub,ux,ux,ux,ux,ub,ub,ux,ux,ux,ux,ux,ur,ug
ub,ug,ux,ux,ub,ux,ub,ux,ub,ub,ux,ux,ux,ux,ux,ux,ux,ux,ux,ux,ux,cr,ug
ub,ug,ux,ux,ub,ux,ub,ux,ux,ux,ux,ux,ux,ux,ux,ux,ux,ux,ux,ux,ux,ux,ug
ub,ug,ux,ux,ub,ux,ub,ux,ux,ux,ux,ub,ub,ux,ux,ux,ux,ux,ub,ub,ub,ux,ug
ub,ub,ub,ub,ub,ub,ub,ub,ub,ub,ub,ub,ug,ug,ug,ug,ug,ug,ug,ug,ug,ug,ug