ur,ur,ur,ur,ur,ur,ur,ur,ur,ur,ur,ur,ux,ux,ux,ux,ux,cb,ur,ur,ub,ub,ub
ur,ur,ur,ur,ur,ur,ur,cb,ub,ub,ub,ub,ub,ub,ub,ub,ub,ub,ub,ub,ur,ur,ub
ur,ur,ur,ur,ur,ur,ur,ur,ur,ur,ur,ur,ur,ur,ur,ur,ur,ur,ur,ub,ub,ub,ub
ur,ur,ur,ur,ur,ur,ur,cg,ur,ur,ur,ur,ur,ur,ur,ur,ur,ur,ur,ub,ux,ux,ux
cb,ur,ur,ur,ur,ur,ur,ug,cr,ur,ur,cr,ur,ur,ur,ur,ur,ub,ur,ur,ux,ux,ux
ur,ur,ur,ur,ur,ur,ur,ug,ub,ub,ur,ub,ur,ur,ur,ur,ur,ub,ug,ug,ug,ur,ur
cb,ur,ur,ur,ur,cg,ug,ug,ub,ug,ur,cb,ur,ur,ur,ug,ur,ur,ug,ur,ug,ur,ur
ub,ub,cr,ur,ur,ug,ug,ub,cb,ug,ur,ur,ur,ur,ur,ur,ur,ur,ur,cr,ug,ux,ux
ub,ub,ub,ub,ub,ug,ug,ub,ub,ur,ur,ur,cr,cr,ur,ug,ux,ux,ug,ux,ug,ux,ux
ub,ub,ub,ub,ub,ug,ug,ub,ub,ug,ur,ug,ug,ug,ur,ug,ug,ug,ug,ux,ug,ux,ux
ub,ub,ub,ur,ur,ur,ur,ur,ug,ug,ug,ug,ug,ug,ur,ug,ux,ug,ug,ux,ug,ux,ux
ub,ub,ub,ur,ur,ur,ur,ur,ur,ur,ur,ux,ux,ux,ug,ug,ux,ug,ug,ux,ug,ux,ux
ub,ub,ub,ux,ux,ub,ub,ux,ub,ux,ux,ux,ux,ux,ug,ux,ux,ug,ug,ux,ug,ux,cg
ub,ub,ub,ux,ux,ub,ub,ub,ub,ug,ug,ux,ux,ux,ug,ux,ux,ug,ug,ux,ug,ux,ux
ug,ug,ug,ux,ub,ug,ug,ug,ug,ug,ug,ux,ux,ux,ug,ux,ux,ug,ug,ux,ug,ux,ux
ug,ux,ug,ux,ub,ug,ug,ug,ug,ug,ug,ux,ux,ux,ug,ux,ux,ux,ux,ux,ug,ug,ux
ug,ug,ug,ug,ug,ug,ug,ug,ug,ug,ug,ug,ug,ug,ug,ug,ug,ug,ug,ug,ug,ur,ur
cg,ug,ux,ux,ug,ux,ub,ub,ux,ux,ux,ux,ux,cg,ug,ux,cg,ux,ux,ux,ux,ug,ur
ur,ur,ur,ur,ug,ug,ug,ug,ug,ug,ug,ug,ug,ug,ur,ur,ug,ug,ug,ug,ug,ug,ur
ur,ug,ug,ug,ug,ug,ug,ux,ux,ux,ux,ux,ux,ug,ur,ug,ug,ug,ug,ug,ug,ug,ur
ur,ur,ur,ug,ug,ug,ug,ug,ug,ur,ur,ur,ur,ug,ug,ug,ur,ur,ur,ur,ur,ur,ur
cr,ux,ux,ug,ug,ug,ux,ux,ug,ug,ux,ux,ux,ux,ux,ux,ux,ux,ux,ux,ux,cb,cr
cg,ux,ux,ug,ug,ug,ug,ug,ug,ug,ux,ux,ux,cb,ux,ux,ux,ux,ux,cg,cb,ux,cr