ur,ur,ur,ur,ur,ur,ur,ur,ur,ur,ur,ur,cr,ub,cb,ur,ur,ur,ur,ur,ur,ur,ur
ur,ur,ur,ur,ur,ur,ur,ur,ur,ur,ur,ur,ur,ur,ur,ur,ur,ux,ur,ur,ux,ux,ur
ur,ur,ur,ur,ur,ur,ur,ur,ur,ur,ur,ur,ur,ur,ur,ur,ur,ux,ur,ur,ux,ux,ur
ur,ur,ur,ur,ur,ur,ur,ur,ur,ur,ur,ur,ur,ur,ur,ur,ur,ux,ur,ux,ux,ux,ur
cb,ur,ur,ur,ur,ur,ur,ur,ur,ur,ur,ur,ur,ur,ur,ur,ur,ur,ur,ur,ux,ux,ur
ur,ur,ur,ur,ur,ur,ur,ur,ur,ur,ur,ur,ur,ur,ur,ur,ur,ur,ux,ux,ux,ux,ur
ur,ur,ur,ur,ur,ur,ur,ur,ur,ur,ur,ur,ur,ur,ur,ug,cr,ug,ug,ug,ur,ur,ur
ur,ur,ur,ur,ur,ur,cr,ub,cb,ur,ur,ur,ur,ur,cr,ub,ug,ug,ur,ug,ur,ur,ur
cg,ur,ur,ur,ur,ub,cr,ur,ur,ur,ur,ur,ub,ug,ug,cb,ug,ug,cg,ug,ur,ur,ur
ur,ur,ur,ur,ur,ub,ub,ub,ub,ug,ug,ug,ub,ug,ug,ug,ug,ur,ur,ur,ur,ur,ur
ur,ur,ur,ub,ug,ub,ux,ub,ub,ub,ub,ug,ub,ug,ug,ug,ug,ub,ub,ub,ub,ub,ub
ub,ux,ug,ub,ug,ub,ux,ub,ub,ub,ub,ug,ub,ug,ug,ug,ug,ux,ux,ux,ux,ub,ub
ub,ux,ug,ub,ug,ug,ux,ux,ux,ub,ub,ub,ub,ub,ub,ug,ug,ux,ux,ux,ux,ub,ub
ub,ub,ug,ub,ux,ug,ux,ux,cb,ub,ub,ub,ug,ug,ug,ug,ug,ux,ux,ux,ux,ub,ub
cg,ub,ug,ub,ux,ug,ux,ux,ux,ux,ux,cg,ug,ug,ug,ug,ug,ux,ux,ux,ux,ub,ub
ub,ub,ug,ub,ux,ug,ux,ux,ux,ux,ux,ub,ux,ux,ux,ux,ux,ux,ux,ux,ux,ub,ub
ub,ux,ug,ub,ux,ug,ux,ux,ux,ux,ux,ub,ux,ux,ux,ux,ux,ux,ux,ux,ux,ub,ub
ub,ug,ug,ux,ux,ug,ux,ux,ux,ux,ux,ub,ux,ux,ux,ux,ux,ux,ux,ux,ux,ub,ub
ub,ug,ux,ux,ux,ug,ux,ux,ux,ux,ux,ub,ux,ux,ux,ux,ux,ux,ux,ux,ux,ub,ub
ub,ug,ux,ug,ug,ug,ug,ug,ug,ug,ug,ug,ug,ug,ug,ug,ug,ug,ug,ug,ug,ub,ub
ub,ug,ub,ug,ux,ug,ug,ug,ug,cr,ur,cb,ub,ub,ub,ub,ub,ub,ub,ub,ub,ub,ub
ug,ug,ub,ug,ug,ug,ug,ug,ug,ug,ug,ug,ug,ug,ug,cg,ub,ub,ub,ub,ub,ub,cb
ug,ug,ug,ug,ug,ug,ug,ug,ug,cg,ux,ux,ux,ux,ux,ux,ux,ux,ux,ux,ux,ux,ux