ur,ur,ur,ur,ur,ur,ur,ur,ur,ur,cr,ub,cb,ur,ur,ur,ur,ur,ur,ur,ur,ur,ur
ur,ur,ur,ur,ur,ur,ur,ur,ur,ur,ur,ur,ur,ur,ur,ur,ur,ur,ur,ur,ur,ur,ur
ur,ur,ur,ur,ur,ur,ur,ur,ur,ur,ur,ur,ur,cr,ur,ux,ux,ur,ur,ur,ur,ur,ur
ur,ur,ur,ur,ur,ur,ur,ur,ur,ur,ur,ur,ur,cr,ub,cb,cr,ur,ur,ur,ur,ur,ur
ur,ur,ur,ur,ur,ur,ur,ur,ug,ug,ug,ug,ug,ur,ur,ur,ub,ur,ur,ur,ur,ur,ur
ur,ur,ur,ur,ur,ub,ub,ur,ug,ug,ur,ur,ug,ur,ur,ur,ub,ur,cb,ur,ub,ur,ur
ur,ur,ur,ur,ub,ub,ub,ur,ug,ug,ug,ug,ug,ub,ub,ub,ug,cg,ub,ur,ub,ur,ur
ur,ur,ur,ur,ub,ub,ub,ur,ur,ur,ug,ug,ub,ub,ur,ub,ug,ub,ug,ur,ub,ur,ur
cg,ux,ux,ux,ug,ub,ub,ur,ur,ur,ug,ug,ub,cb,ug,ub,ug,ub,ug,ub,ub,ur,ur
ux,ux,ux,ux,ug,ug,ub,ub,cr,ur,ug,ug,ub,ug,ug,ug,ug,ug,ug,ub,ug,ur,ur
ux,ux,ux,ur,ur,ux,ux,ub,ur,ug,ug,ug,cg,ug,ug,ug,ug,ub,ub,ub,ug,ur,ur
ur,ur,ur,ur,ur,ur,ur,ub,cb,ub,ug,ub,ub,ub,ub,ub,ub,ub,ub,ub,ug,cr,ur
ur,ur,ur,ur,ur,ux,ux,ux,ub,ug,ug,ub,cb,ub,ub,ug,ug,ug,ug,ux,ug,ug,ub
ux,ux,ux,ux,ux,ux,ux,ux,ub,ug,ub,ux,ub,ub,ub,ub,ub,ug,ux,ux,ug,ug,ub
cg,ux,ux,ux,ux,ux,ux,ux,ub,ug,ub,ub,ux,ux,ux,ux,ux,ug,ux,ug,ug,ug,ub
ux,ux,ux,ux,ux,ux,ux,ux,ub,ug,ub,ub,ux,ux,ux,ux,ux,ux,ux,cg,ux,ug,ub
ux,ux,ux,ux,ux,ux,ux,ux,ub,ug,ux,ux,ux,ux,ux,ux,ux,ux,ux,ux,ux,ug,ub
ux,ux,ux,ux,ux,ux,ux,ux,ub,ug,ux,ux,ux,ux,ux,ux,ux,ux,ux,ux,ux,ug,ub
ux,ux,ux,ux,ux,ux,ux,ux,ub,ug,ux,ux,ux,ux,ux,ux,ux,ux,ux,ux,ux,ug,ub
ux,ux,ux,ux,ux,ux,ux,ux,ub,ux,ux,ux,ux,ux,ux,ux,ux,ux,ux,ux,ux,ug,ub
ub,ub,ub,ub,ub,ub,ub,ub,ub,ub,ub,ub,ub,ub,ub,ub,ub,ub,ub,ub,ub,ub,ub
ub,ux,ux,ux,ux,ux,ux,ux,ub,ux,ux,ux,ux,ux,ux,ux,ux,ux,ux,ux,ux,ux,cb
ub,ub,ub,ub,ub,ub,ub,ub,ub,cg,ux,ux,ux,ux,ux,ux,ux,ux,ux,ux,ux,ux,ux