ur,ur,ur,ur,ur,ur,ur,ur,cr,ur,ur,ur,ur,ur,ur,ur,ur,ur,ur,ur,ur,ur,cb
ur,ur,cg,ur,ur,ur,ur,ur,ub,ur,ur,ur,ur,ur,ur,ur,ur,ur,ur,ur,ur,ur,ur
ur,ur,ug,ur,ur,cr,ur,ur,ub,ub,ub,cb,ur,ur,ur,ur,ur,ur,ur,ur,ur,ur,ur
ur,ux,ug,ur,ur,ur,ur,ur,ur,ur,ur,ur,ur,ug,ur,ur,ug,ur,ub,ur,ur,ux,ur
ur,ub,ug,cr,ur,ug,ug,ug,ug,ug,ug,ug,ub,ug,ub,ug,ug,ur,ur,ur,ur,cr,ur
ur,ub,ug,ug,ur,ug,ug,ug,ug,ug,ug,ug,ub,ug,ux,ug,ug,ug,ux,ux,ug,ur,ux
ub,ub,ug,cg,ug,ug,ub,ug,ur,cb,ub,ub,ub,ub,ub,ub,ug,ug,ux,ux,ug,ux,ux
ub,ub,ur,ur,ur,ug,ux,ux,ux,ug,ug,ug,ug,ug,ux,ub,ug,ug,ux,ux,ug,ux,ux
cg,ub,cb,ur,ur,cr,ug,ug,ux,ug,ux,ub,ug,ub,ub,ub,ug,ug,ux,ux,ug,ux,ux
ur,ur,ur,ur,ur,ur,ur,ur,ur,ur,ur,ur,ur,ur,ur,cr,ux,ux,ux,ux,ug,ux,ux
ur,ub,ux,ub,ug,ux,ug,ug,ux,ug,ux,ub,ub,ub,ub,ug,ux,ux,ub,ub,ug,ug,ug
ur,ux,ux,ub,ug,ux,ug,ug,ux,ug,ub,ub,ub,ub,ub,ub,ub,ub,ub,ub,ux,ux,ug
ur,ux,ux,ub,ug,ux,ug,ug,ug,ug,ub,cb,ub,ub,ub,ub,ub,ub,ub,ub,ub,ux,ug
ur,ux,ux,ub,ug,ub,ug,ug,ug,ug,ub,ub,ub,ub,ub,ub,ub,cb,ub,ux,ub,ux,ug
ur,ux,ux,ub,ug,ub,ug,ug,ug,ug,ug,ub,ug,ub,ub,ub,ub,ub,ub,ux,ub,ux,ug
ur,ux,ux,ub,ug,ub,ug,ug,ug,ug,ug,ug,ug,ug,ug,ug,ux,ub,ub,ub,ub,ux,ug
ur,ur,ur,ub,ug,ur,ug,ur,ub,ug,ug,ug,ug,ug,ug,ug,ur,ub,ub,ub,ub,ub,ur
ur,ux,ux,ub,ug,ux,ug,ug,ug,ug,ug,ug,ug,ug,ug,ug,cg,ux,ub,ub,ug,ub,ur
ur,ur,ur,ur,ur,ur,ur,ur,ur,ur,ur,ur,ur,ur,ug,ug,ug,ur,ur,ur,ur,ub,ub
ur,ur,ux,ub,ux,ux,ux,ux,ux,ux,ug,ug,ug,ux,ux,ug,ug,ug,ug,ug,ux,ux,ub
ur,ur,ub,ub,ux,ux,ux,ux,ux,ux,ux,ux,ux,ux,ux,ux,ux,ux,ux,ux,ux,ux,ux
ur,ur,ub,ux,ux,ux,ux,ux,ux,ux,ux,ux,ux,ux,ux,ux,ux,ux,ux,ux,ux,ux,ux
ur,ur,ur,ur,ur,ur,ur,ux,ux,ux,ux,ux,ux,ux,ux,ux,ux,ux,ux,ux,ux,ux,ux