ur,cb,cb,cr,ur,ur,ur,ur,ur,ur,ur,ur,ur,ur,cb,ub,ub,ub,ub,ub,ub,ub,cb
ur,ur,cb,ur,ur,ur,ur,ur,cr,ug,ur,ur,ur,ur,ur,ub,cr,ug,ug,cr,ub,ub,ux
ur,ur,ur,ur,ur,ur,ur,ur,ur,ug,ux,ur,ur,ur,ur,ur,ur,ur,ur,ur,ug,ug,ug
ux,cr,ur,ur,ur,ur,ur,ur,ur,ug,ur,ur,ur,ur,ur,ur,ur,ur,ur,ur,ub,ux,ug
ux,ur,ur,ur,ur,ur,ub,ub,ub,ug,ug,ug,cg,ur,ur,ur,ur,ur,ug,ub,ub,ux,ug
ux,ux,ux,ux,ur,ur,ub,ur,ur,ur,ur,ur,ur,ur,cr,ur,ur,ur,ux,ub,ub,ur,ug
ux,ux,ux,ur,ub,ub,ub,ur,cg,ug,ug,ug,ur,ur,ur,ur,ur,ur,ug,ux,ux,ur,ug
cb,ux,ur,ur,ub,ub,ub,ug,ug,ug,ug,ug,ur,ur,ur,ur,ur,ur,ug,ug,ug,ur,ug
ur,ux,ur,ur,ur,ur,ub,ub,ub,ub,ub,cb,ur,ur,ux,ux,ug,ug,ug,ug,ug,ur,ug
ur,ur,ur,ur,ur,ur,ur,ur,ug,ug,ug,ug,ug,ux,ux,ux,ug,ug,ug,ug,ug,ur,ug
ur,ur,ur,ur,ur,ur,ur,ur,ug,ug,ug,ug,ub,ub,ux,ux,ug,ux,ug,ug,ug,ur,ug
ur,ur,ug,ug,ug,ug,ub,ug,ub,ug,ub,ub,ub,ub,cb,ug,ug,cg,ur,ur,ur,ug,ug
cb,ug,ug,ug,cg,ug,ug,ub,ux,ub,ub,ug,ub,ub,ug,ux,ug,ug,ux,ug,ur,ug,cg
ug,ug,ug,ug,ug,ub,ub,ug,ub,ub,ub,ug,ub,ub,ug,ug,ug,ug,ug,ug,ur,ug,ux
ug,ug,ug,ug,ux,cb,ub,ub,ub,ub,ub,ug,ub,ug,ug,ux,ur,ux,ux,ux,ur,ug,ux
ug,ug,ug,ug,ux,ug,ug,ug,ub,ub,ub,ub,ux,ux,ur,ux,ur,ux,ux,ux,ur,ug,ux
ub,ub,cb,ug,ux,ug,ug,ug,ug,ug,ug,ug,ug,ux,ur,ux,ur,ux,ux,ux,ur,ug,ux
ub,ug,ug,ug,ux,ug,ub,ub,ub,ub,ub,ub,ub,ub,ur,cg,ug,ug,ug,ug,ug,ug,ub
ub,ub,ub,ub,ub,ub,ub,ux,ux,ux,ux,ux,ug,ux,ur,ub,ub,ub,ub,ub,ub,ub,ub
cr,ug,ux,ux,ux,ug,ub,ux,ux,ux,ux,ug,ug,ub,ur,ub,ub,ub,ux,ux,ux,ux,ux
cg,ug,ux,ux,ug,ug,ug,ug,ug,ug,ug,ug,ub,ub,ur,ub,ub,ub,ux,ux,ux,ux,cr
cr,ug,ug,ug,cr,ug,ug,ug,ug,ug,ug,ub,ub,ub,ur,ub,ub,ub,ur,cb,cb,ux,cr
cg,ux,cg,cb,ur,ur,ur,ur,ur,ur,ur,ur,ur,ur,ur,cg,ub,ub,ur,cg,cg,cb,cr