cb,cb,cb,cr,ur,ur,ur,ur,ur,ur,ur,ur,ur,ur,ur,ur,ur,ur,ur,ur,ur,ur,cb
ur,ub,ur,ur,ur,ur,ur,ur,ur,ur,ur,ux,ux,ux,ur,ur,ur,ug,ug,ur,ur,ur,ur
ur,ub,cb,ur,cr,ur,ur,ur,cr,ur,ug,ux,ur,ug,ug,cr,ug,ug,ug,ub,cb,ur,ur
cg,ug,ur,ur,cr,ub,ur,ur,ur,ur,ug,ur,ug,ug,ur,ub,ub,ur,ub,ub,ug,ur,ur
ur,cr,ur,ur,ur,cb,ub,ur,ur,ur,ug,ug,ug,ur,ur,ug,ub,ub,ub,ur,ug,ug,ur
ur,ur,ur,ub,ur,ub,ug,ug,ug,ur,ur,ug,ux,ur,ur,ug,ug,ur,ug,ug,ur,ug,ur
ur,ur,ur,ug,ur,ug,ug,ug,ux,ur,ur,ug,ur,ur,ur,ug,ug,ub,ug,ug,ux,cg,ub
cb,ug,ug,ub,ur,ug,ux,ug,ux,ux,ur,ug,ux,ur,ug,ug,ug,ub,ug,ug,cg,ub,ub
ur,ug,ub,ub,ur,ug,ug,ug,ux,ux,ur,ug,ur,ug,ug,ur,ug,ug,ug,ub,ub,ub,ux
ur,ug,ub,ub,ur,ur,ur,ur,ux,ux,ur,ug,ug,ug,ug,ug,ur,ug,ug,ur,ur,ur,ur
ux,ug,ug,ur,ur,ur,ux,ur,ux,ur,ur,ug,ug,ug,ug,ug,ur,ur,ug,ug,ur,ur,ur
ur,ur,ug,ug,ug,ur,ur,ur,ux,ur,ur,ug,ug,ug,ug,ug,ug,ug,ur,ug,ur,ur,ur
cb,ur,ug,ur,ur,ur,ur,ur,ur,ur,ur,ug,ug,ug,ug,ur,ur,ur,ur,ug,ur,cr,ur
ug,ur,ug,ug,ug,ur,ur,ur,ur,ur,ur,ug,ug,ug,ug,ug,ur,ur,ur,ug,ur,ug,ur
ug,ug,ub,ub,ug,ug,ug,ur,ux,ur,cg,ur,ub,ub,ug,ug,ub,ub,ub,ug,ur,ug,ur
ug,ug,ub,ub,ub,ub,ub,ub,ub,ub,ug,ug,ug,ug,ug,ux,ub,ur,ub,ur,ur,ur,ur
ug,cb,ug,cg,ub,ux,ux,ux,ux,ux,ub,ub,ub,ub,ux,ux,ub,ur,ub,ur,ur,ur,ur
cr,ub,ub,ub,ub,ux,ux,ux,ux,ux,ux,ux,ux,ub,ub,ub,ub,ub,cb,ur,ur,ur,ur
cg,ub,ub,ub,ub,ux,ux,ux,ux,ux,ux,ux,ux,ux,ux,ux,ux,ur,ur,ur,ur,ur,ur
cb,ub,ub,ub,ub,ux,ux,ux,ux,ux,ux,ux,ux,ux,ux,ux,ux,ur,ur,ur,ur,ur,ur
ux,ux,ub,ub,ux,ub,ub,ux,ux,ux,ux,ux,ux,ux,ux,ux,ux,ur,ur,ur,ur,ur,cr
cr,ub,ub,ub,ub,ub,cb,ub,ub,ux,ux,ux,ux,ux,ux,ux,ux,cb,cg,ux,cb,ur,cr
cg,ub,cg,cb,ub,ub,ub,ub,ub,ux,ux,ux,ux,ux,ux,cg,ux,ux,ux,cg,cg,ur,cr