ub,ub,cb,cr,ur,ur,ur,cg,ug,ur,cr,ur,ur,ur,ur,ur,ur,ur,ur,cg,ur,ur,ur
ub,ub,ub,ub,ub,ub,ur,ug,ub,ub,ub,ur,ur,ur,ur,ur,ur,ur,ur,ur,ur,ur,ur
ub,ub,cb,ub,ur,ug,ug,ug,ur,ur,ur,ur,ur,ur,ur,ur,ur,ur,ur,ur,ur,ur,ur
ur,ur,ur,ur,ug,ug,ur,ur,ur,ur,ur,ur,ur,ur,ur,ur,ur,ur,ur,ur,ur,ub,ur
ur,ur,ur,ur,ug,ur,ur,ur,ur,ur,ur,ur,ur,ur,ub,ur,ur,ur,ur,ur,ur,cr,ur
ur,ur,ur,ur,cr,ug,ur,ug,ug,ug,ur,ur,ug,ur,ub,ur,ur,ur,ur,ur,ur,ur,ub
ur,ur,ur,ur,ug,ug,ur,ug,ur,ug,ur,ur,ug,ug,ug,ug,ug,cr,ur,ub,ur,ub,ub
ur,ur,ur,ur,ug,ug,ug,ug,ur,ug,ug,ug,ur,cg,ug,ug,ug,ug,ur,ur,ur,ub,ub
ug,ug,ug,ug,ug,ur,ub,ub,ub,cb,ub,ug,ub,ub,ub,ug,ug,ug,ub,ub,ub,ub,ub
ug,ux,ux,ug,ug,ug,ux,ub,ux,ug,ux,ug,ux,ug,ug,ug,ug,ug,ux,ug,ux,ub,ub
ug,ux,ux,ug,ug,ug,ux,ub,ux,cg,ux,ug,ux,ug,ug,ub,ub,ug,ux,ug,ux,ub,cb
ug,ug,ug,ux,ub,ug,ub,ub,ux,ub,ux,ug,ux,ug,ug,ub,ub,ug,ub,ub,ux,ub,ux
ux,ux,ug,ug,ug,ug,ug,ub,ug,ug,ub,ub,ub,ug,ug,ub,ug,ug,ub,ub,ux,ub,ub
ug,ug,ug,ug,ub,ub,ux,ub,ux,ub,ux,ub,ub,ub,cb,ub,ug,ug,ub,ub,ux,ub,ub
ug,ug,ug,ug,ub,ub,ub,ub,ub,ug,ug,ug,ub,ug,ug,ug,ug,cg,ub,ub,ux,ub,ub
cg,ug,ug,ug,ub,ub,ux,ub,ub,ug,ug,ug,ub,ug,ug,ug,ug,ub,ub,ub,ub,ub,ub
ux,ug,ux,ug,ub,ub,ux,ux,ux,ug,ux,ux,ub,ux,ug,ug,ug,ub,ub,ub,ub,ub,ub
ux,ug,ub,ug,ug,ub,ux,ux,ug,ug,ug,ug,ug,ux,ux,ux,ux,ub,ub,ub,ub,ub,ur
ux,ug,ug,ug,ub,ub,ux,ux,ug,ux,cb,ux,ug,ub,ux,ub,ux,ub,ub,ub,ub,ub,ub
ub,ub,cg,ug,ug,ug,ug,ug,ug,ux,ub,ub,ub,ub,ub,ub,ub,ub,ub,ub,ub,ub,ub
cr,ub,ug,ug,ug,ug,ug,ug,ug,ur,ur,ub,ub,ub,ub,ub,ub,ub,ub,ub,ub,ub,ub
cg,ux,ug,ug,ug,ug,ug,ug,ug,ux,ub,ub,ux,ux,ux,ub,ub,ub,ub,ub,ub,cb,cr
cr,ux,ux,ub,ur,ur,ur,ur,ur,ur,ur,ur,ur,ur,ur,ur,ur,ur,cr,cb,cb,ux,cr