ur,ur,ur,ur,ur,ur,ur,ur,ug,ug,ub,ub,ur,ur,ur,ur,ur,cb,ur,ur,ur,ur,ur
ur,ur,ur,ur,ur,ur,ur,ur,ur,ug,ux,ub,ub,ub,ub,ur,ur,ux,ur,ur,ur,ux,ur
ur,ur,ur,ub,ub,cr,ur,ur,ur,ug,ub,ub,ub,ub,ub,ub,ur,ur,ur,ux,ur,cr,ur
ur,ur,ur,ur,ub,ub,ub,cr,ur,ug,ur,ur,ur,ur,ur,ub,ur,ur,ux,ux,ux,ur,ub
ur,ur,ur,ur,ug,ug,cg,ug,ub,ug,ux,ur,ur,ur,ux,ub,ur,ur,ux,ux,ub,ub,ub
ur,ur,ur,ug,ug,ub,ug,ug,ug,ug,ug,ug,ug,ug,ug,ub,ug,ug,ug,cb,ug,ug,ug
ur,ug,ug,ug,ub,ub,ug,ub,ub,ub,ub,ug,ug,ug,ug,ub,ub,ub,ub,ub,ux,ub,ug
cr,ur,ur,ur,cr,ur,ug,ub,ug,ug,ug,ug,cb,ub,ub,ug,ug,ug,ug,ub,ub,ub,ug
ub,ur,ur,ur,ur,ur,cr,ub,ub,ub,ug,ub,ub,ub,ug,ug,ug,ug,ug,ub,ub,ub,ug
ub,ub,ur,ur,ur,ub,ub,ub,ub,ub,ug,ub,ug,ub,ug,ub,ux,ux,ug,ub,ux,ux,ug
ub,ub,ub,ug,ur,ug,ug,ux,ub,ug,ub,ub,ug,ub,ug,ug,ug,ug,ug,ub,ux,ux,ug
ub,ub,ub,ug,ur,ug,ug,ux,ub,ug,ux,ub,ug,cg,ux,ux,ux,ux,ug,ug,ub,ub,ug
ub,ub,ub,ub,ur,ub,ug,ux,ub,ug,ux,ux,ug,ug,ug,ug,ux,ux,ux,ug,ux,ux,ug
ub,ub,ub,ub,ur,ub,ug,ug,ub,ug,ur,ur,ug,ug,ug,ug,ug,ug,ux,ug,ux,ux,ug
cg,ub,ub,ux,ur,ux,ux,ux,ub,ub,ub,ub,ug,ug,ux,ug,ug,ug,ub,ub,ub,ux,ug
ux,ub,ub,ug,ur,ug,ug,ug,ub,ub,ug,ub,ub,ug,ux,ux,ux,ub,ub,ug,ub,ux,cb
ux,ub,ub,ug,ur,ux,ux,ux,ux,ux,ux,ux,ub,cb,ux,ux,ux,ub,ub,ux,ub,ub,ub
ux,ub,ub,ug,ur,ux,ux,ux,ux,ux,ux,ux,ug,ug,ux,ux,ux,ub,ub,ux,ub,ub,ub
ux,ub,ub,ug,ur,ug,ug,ug,ug,ug,ug,ux,ux,ux,ux,ux,ub,ub,ux,ux,ux,ux,ug
ux,ub,ub,ub,ur,ug,ug,ug,ug,ug,ug,ux,ux,ux,ux,ux,ub,ux,ux,ux,ux,ux,ug
ux,cg,ug,ug,ug,ug,ug,cb,ub,ub,ub,ub,ug,ug,ug,ug,ug,ug,ug,ug,ug,ug,ug
cr,ub,ub,ub,ub,ub,ub,cg,ug,ug,ug,ug,ug,ux,ux,ux,ux,ux,ux,ub,ux,ub,cb
cg,ub,ub,ub,ub,ux,ux,ux,ux,cg,ux,ux,ux,ux,ux,ux,ux,ux,ux,ub,ub,ub,cb