ur,ur,ur,ur,ur,ur,ur,ur,ur,ur,ur,ur,ur,ur,ur,ub,ub,ub,ub,ub,ub,cb,ur
ur,ur,ur,ur,ur,ur,ur,ur,ur,ur,ur,ur,ur,ur,ur,ub,ur,ur,ur,ur,ur,ur,cr
ur,ur,ur,ur,ur,ur,ur,ur,ur,ur,ur,ur,ur,ur,ur,ub,ub,ub,ub,ub,ub,ur,ux
cr,cr,ur,ur,ur,ur,ur,ur,ur,ur,cr,ug,cg,ur,ur,ur,ur,ur,ur,ur,ur,ux,cb
cb,ub,ur,ur,ur,ur,ur,ur,ur,cr,ur,ur,ur,ur,ur,ub,ux,ux,ux,ux,ur,ur,ur
ur,ur,ur,ur,ur,ur,ur,ur,ur,ur,ur,ur,ur,ur,cg,ug,ug,ug,ug,ux,ux,ux,ur
ur,ur,ur,ur,ur,ur,ur,cg,ug,ug,ur,ur,ur,ur,ug,ug,ug,ug,ug,ur,ur,ur,ur
ux,ur,ux,ux,ux,ur,ur,ug,ug,ug,ux,ur,ug,ug,ug,ug,ug,ug,ur,ur,ur,ur,ur
cg,ur,ur,ur,ur,ur,ur,ug,ug,ug,ur,ur,ug,ug,ug,ug,ug,ug,ug,ug,ur,ur,cr
ur,ur,ur,ur,ug,ug,ub,ug,ur,ur,ur,ur,ug,ug,ug,ug,ug,ug,ug,ug,ur,ur,ux
ur,ur,ur,ug,ux,ur,ur,ug,ur,ur,ur,ur,ug,ug,ub,ug,ug,ug,ug,ur,ur,ur,ux
ur,ur,ur,ur,ur,ur,ur,ug,ug,ur,ub,ub,ub,ug,ub,ux,ug,ug,ug,ux,ux,ux,ux
ur,ur,ub,ub,ub,ux,ux,ux,ug,ur,ub,ub,ub,ug,ug,ug,ug,ub,ug,ux,ux,ux,ux
ux,ug,ug,ug,ug,ug,ug,ub,ug,ug,ub,cb,ub,ug,ug,ug,ug,ug,ug,ux,ux,ux,ux
cg,ug,ug,ug,ux,ux,ug,ug,ug,ug,ug,ug,ub,ub,ub,ug,ub,ub,ub,ub,ub,ub,ub
ux,ug,ug,ug,ux,ux,ur,ur,ur,ur,ux,ux,ub,ub,ub,ub,ub,ub,ub,ub,ub,ux,ub
ux,ug,ug,ug,ur,ur,ur,ux,ux,ux,ux,ux,ub,ub,ub,ub,ub,ub,ub,ub,ub,ub,ub
ux,ug,ug,ug,ux,ux,ux,ux,ux,ux,ux,ux,cb,ub,ub,ub,ub,ub,ub,cb,ub,ub,ub
ux,ug,ug,ug,ux,ux,ux,ux,ux,ux,ux,ux,ub,ux,ux,ub,ub,ub,ub,ux,ub,ub,ub
ux,ug,ug,ug,ux,ux,ux,ux,ux,ux,ux,ux,ub,ux,ux,ux,ux,ux,ub,ub,ub,ub,ux
ux,ux,ux,ug,ux,ux,ux,ux,ux,ux,ux,ux,ux,ux,ux,ux,ux,ux,ub,ub,ub,ub,ux
ux,ux,ux,ug,ug,ux,ux,ux,ux,ux,ux,ux,ux,ux,ux,ux,ux,ux,ux,ux,ux,ux,cb
ux,ux,ux,ux,ux,ux,ux,ux,ux,cg,ux,ux,ux,ux,ux,ux,ux,ux,ux,ux,ux,ux,ux