ur,ur,ur,ur,ur,ur,ur,ur,ur,ur,ur,cr,ur,ur,ur,ur,ur,ur,ur,ur,ur,ur,ur
ur,ur,ur,ur,ur,ur,ur,ur,ur,ur,ur,ur,ur,ur,ur,ur,ur,ur,ur,ur,ur,ur,ur
ur,ur,ur,ur,ur,ur,ur,ur,ur,ur,ur,ur,ur,ur,cr,ub,cb,ur,ur,ur,ux,ux,ux
ur,ur,ur,ur,ur,ur,ur,ur,ur,ur,ur,ur,ur,ur,ur,ur,ur,ur,ur,ur,ur,ux,cb
ur,ur,ur,ur,ur,ur,ur,ur,cb,cg,ug,cr,ur,ug,ur,ur,ur,ur,ur,ur,ur,ux,ux
ur,ur,ur,ur,ur,ur,ur,ur,ub,ur,ur,ur,ur,ur,ur,ur,ur,ur,ur,ur,ur,ux,ux
ur,ur,ur,ur,ur,ur,ur,ur,cr,ur,ur,ur,ur,ur,ur,cr,ug,ur,ur,ur,ux,ux,ux
ur,ur,ur,ur,ur,ur,ur,ur,ur,ur,ug,ur,ug,ug,ug,ug,ug,cg,ur,ur,ux,ux,ux
cg,ur,ur,ur,ur,ur,ur,ur,ub,ub,ub,ug,ub,ug,ug,ug,ug,ug,ug,ug,ug,ug,ug
ur,ur,ur,ur,ur,ur,ur,ug,ub,ub,ub,ub,ub,ug,ux,ux,ux,ux,ub,ux,ux,ux,ug
ur,ur,ur,ub,ux,ux,ub,ux,ub,ub,ub,ub,ub,ug,ub,ub,ub,ub,ub,ux,ux,ux,ug
ux,ub,ub,ub,ux,ub,ub,ub,ub,ug,ub,ub,ub,ub,ub,ux,ug,ub,ub,ux,ux,ux,ug
ux,ub,ub,ub,ub,ub,cb,ub,ux,ug,ug,ug,ub,ug,ug,ug,ug,ux,ux,ux,ux,ux,ug
ux,ub,ub,ub,ub,ub,ub,ub,ux,ug,ug,ub,ub,ux,ug,ux,ux,ux,ux,ux,ux,ux,ug
cg,ub,ub,ub,ux,ux,ux,ux,ub,ub,ug,ub,ub,ub,ug,ux,ux,ux,ux,ux,ux,ux,ug
ux,ub,ub,ub,ub,ux,ux,ub,ub,ub,ug,ub,ur,ub,ur,ur,ur,ur,ur,ur,ur,ur,ug
ux,ux,ux,ub,ub,ux,ux,ub,cr,ug,ug,ug,ub,ub,ug,ux,ux,ux,ux,ux,ux,ux,ug
ux,ux,ux,ub,ub,ux,ux,ux,ur,ug,cb,ub,ub,ux,ux,ux,ux,ux,ux,ux,ux,ux,ug
ux,ux,ux,ub,ub,ux,ux,ux,cb,ug,ug,ug,ug,ug,ux,ux,ux,ux,ux,ux,ux,ux,ug
ux,ux,ux,ub,ub,ux,ux,ux,ub,ug,ug,ux,ux,ux,cg,ug,ug,ug,ug,ug,ug,ug,ug
ub,ub,ub,ub,ub,ub,ub,ub,ub,ur,ur,ur,ur,ur,ur,ur,ur,ur,ur,ur,ur,ur,ur
ub,ub,ub,ub,ub,ux,ux,ux,ub,ug,ug,ug,ug,ug,ug,ug,ug,ug,ug,ug,ug,ug,cb
ur,ub,ub,ub,ub,ub,ub,ub,ub,cg,ug,ug,ug,ug,ug,ug,ug,ug,ug,ug,ug,ug,ur