ur,ur,cb,ur,ur,ur,ur,ur,ur,ur,ur,ur,ur,ur,ur,ur,ur,cb,ux,ur,ur,ur,ur
ur,ur,ub,cr,ur,ur,ur,ur,ur,ur,ur,ur,ur,ur,ur,ur,cr,ub,ub,ub,cb,ur,ur
ur,ur,ur,ur,ur,ur,ur,ur,ur,ur,ur,ur,ur,ur,ur,ur,ux,ux,cg,ug,ur,ur,ur
ur,ur,ur,ur,ur,ur,ur,ur,ur,ur,ur,ur,ur,ur,ur,ur,ur,ur,ur,ug,ur,ur,ur
ur,ur,ur,ur,ur,ur,ur,ur,ur,ur,ur,ur,ur,ur,ur,ur,ur,cr,ur,ug,ur,ur,ug
ur,ur,ur,ur,ur,ur,ur,ur,ur,ug,ur,ur,ur,ur,ur,ur,ug,ug,ur,ur,ur,ur,ug
ur,ur,ur,ur,ur,ur,ur,cr,ub,ub,ub,ub,ub,ub,ub,ub,ub,ub,ur,ur,ur,ub,ug
ur,ur,ur,ug,ug,ug,ug,ug,ug,ug,ug,ur,ug,ug,ug,ug,ug,ug,ug,ux,ug,ug,ug
ur,ur,ur,ug,ug,ug,ug,ur,ux,ub,ur,ug,ug,ug,ug,ug,ug,ug,ug,ux,ux,ux,ux
ur,ur,ur,ug,ug,ug,ug,ub,ug,ug,ur,ur,ux,ug,ug,ug,ux,ux,ug,ux,ux,ux,ux
ur,ur,ur,ug,ur,ub,ub,ub,ub,ug,ub,ub,ub,ub,ug,ug,ug,ug,ug,ux,ux,ux,ux
ur,ur,ur,ug,ug,ug,ug,ug,ub,ub,ub,ub,ug,ug,ug,ug,ub,ub,ux,ux,ux,ux,ux
ur,ur,cg,ug,ug,ub,ub,ub,ub,ub,cb,ub,cb,ug,ub,ub,ub,ub,ux,ux,ux,ux,ux
ur,ur,ug,ug,cr,ug,ug,ug,ub,ub,ub,ub,ub,ug,cg,ub,ub,ub,ub,ux,ux,cr,ux
cg,ur,ur,ur,ur,ux,ux,ux,ub,ub,cb,ub,ub,ug,ug,ux,ux,ux,ux,ux,ux,ur,ux
ub,ug,ub,ub,ub,ub,ub,ub,ub,ug,ug,ub,ub,ug,ug,ub,ub,ub,ub,ub,ub,ur,ux
ub,ug,ux,ux,ux,ux,ux,ux,ux,ug,ug,ub,ub,ug,ug,ux,ux,ux,ux,ux,ub,ur,ub
ub,ug,ux,ux,ux,ux,ux,ux,ux,ux,ub,ub,ub,ug,ug,ub,ub,ub,ub,ub,ub,cb,ub
ub,ug,ub,ux,ux,ux,ux,ux,ux,ux,ub,ub,ub,ub,ub,ub,ub,ub,ux,ux,ux,ub,ux
ub,ug,ub,ux,ux,ux,ux,ux,ux,ux,ux,ub,ur,ux,ux,ux,ux,ub,ux,ux,ux,ub,ux
ub,ug,ub,ur,ur,ur,ur,ur,ur,ur,ur,ur,ur,ub,ub,ub,ub,ub,ur,ur,ub,ub,ux
cr,ug,ux,ux,ux,ux,ux,ux,cg,ux,ux,ux,ux,ub,ux,ux,ux,ux,ux,ux,ub,ux,cb
cg,ug,ug,ug,ug,ug,ug,ug,ug,cg,ux,ux,ux,ub,ub,ub,ub,ub,ub,ub,ub,ur,ur