ur,ur,ur,ur,ur,ur,ur,cg,ug,ug,ug,ug,ug,ug,ug,ug,ug,ug,ug,ug,ug,ub,ub
ur,ur,ur,ur,ur,ur,ur,ur,ur,ub,ub,ub,ub,ur,ur,ur,ur,ur,ur,ur,ub,ub,ub
ur,ur,ur,ur,ur,ur,ur,ur,ur,ur,ur,ur,ub,ub,ub,ub,ub,ub,ub,ub,ub,ur,ub
ur,ur,ur,cr,ur,ur,ur,ur,ur,ur,ur,ur,ur,ur,ur,ur,ur,ur,ur,ux,ux,cb,ub
ux,ur,ub,ub,ur,ur,ur,ur,ur,ur,ur,ur,ur,ur,ur,ur,ur,ur,ur,ux,ux,ux,ug
ux,ux,ub,ub,cb,ur,ur,ur,ur,ur,ur,ur,ub,ub,ub,ub,ub,ur,ur,ux,ux,ux,ug
ux,cr,ur,ur,ur,ur,ur,ur,ur,cg,cr,ur,ug,ug,ug,cg,ub,ur,ur,ur,ux,ux,ug
ux,ur,ur,ur,ur,ur,ur,ur,ur,ug,ug,ur,cb,ub,ub,ub,ub,ur,ur,ur,ux,ux,ug
cg,ur,ur,ur,ur,ur,ub,ur,ur,ug,ug,ur,ur,ug,ur,ur,ug,ur,ur,ug,ux,ux,ug
ur,ur,ur,ur,ur,ur,ub,ur,ur,cr,ug,ug,ug,ug,ur,ug,ug,ub,ug,ug,ux,ux,ug
ur,ur,ur,ub,ur,ur,ub,cr,ub,ub,ub,ub,ub,ug,ug,ug,ug,ug,ug,ug,ur,ux,ug
ub,ux,ug,ub,ur,ub,ub,cb,ub,ub,ub,ub,ub,ug,ug,ug,ub,ug,ug,ug,ur,ux,ug
ub,ux,ug,ux,ur,ub,cb,ub,ub,ub,ug,ub,ub,ug,ux,ug,ug,ug,ub,ug,ux,ug,ug
ux,ux,ug,ug,ur,ux,ux,ux,cr,ub,ub,ub,ub,ug,ux,ub,ub,ug,ux,ug,ux,ug,ub
cg,ux,ux,ug,ur,ux,ux,ux,ur,ub,ub,ub,ub,ub,ub,ub,ub,ug,ux,ug,ux,ug,ub
ub,ub,ub,ub,ur,ub,ux,ux,ur,ub,cb,ux,ux,ug,ux,ub,ux,ug,ug,ug,ux,ug,ub
ub,ub,ub,ug,ur,ub,ub,ub,ur,ub,ub,ub,ux,ug,ux,ux,ux,ux,ux,ux,ux,ug,ub
ux,ux,ub,ug,ur,ux,ux,ux,ur,ux,ux,ub,ub,ug,ux,ux,ux,ux,ux,ux,ux,ug,ub
ux,ux,ux,ux,ur,ux,ux,ux,ur,ux,ux,ux,ux,ug,ub,ub,ub,ub,ub,ux,ux,ug,ub
ux,ux,ux,ux,ur,ux,ux,ux,ur,ux,ux,ux,ux,ug,ux,ux,ux,ug,ug,ug,ug,ug,ub
ux,ux,ux,ux,ur,ux,ux,ux,ur,ux,ux,ux,ux,ug,ug,ug,ug,ug,ux,ub,ub,ux,ub
ux,ux,ux,ux,ur,ux,ux,ux,ur,ux,ux,ux,ux,ux,ux,ux,ux,ux,ux,ux,ub,ub,ub
ux,ux,ux,ux,ur,ur,ur,ur,ur,cg,ux,ux,ux,ux,ux,ux,ux,ux,ux,ux,ux,ub,ub