ur,cb,cb,cr,cr,ur,ur,ur,ur,ur,ur,ur,ur,ur,ub,ub,ub,ur,ur,ur,ur,ur,cb
ur,cb,cb,ux,ur,cr,ur,ur,ur,ur,ur,ur,ur,cg,ub,ur,ub,cb,ug,ug,ug,ug,ug
ur,ur,ur,ug,ur,ug,ur,ur,ur,ur,ur,ur,ur,ug,ug,ur,ur,ur,ur,ur,ur,ub,ug
ur,ur,ur,ur,ur,ur,ur,cr,ug,ug,cr,ub,ur,ug,ub,ur,ur,ur,ur,ur,ur,ub,ug
ur,ug,ur,ur,ug,ur,ur,ug,ur,ux,ur,ur,ur,ur,ur,ur,ug,ug,ug,ug,ub,ub,ug
ur,ur,ur,ug,ug,ub,ub,ug,ub,ub,ub,ug,ug,ug,ur,ux,ug,ug,ux,ug,ub,ux,ug
ug,ug,ug,ug,cr,ug,ug,ug,ux,ux,ux,ux,ur,ux,ur,ux,ug,ug,ux,ug,ub,ux,ug
cb,ur,ur,ur,ur,ur,ux,ur,ur,ur,ur,ur,ur,ug,ug,ux,ub,cb,ux,ug,ub,ux,ug
ug,ug,ug,ug,ug,ur,ur,ur,ur,ux,ux,ux,ug,ug,ug,ub,ub,ug,ug,ug,ub,ux,ug
ug,ug,ug,ug,ug,ur,ur,ug,ur,ug,ux,ub,ub,ub,ug,ur,ug,ug,ug,ug,ub,ux,ug
ux,ur,ur,ur,ug,ur,ur,ug,ux,ug,ux,ub,ux,ub,cg,ux,ux,ug,ug,ug,ub,ux,ug
ux,ux,ux,cr,ur,ur,ur,ur,ur,ur,ur,ur,ur,ur,ur,cg,ug,ug,ug,ug,ug,ug,ug
cb,ux,ux,ux,ub,ug,ub,ug,ug,ug,ux,ug,ug,ub,ub,ug,ug,ug,ug,ux,ux,ux,cg
ub,ub,ub,ub,ub,ub,ub,ub,ub,ub,cb,ug,ug,ub,ub,ux,ub,ub,ub,ux,ux,ux,ux
ux,ux,ux,ux,ub,ux,ux,ub,ug,ug,ug,ug,ug,ub,ub,ux,ub,ub,ub,ux,ux,ux,ux
ux,ux,ux,ux,ub,ux,ug,ug,ub,cg,ug,ug,ug,ug,ug,ug,ug,ug,ub,ux,ux,ux,ux
ux,ux,ux,ux,ug,ug,ub,ub,ug,ug,ug,ug,ug,ug,ub,ub,ub,ug,ug,ug,ug,ug,cb
ux,ux,ux,ux,ub,ub,ug,ug,ug,ux,ux,ux,ux,ug,ug,ug,ug,ug,ug,ug,ug,ug,ux
ux,ux,ux,cb,ub,ub,ug,ug,ug,ug,ux,ux,ux,ug,ug,ug,ug,ug,ug,ug,ug,ug,ux
ux,ub,ub,ug,ug,cg,ub,ux,ux,ug,ug,ug,ug,ug,ug,ug,ug,ug,ug,ug,ug,ug,ux
cr,ub,ub,ub,ub,ux,ub,ux,ux,ux,ux,ux,ux,ux,ub,ub,ub,ux,ux,ux,ux,ux,cr
cg,ub,ub,ub,ub,ux,ub,ux,ux,ux,ux,ux,ux,ux,ub,ux,ux,ux,ux,cb,cb,ux,cr
cr,cg,cg,cb,ub,ub,ub,ux,ux,ux,ux,ux,ux,ub,ub,cg,ux,ux,ux,cg,cg,ux,cr