ur,ur,ur,ur,ur,ur,ur,ur,ur,ur,ur,cr,ub,cb,ur,ur,ur,ur,ur,ur,ur,ur,ur
ur,ur,ur,ur,ur,ur,ur,ur,ur,ur,ur,ur,ur,ur,ur,ur,ur,ur,ur,ur,ur,ur,ur
ur,cr,cr,ub,ub,ur,ur,ur,ur,ur,ur,ur,ur,ur,ur,ur,ur,ur,ur,ur,ur,ur,ur
ur,ur,ur,ur,cb,ur,ur,ur,ur,ur,ur,ur,cb,ub,ur,cr,ur,cr,ur,ur,ux,ur,ux
ur,ur,ug,ur,ur,ur,ur,ur,ur,ur,ur,ub,ub,ub,ur,ug,ur,ub,ur,ur,ux,ur,ur
ur,ur,ug,ug,cg,ur,ux,ub,ub,ub,ub,ub,ub,ub,cg,ug,ur,ub,ur,ur,ur,ur,ur
ug,ug,ux,ux,ub,ub,ug,ub,ub,ub,ur,ub,ub,ub,ur,ub,ub,ub,ur,ur,ur,ux,ux
ub,ug,ux,ub,ub,ug,ug,ug,ug,ug,ur,ub,ub,ub,cb,ub,ug,ug,ug,ug,ug,ux,ux
cg,ug,ub,ub,ug,ug,ug,ug,ug,ug,ur,ub,ub,cb,ub,ur,ug,ug,ug,ug,ug,ux,ux
ux,ug,ur,ur,ug,ur,ub,ug,ug,ug,ug,ug,ub,ub,ub,ub,ub,ub,ub,ub,ug,ux,ux
ug,ug,ux,ur,ug,ug,ug,ug,ug,ug,ug,ug,ub,ub,ug,cg,ub,ug,ug,ux,ux,ux,ux
ug,ur,ur,ur,ug,ug,ub,ub,ug,ug,ub,ub,ug,ug,ug,ub,ub,ug,ug,ug,ux,ux,ux
ug,ug,ug,ug,ug,ug,ur,ug,ur,ug,ub,ub,ug,ug,ug,ub,ux,ug,ug,ug,ux,ux,ux
ux,ux,ux,ux,ug,ug,ug,ug,ur,ug,ug,ug,ug,ub,ub,ux,ux,ux,ux,ux,ux,ux,ux
cg,ux,ux,ux,ug,ux,ug,ug,cr,ug,ug,ug,ug,ug,ug,ug,ug,ug,ug,ug,ub,ub,ub
ux,ux,ux,ux,ug,ux,ux,ug,ur,ux,ub,ux,ux,ux,ug,ug,ug,ug,ug,ug,ug,ux,ub
ux,ux,ux,ux,ug,ux,ux,ug,ur,ux,ub,ux,ux,ux,ug,ug,ug,ug,ug,ug,ug,ux,ub
ux,ux,ug,ux,ug,ux,ux,ug,ur,ux,ub,ux,ux,ux,ug,ug,ug,ub,ux,ug,ug,ux,ub
ux,ux,ug,ug,ug,ug,ug,ug,ur,ux,ub,ux,ux,ux,ux,ux,ug,ug,ux,ug,ug,ux,ub
ux,cb,ug,ug,ug,ux,ux,ux,ur,ux,ub,ux,ux,ux,ux,ux,ux,ug,ug,ug,ug,ux,ub
ub,ub,ub,ub,ub,ub,ub,ub,ur,ub,ub,ub,ub,ub,ub,ub,ub,ub,ub,ub,ub,ub,ub
ub,ub,ub,ub,ub,ub,ub,ux,ur,ux,ub,ub,ub,ub,ub,ub,ub,ub,ub,ub,ub,ux,ux
ub,ub,ub,ub,ub,ub,ub,ur,ur,cg,ub,ub,ub,ub,ub,ub,ub,ub,ub,ub,ub,ux,ux