ur,ur,ur,ur,ur,ur,ur,ur,ur,ur,ug,ug,ug,ur,ur,ur,ux,cb,ur,ur,ur,ur,ur
ur,ur,ur,ur,cr,ur,ur,cg,ur,ur,ur,ur,ug,ur,ub,ur,ux,ux,ur,ur,ur,ur,ur
ub,ur,ur,ug,ug,ur,ug,ug,ur,ur,ur,ur,ug,ur,ur,ur,ub,ur,ur,ur,ur,ur,ur
ub,ux,cr,cr,ur,ur,ur,ug,ug,ug,ug,ug,ug,ug,ug,ug,ug,ug,ug,ug,ug,ug,ug
ub,ub,ub,ug,ug,ug,ug,ug,ur,ug,ur,ug,ug,ur,ur,ur,ur,ur,ux,ur,ur,ur,ug
ug,ur,ub,ub,ub,ux,ux,ux,ux,ug,ug,ug,ur,cr,ur,ur,ur,cr,ur,ur,ux,ux,ug
ug,ux,ug,ux,ub,ub,ux,ux,ux,ux,ux,ur,cb,ux,ux,ug,ug,ux,ur,ux,ux,ux,ug
ub,ub,ub,ub,ub,ub,ux,ux,ux,ux,ux,ux,ub,ub,ug,ub,ub,ub,ub,ux,ux,ux,ug
ub,ub,ub,ub,ug,ug,ug,ux,ux,ux,ux,ub,ub,ub,ug,cb,ub,ub,ub,ub,ux,ux,ug
ub,ub,ub,ub,ux,ux,ug,ug,ug,ux,ux,ub,ub,ub,ub,ub,ug,ub,ub,ub,ub,ux,ug
ub,ub,ub,ub,ux,ux,ux,ux,ug,ug,ub,ub,ub,ub,ug,ub,ub,ub,ub,ub,ub,ux,ug
ux,ug,ub,ub,cb,ug,ug,ug,ug,ug,ug,ub,ub,ub,ug,ug,ug,ug,ub,ub,ub,cg,ug
ux,ug,ux,ux,ug,ug,ug,ux,ux,ux,ug,ub,ub,ug,ug,ug,ug,ug,ug,ub,ub,ur,cb
ux,ug,ux,ux,ug,ug,ug,cr,ur,ur,ur,ur,ur,ur,cg,ug,ur,ur,ug,ub,ub,ub,ub
cg,ug,ux,ux,ug,ug,ug,ug,ub,ub,ub,ub,ub,ug,ug,ug,ug,ug,ug,ub,ub,ub,ub
ub,ub,ub,ub,ub,cg,ug,ug,ug,ug,ug,ug,ur,ug,ug,ub,ug,ux,ub,ub,ub,ub,ub
ub,ub,ub,ub,ug,ug,ug,ug,ug,ub,ub,ug,ur,ub,ug,ug,ug,ux,ux,ux,ux,ub,ub
ub,ub,ux,ub,ug,ub,ug,ug,ug,ux,ux,ug,ur,ux,ux,ux,ux,ux,ux,ux,ux,ur,ur
ub,ub,ux,ub,ub,ub,ub,ub,ub,ub,ub,ug,ur,ub,ux,ux,ux,ux,ux,ux,ux,ur,ur
ub,ub,ub,cb,ug,ug,ug,ug,ug,ug,ug,ug,ur,ur,ur,ur,ur,ur,ur,ur,ur,ur,ur
ub,ub,ub,ub,ub,ur,ur,ur,ur,ur,ur,ur,ur,ur,ur,ur,ur,ur,ur,ur,ur,ur,ur
cr,ux,ux,ux,ux,ux,ux,ux,ux,ux,ux,ux,ux,ux,ux,ux,ux,ux,ux,ux,ux,ux,cb
cg,ux,ux,ux,ux,ux,ux,ux,ux,cg,ux,ux,ux,ux,ux,ux,ux,ux,ux,ux,ux,ux,cb