ux,ux,ux,ux,ux,ur,ur,ur,ur,ur,ur,ur,ux,ux,ux,ux,ux,ux,ux,ux,ux,ux,ux
ur,ux,ur,ur,ur,ur,ur,cr,ux,ux,ux,ur,ur,ur,ux,ux,ux,ux,ux,ux,ux,ux,ux
ur,ur,ur,ur,ur,ur,ur,ur,ur,ur,ur,ur,ur,ur,ur,ur,ur,ur,ur,ur,ur,ur,ur
ux,ur,ur,ur,ur,cg,ug,ug,ug,ug,ur,ur,ur,ur,ux,ux,ux,ux,ux,ux,ur,ur,cb
ux,ux,ux,ur,ur,ur,ur,ur,ub,ub,ur,ur,ub,ur,ub,ux,ux,ux,ux,ux,ur,ur,ur
ur,ur,ur,ur,ur,ur,ur,ur,ub,ub,ug,ug,ug,ug,ug,ur,ur,ur,ur,ux,ur,ur,ur
ur,ur,ur,ur,ur,ur,ur,ug,ub,ub,ug,ug,ug,ug,ug,ub,ur,ub,ur,ux,ur,ur,ur
ur,ur,ur,ur,ur,ur,ur,ur,ub,ub,ug,ug,ug,ug,ug,ug,ur,ub,ur,ur,ur,ur,ur
cg,ur,ur,ur,ur,ur,ux,ur,ub,ub,ub,ug,ub,ub,ug,ug,ug,cg,ur,ur,ur,ur,ur
cb,ur,ur,ur,ur,ur,ur,ur,ub,ub,ub,ug,ug,ug,ug,ug,ug,ur,ur,ur,ur,ur,ur
ub,ub,ur,ur,ur,ur,ub,ub,ub,ur,ur,cr,cb,ug,ug,ug,ug,ub,ub,ub,ur,ur,ur
ub,ub,ub,ur,ur,ur,ub,ur,ur,ur,ur,ur,ub,ux,ub,ux,ug,cr,ur,ub,ur,ur,ur
ub,ur,cb,ub,ur,ur,cb,ur,ur,ur,ur,ur,cr,ub,ub,ux,ug,ur,ur,ub,ur,ur,ur
ub,ub,ux,ub,ub,ub,ux,ub,ub,ub,ub,ub,ub,ub,ub,ub,ug,ur,ur,ub,ur,ur,ur
cg,ub,ux,ux,ux,ub,ub,ux,ub,ub,ub,ub,ub,ub,ub,ub,ug,cb,ur,cr,ur,ur,ur
ub,ub,ux,ux,ux,ux,ub,ux,ub,ub,ub,ub,ub,ub,ub,ub,ug,ub,ur,ur,ur,ur,ur
ub,ub,ux,ux,ux,ux,ux,ux,ub,ub,ub,ub,ub,ub,ux,ub,ug,ub,ur,ur,ur,ur,ur
ub,ub,ux,ux,ux,ux,ux,ux,ub,ub,ub,ub,ub,ux,ux,ub,ug,ub,ur,ur,ur,ur,ur
ub,ub,ub,ux,ux,ux,ux,ux,ub,ub,ux,ux,ux,ux,ux,ub,ug,ub,ur,ur,ur,ur,ur
ub,ub,cg,ug,ug,ug,ug,ug,ug,ub,ug,ug,ug,ug,ug,ub,ug,ub,ur,ur,ur,ur,ur
ub,ux,ug,ug,ug,ug,ug,ug,ug,ug,ug,ub,ub,ub,ub,ub,ug,ub,ub,ur,ur,ur,ur
ub,ub,ub,ub,ub,ub,ub,ub,ub,ub,ug,ug,ug,ub,ug,ug,ug,ub,ur,ur,ur,ur,cb
ux,ub,ub,ub,ub,ub,ub,ub,ub,cg,ub,ub,cr,ur,ur,ur,ur,ur,ur,ur,ur,ur,ur