ur,ur,ur,ur,ur,cb,ub,ub,ub,ur,ur,ur,ur,ur,ur,ur,ur,ur,ur,ur,ur,ur,ur
ur,ur,ur,ur,ur,cr,cr,ub,cr,ur,ub,ur,ur,ur,ux,ux,ux,ux,ub,ux,ub,cr,ur
ur,ur,ur,ur,ur,ur,ur,ur,ur,ub,ub,ur,ug,ug,ug,ug,ug,ug,ug,ug,ug,ug,ug
ur,ur,ur,ur,ur,ub,ur,ur,ur,ur,ur,ur,ug,ug,ug,ug,ug,ug,ug,ug,ur,ub,ug
ur,ur,ur,ur,cr,ur,ur,ub,ub,ub,ub,ub,ug,ub,ub,ug,ug,ug,ub,ug,ub,ub,ug
ur,ur,ur,ub,ub,ub,ub,ug,ug,ub,ug,cb,ug,ub,ub,ug,ug,ug,ug,ug,ub,ub,ug
ur,ub,ur,ub,ub,ub,ug,ug,ub,ub,ub,ur,ub,ub,ub,ub,ug,ub,ub,ub,ux,ur,ug
ur,ur,ur,ub,ub,ub,cg,ub,ub,ub,ub,ur,cb,ur,ug,ub,ub,ub,ug,ub,ub,ur,ug
cg,ub,ur,ur,ub,ub,ub,ub,ub,ub,ub,ur,ur,ur,ug,ug,ug,ug,ug,ug,ub,ux,ug
ur,ub,ub,ub,ub,ub,ub,ub,ub,ub,ub,ub,ur,ub,ub,ub,ug,ub,ug,ug,ub,ux,ug
ur,ux,ux,ux,ux,ub,ux,ux,ux,ub,ub,cb,ur,ub,ux,ub,ug,ub,ug,ug,ux,ux,ug
ur,ux,ux,ub,ub,ub,ux,ux,ux,ub,ub,ub,ur,ub,ux,ux,ug,ux,ug,ug,ux,ux,ug
ur,ux,ux,ub,ub,ub,ub,ug,ug,ub,ub,ub,ub,ux,ux,ux,ug,ux,ug,ug,ux,ux,ug
ur,ux,ux,ux,ux,ub,ug,ug,ub,ub,ub,ub,ub,ux,ux,ug,ug,ug,ug,ug,ux,ux,ug
ur,ux,ux,ux,ux,ub,ug,ug,ub,cb,ub,ub,ub,ux,ux,ug,ug,ug,ug,ug,ux,ux,ug
ur,ux,ux,ux,ux,ux,ux,ux,ub,ub,ub,ub,ur,ug,ug,ug,ug,ug,ug,ug,ub,ub,ug
ur,ux,ux,ux,ux,ux,ub,ub,ub,ux,ux,ug,ur,ug,ug,ug,cg,ux,ug,ug,ub,ub,ug
ur,ux,ux,ux,ux,ub,ub,ub,ub,ux,ux,ug,ur,ug,ug,ux,ug,ux,ug,ug,ub,ub,ug
ur,ux,ux,ux,ux,ux,ux,ub,ux,ux,ux,ux,ur,ux,ug,ux,ug,ug,ug,ug,ub,ub,ug
ur,ux,ux,ux,ux,ux,ux,ux,ux,ux,ux,ux,ur,ux,ug,ug,ug,ug,ug,ug,ux,ux,ug
ur,ux,ux,ux,ux,ux,ux,ux,ux,ux,ux,ux,ur,ux,ub,ub,ub,ux,ux,ux,ux,ux,ug
ur,ux,ux,ux,ux,ux,ux,ux,ux,ux,ux,ux,ur,ux,ub,ux,ub,ux,ux,ux,ux,ux,ug
ur,ur,ur,ur,cb,ub,ub,ub,ub,ub,ub,ub,ur,ur,cr,ur,ub,ub,ub,ub,ub,cg,ug