ub,ub,cr,cr,ur,ur,ur,ur,ur,ur,ur,ur,ur,ur,ur,ur,ur,cb,ux,ux,ur,ub,ub
ub,cg,ug,cr,cb,ur,ur,ur,ur,ur,ur,ur,ur,ur,ur,ur,ur,ur,ur,ur,ub,ub,ub
ub,cr,ur,ur,ub,ub,ub,ub,ub,ur,ur,ur,ur,ur,ur,ur,ur,ur,ur,ur,ub,ux,ub
ub,ur,ur,ur,ub,ub,ur,ub,ub,ur,ur,ur,ur,ux,ur,ur,ug,ub,ub,ur,ub,ub,ub
cb,ur,ur,ur,ur,ub,ub,ub,ub,ur,ur,ug,ug,ur,ub,ub,ug,ub,ub,ur,ur,ub,ur
ur,ur,ur,ur,ur,ub,ub,ub,ub,ur,ug,ug,ug,ug,cg,ug,ug,ug,ug,ur,ur,ub,ub
ur,ur,ur,ur,ur,ub,ub,ub,cb,ur,ug,ug,ug,ug,ug,ug,ub,ub,cg,ub,ub,ub,ub
ur,ur,ur,ub,ub,ub,ub,ub,ub,ug,ug,ug,ug,ug,ug,ub,ub,ub,ub,ub,ux,ux,ux
ur,ur,ur,ur,ub,cr,ub,ub,ub,ug,ug,ug,ug,ug,ug,cb,ux,ux,ux,ux,ux,ux,ux
ur,ur,ur,ur,ur,ur,ub,ub,ub,ux,ug,ug,cr,ug,ug,ug,ux,ux,ux,ux,ux,ux,ux
ux,ux,ug,ug,ug,ug,ug,ug,ub,ux,ug,ug,ur,ug,ug,ug,ux,ux,ux,ux,ux,ux,ux
ux,ux,ug,ux,ux,ux,ux,ug,ux,ux,ux,ub,ur,ub,ub,ug,ux,ux,ux,ux,ux,ux,ux
ux,ux,ug,ux,ux,ux,ux,ug,ux,ux,ux,ub,ur,ub,ub,ug,ug,ug,ux,ux,ux,ux,cg
ur,ur,ug,ug,ug,ug,ug,ug,ug,ug,ug,ub,ur,ug,ug,ug,ug,ug,ux,ux,ux,ux,ux
ur,ux,ux,ux,ux,ux,ux,ug,ub,ug,ug,ug,ur,ug,ug,ug,ug,ug,ux,ux,ux,ux,ux
ur,ux,ux,ux,ux,ux,ux,ug,ub,ug,ug,ug,ur,ug,ug,ug,ug,ug,ux,ux,ux,ux,ux
ur,ur,ur,ur,ug,ug,ug,ug,ug,ur,ur,ug,ur,ug,ug,ug,ug,ug,ug,ug,ug,ug,ug
cg,ur,ur,ur,ur,ur,ur,ur,ur,ur,ug,ug,ur,ur,ur,ur,ur,ur,ur,ur,ur,ur,ug
ub,ub,ub,ug,ug,ug,ug,ug,ug,ug,ug,ub,ur,ux,ug,ug,ug,ug,ug,ug,ug,ug,ug
ub,cb,ub,ug,ug,ug,ug,ux,ux,ug,ug,ux,ur,ux,ug,ug,ug,ug,ug,ug,ug,ug,ug
ub,ub,ub,ub,ux,ux,ug,ux,ux,ux,ux,ug,ur,ug,ug,ug,ux,ux,ux,ug,ug,ug,ug
cr,ur,ub,ub,ux,ux,ug,ux,ux,ux,ux,ug,ur,ug,ug,ug,ug,ug,cg,ug,ux,cb,cr
cg,ur,ur,ur,ur,ur,ur,ur,ur,ur,ur,ur,ur,cb,ug,ug,ug,ug,ux,cg,cb,ux,cr