ur,ur,ur,ur,cr,ur,ur,ur,ur,ur,ur,ur,ur,ur,ur,ur,ur,ur,ur,ur,ur,ur,ur
ur,ur,cr,cb,ub,ur,cb,ur,cr,ux,ux,cr,ur,ur,ur,ur,ur,ur,ur,ur,ur,ur,ur
ur,ux,ur,cr,ur,ur,ub,ub,ux,ux,ux,ux,ur,ub,ux,ux,ux,ur,ur,ur,ur,ur,ur
ur,ux,ux,ur,ur,ur,ur,ur,ur,ux,ur,ur,ur,ub,ur,ur,ur,ur,ur,ur,ur,ur,ur
ur,ur,ux,ur,ur,ur,ur,ur,ur,ur,ur,ur,ur,ub,ur,ur,ur,ur,ur,ur,ur,ur,ur
ur,ur,ux,ur,ur,ur,ur,ur,ur,ur,ur,ur,cb,ub,ur,ur,ug,ug,ur,ur,ur,ur,ur
ur,ub,ub,ur,ur,ur,ur,ur,cg,ug,ug,ug,ug,ug,ug,ug,ug,ug,ub,ur,ur,ur,ur
ur,ub,ub,ub,ug,ub,ub,ub,ur,cb,ur,ug,ub,ug,ug,ug,ub,ug,ur,ur,ur,ur,ux
cg,ub,ub,ux,ug,ub,ub,ub,ub,ub,ub,ug,ub,ug,ug,ug,ub,cg,ug,ug,ug,ux,ux
ur,ub,ub,ug,ug,cg,ub,ub,ub,ub,ub,ug,ug,ug,ug,ub,ub,ur,ug,ug,ug,ux,ux
ur,ub,ub,ug,ub,ug,ub,ub,ug,ub,ub,ug,ub,ur,ur,ur,ur,ur,ux,ux,ug,ux,ux
ux,ux,ug,ug,ub,ug,ub,ub,ug,ub,ug,ug,ug,ux,ux,ug,ur,ur,ux,ur,ug,ux,ux
ux,ub,ug,ub,ub,ug,ub,ug,ug,ub,ug,ug,ug,ux,ug,ug,ur,ur,ur,ur,ug,ux,ux
ux,ub,ug,ug,ub,ug,ub,ug,ug,ub,ub,ug,ug,ux,ug,ub,ur,ux,ux,ux,ug,ux,ux
cg,cb,ub,ug,ub,ug,ux,ux,ug,ub,ub,ug,ug,ug,ug,ug,ur,ug,ug,ux,ug,ux,ux
ux,ux,ub,ug,ux,ug,ug,ug,ug,ug,ug,ug,ug,ug,ug,ug,ur,ux,ug,ux,ug,ux,ux
ux,ux,ux,ug,ug,ug,ug,ux,ug,ux,ub,ug,ug,ug,ux,ux,ur,ug,ug,ux,ug,ux,ux
ub,ub,ub,ub,ub,ub,ub,ub,cb,ug,ug,ug,ug,ug,ug,ux,ur,ur,ur,ur,ur,ur,ur
ub,ub,ux,ux,ug,ug,ux,ux,ug,ug,ug,ug,ug,ug,ug,ux,ux,ug,ug,ug,ug,ux,ur
ub,ub,ug,ug,ug,ug,ug,ub,ub,ug,ug,ug,ug,ug,ug,ug,ug,ug,ub,ub,ub,ux,ur
ub,ub,ub,ub,ub,ub,cr,ur,ur,ur,ur,ur,ur,ur,ur,ur,ur,ur,ur,ur,ur,ur,ur
ub,ub,ub,ux,ux,ux,ux,ux,ug,ux,ux,ub,ux,ux,ux,ux,ub,ub,ux,ub,ub,ux,cb
ub,ub,ug,ug,ug,ug,ug,ug,ug,cg,ux,ux,ux,ux,ux,ux,ub,ub,ux,ub,ub,ux,ux