ux,ur,ur,ur,ur,ur,ur,ur,ur,ur,ur,ur,ur,ur,ur,ur,ur,ur,ur,ur,ur,ur,ur
ux,ur,cb,ur,ur,ur,ur,ur,ur,ur,ur,ur,ur,ur,ur,ur,ur,ur,ur,ur,ur,ur,cr
ur,ur,ub,ub,cr,ur,ur,ur,ur,ur,ur,ur,ur,ur,ur,ur,ur,ur,ur,ur,ur,ur,ur
ur,ur,ur,ur,ur,ur,ur,ur,ur,ur,ur,ur,ur,ur,ur,ur,ur,ur,ur,ur,ur,ur,ub
ur,ur,ur,ux,ur,ur,ur,ur,ur,ur,ur,ur,ur,ur,ur,ur,ur,ur,ur,ur,ur,ur,ub
ur,ur,ur,ux,ur,ur,ur,ur,ur,ur,ur,ur,ur,ur,ur,ur,ur,ur,cb,ur,ur,ub,ub
ur,ur,ur,ur,ug,ug,ur,ur,ur,cr,ur,ur,ur,ug,cr,ur,ur,ur,ub,ub,ub,ub,ux
ur,ur,ur,ur,ug,ug,ur,ug,ug,cb,ug,ug,ug,ug,ug,ug,ur,ur,ur,ur,ub,ub,ux
ur,ur,ur,ur,ug,ug,ur,ug,ug,ub,ug,ur,ug,ug,ug,ug,ug,ur,ur,ur,ub,ur,ur
ur,ub,ub,ub,cg,ub,ub,ub,ub,ub,ub,ub,ug,ug,ub,ux,ug,ug,ux,ux,ug,ux,ur
ur,ur,ur,ur,ub,ug,ub,ub,ug,ub,ub,ub,ux,ug,ub,cg,ug,ug,ux,ux,ug,ux,ur
ur,cr,ur,ur,ur,ug,ub,ub,ug,ug,ub,ub,ub,ub,ub,ug,ug,ug,ux,ux,ug,ux,ur
ur,ub,cb,ur,ur,ug,ug,ug,ug,ub,ub,ub,ub,ub,ub,ug,ug,ug,ux,ux,ug,ux,ur
ux,ux,ub,ub,ug,ug,ur,ug,ub,ub,ub,ub,ub,ug,ug,ug,ug,ug,ux,ux,ug,ux,ur
ux,ux,ux,ux,ug,ug,ur,ux,ub,ub,ux,ub,cb,ub,ux,ux,ux,ux,ux,ux,ug,ux,ur
cg,ux,ux,ux,ug,ug,ug,ug,ub,ub,ug,ub,ub,ub,ux,ux,ux,ux,ux,ux,ug,ux,ur
ug,ux,ux,ux,ux,ux,ug,ux,ub,ux,ug,ub,ub,ub,ux,ux,ux,ux,ux,ux,ug,ux,ur
ug,ux,ux,ux,ux,ux,ug,ug,ug,ug,cr,ur,ur,ur,ur,ur,ur,ur,ur,ur,ur,ur,ur
ug,ux,ux,ux,ux,ux,ur,ux,ub,ub,ux,ux,ux,ug,ux,ux,ux,ur,ur,ur,ug,ur,ur
ug,ux,ux,ux,ux,ux,ur,ux,ux,ux,ux,ux,ux,ug,ux,ux,ux,ux,ux,ux,ug,ux,ur
ug,ux,ux,ux,ux,ux,ur,ux,ux,ux,ux,ux,ux,ug,ux,ux,ux,ux,ux,ux,ug,ux,ur
ug,ug,ug,ug,ug,ug,ug,ug,ug,ug,ug,ug,ug,ug,ur,ur,ur,ur,ur,ur,ug,ur,ur
ur,ur,ur,ur,ur,ur,ur,cg,ug,ug,ug,ug,ug,ug,ug,ug,ug,ug,ug,ug,ug,cb,ur