ur,cb,cb,cr,cb,ub,cr,ur,ur,ur,ur,ur,ur,ur,ur,ur,ur,ur,ur,ur,ub,ub,cb
ur,ur,cb,ur,ur,ur,ur,ur,ur,ur,ur,ur,ur,ur,ur,ur,ur,ur,ur,ur,ub,ub,ux
ur,ur,ur,ur,ur,ur,ur,ur,ur,ur,ur,ur,ur,ur,ur,cr,ur,ur,ur,ur,ug,ug,ug
ur,ur,ur,ur,ur,ur,ur,ur,ur,ur,ur,ur,ur,ur,ur,ur,ur,ur,ur,ur,ux,ux,ug
ur,ur,ur,ur,ur,ur,ur,ur,ur,ur,ug,ug,ug,ug,ug,ug,ur,cg,ux,ux,ux,ux,ug
ur,ur,ur,ur,ur,ur,ur,ur,ur,ur,ur,ur,ur,ur,ur,ug,ur,ug,ux,ux,ux,ur,ug
ur,cr,ux,ur,ub,ub,cr,ug,cr,ur,cb,ub,ub,ub,ur,ug,ug,ug,ug,ux,ux,ur,ug
cb,ux,ur,ur,ub,ub,ug,ug,ug,ug,ug,ug,cg,ub,ur,ur,ug,ur,ug,ug,ug,ur,ug
ux,ux,ur,ur,ur,ur,ug,ug,ug,ug,ug,ug,ug,ur,ur,ux,ug,ug,ug,ug,ug,ur,ug
ux,ux,ur,ur,ur,ur,ur,ur,ug,ug,ug,ug,ug,ux,ux,ux,ug,ug,ug,ug,ug,ur,ug
ur,ur,ur,ur,ur,ur,ur,ur,ug,ug,ug,ug,ub,ub,ux,ux,ug,ux,ug,ug,ug,ur,ug
ur,ur,ug,ug,ug,ug,ux,ug,ux,ug,ub,ub,ub,ub,ub,ub,ub,ub,ub,ub,ub,ub,cb
cb,ug,ug,ug,ug,ug,ug,ub,ux,ub,ub,ug,ub,ub,ug,ux,ug,ug,ug,ug,ur,ug,cg
ug,ug,ug,ug,ug,ub,ub,ug,ub,ub,ub,ug,ub,ub,ug,ug,ug,ug,ug,ug,ur,ug,ux
ub,cb,ug,ug,ug,ub,ub,ub,ub,ub,ub,ug,ub,ug,ug,ug,ug,ug,ux,ux,ur,ug,ux
ub,ub,ub,ub,cb,ub,ug,ug,ub,ub,ub,ub,ux,ux,ur,ug,ur,ux,ux,ux,ur,ug,ux
ug,ug,ug,ug,ub,ub,ub,ug,ug,ug,ug,ug,ug,cg,ug,ug,ur,ux,ux,ux,ur,ug,ux
ug,ug,cg,ug,ur,ur,ur,ur,ur,ur,ur,cr,ub,ub,ug,ug,ug,ug,ug,ug,ug,ug,ub
ub,ub,ub,ub,ur,ub,ub,ux,ux,ux,ux,ux,ug,ux,ug,ub,ub,ub,ub,ub,ub,ub,ub
cr,ux,ux,ux,ur,ug,ub,ux,ux,ux,ux,ug,ug,ub,ug,ub,ub,ub,ux,ux,ux,ux,ux
cg,ux,ux,ux,ur,ug,ug,ug,ug,ug,ug,ug,ub,ub,ug,ug,ug,ug,ux,ux,ux,ux,cr
cr,ux,ux,ux,ur,ug,ug,ug,ug,ug,ug,ub,ub,ub,ur,ub,cg,ug,ux,cb,cb,ux,cr
cg,ux,cg,cb,ur,ur,ur,ur,ur,ur,ur,ur,ur,ur,ur,cg,ug,ug,ux,cg,cg,cb,cr