ur,ur,ur,ur,ur,ur,ur,ur,ur,ur,ur,ur,cr,ub,ub,ub,ur,cb,ux,ux,ux,ux,ux
ur,ur,ur,ur,ur,ur,ur,ur,ur,ur,ur,ur,ur,ur,ur,ub,ur,ux,ux,ux,ux,ux,ux
ur,ur,ur,ur,ur,ur,ur,ur,ur,ur,ur,ur,ur,cr,ur,ub,ub,ux,ux,ux,ux,ux,ux
ur,ur,ur,ur,ur,ur,ur,ur,ur,ur,ur,ur,cr,ug,ub,ub,ub,ux,ux,ux,ux,ux,ux
cb,ur,ur,ur,cg,cr,ur,ur,ub,cb,ur,ur,ub,ug,ub,ub,ub,ub,ux,ux,ux,ux,ux
ur,ur,ur,ur,ug,ug,ur,ur,ub,ub,ub,ub,ub,cg,ug,ub,ub,ub,ux,ux,ux,ux,ux
ux,ux,ur,ur,ur,ub,ub,ub,ub,ub,cg,ub,ub,ub,ub,ub,ub,ub,cb,ug,ux,ux,ux
ux,ux,ur,ur,ug,ur,ur,ur,ur,ur,ug,ur,ug,ug,ug,ug,ug,ug,ug,ug,ux,ux,ux
ur,ur,ug,ug,ug,ux,ur,ug,ug,ug,cr,ug,ug,ug,ug,ug,ug,ug,ug,ug,ur,ur,ux
ur,ur,ug,ug,ux,ux,ug,ug,ug,ug,ur,ug,ug,ug,ug,ug,ux,ux,ux,ug,ur,ur,ux
ur,ur,ug,ug,ug,ux,ug,ug,ux,ug,ur,ug,ug,ug,ug,ug,ug,ug,ug,ug,ur,ur,ux
ur,ur,ur,ug,ug,ug,cb,ug,ug,ug,cb,ug,ub,ub,ub,ub,ub,ub,ub,ug,cg,ur,ux
ur,ur,ur,ug,ug,ug,ub,ub,ub,ub,ub,ub,ub,ub,ub,ux,ub,ux,ux,ug,ur,ur,cg
ur,ur,ur,ur,ur,ur,ub,ub,ur,ub,ub,ug,ug,ur,ub,ub,ub,ur,ur,ug,ur,ur,ur
ur,ur,ur,ub,ub,ub,ub,ub,ub,ub,ug,ug,ug,ur,ux,ux,ur,ur,ur,ug,ur,ur,ur
ur,ur,ub,ub,ug,ug,ug,ug,ug,ug,ug,ug,ug,ur,ux,ux,ur,ur,ux,ug,ur,ur,ur
ur,ub,ub,ub,ub,ug,ux,ug,ux,ux,ub,ux,ux,ur,ux,ux,ur,ur,cr,ug,ur,ur,ur
cg,ub,ub,ub,ub,ug,ub,ug,ub,ub,ub,ux,ux,ur,ux,ux,ur,ur,ur,ug,ur,ur,ur
ug,ub,ub,ub,ub,ug,ug,ug,ug,ug,ug,ug,ug,ug,ug,ug,ur,ur,ur,ug,ur,ur,ur
ug,ug,ug,ug,ug,ug,ug,ug,ux,ux,ux,ux,ux,ur,ux,ug,ug,ur,ur,ur,ur,ur,ur
ub,ub,ub,ub,ub,ux,ug,ug,ux,ux,ux,ux,ux,ur,ux,ux,ur,ur,ur,ur,ur,ur,ur
cr,ux,ug,ug,ug,ug,ug,ug,ux,ux,ux,ux,ux,ur,ur,ur,ur,ur,ur,ur,ur,cb,cr
cg,ux,ug,ug,ug,ug,ug,ug,ux,ux,ux,ux,ux,cb,ux,ux,ux,ux,ux,cg,cb,ux,cr