ur,ur,cb,ur,ur,ur,ur,ur,ur,ur,ur,ur,ur,ur,ur,ur,ur,cb,ur,cg,ur,ur,ux
ur,ur,ur,ur,ur,ux,ur,ur,ur,ux,ux,ur,ur,ur,ur,ug,ug,ug,ur,ur,ur,ur,ur
ur,ur,cr,ug,cg,ux,ur,ur,ur,ur,ur,ur,ur,ur,ug,ug,ur,ug,ur,ur,ur,ur,ur
ur,ur,ur,ur,ur,ur,ur,ur,ur,ug,ur,ur,ur,ur,cg,ur,ur,ug,ur,ur,ur,ur,ur
ur,ur,ur,cr,ur,ur,ur,ur,cr,ug,ug,ur,cb,ur,ur,ur,ur,ug,ur,ur,ur,ur,ur
ur,ur,ur,ur,ur,ur,ur,ub,ub,ur,ug,ur,ub,cr,ur,ur,ur,ug,ug,ur,ur,ur,ur
ur,ur,ur,ur,ur,ur,ur,ub,ub,ur,ur,ub,ub,cg,ug,cr,ug,ug,ug,ug,ur,ur,ur
ur,ur,ur,ur,ur,ur,ur,cb,ub,ub,ub,ub,ub,ub,ub,ub,ug,ur,ug,ur,ur,ur,ur
ur,ur,ur,ur,ur,ur,ur,ur,ub,ub,ug,ub,ub,ub,ug,ux,ug,ug,ug,ur,ux,ux,ux
ur,ur,ur,ur,ur,ub,ub,ub,ub,ub,ug,ug,ug,ug,cr,ub,ux,ux,ug,ur,ux,ux,ux
ux,ux,ub,ux,ux,ux,ux,ub,ub,ug,ug,ug,ug,ug,ur,ub,ub,ux,ub,ub,ub,ub,ub
ux,ux,ub,ug,ux,ug,ug,ug,cg,ug,ug,ug,ug,ug,ur,ug,ug,ug,ub,ur,ug,ux,ub
ug,ug,ug,ug,ug,ug,ub,ug,ug,ug,ug,ug,ug,ug,ur,ug,ug,ug,ub,ub,ug,ux,ub
ux,ux,ub,ug,ux,ux,ux,ug,ug,ug,ug,ug,ug,ug,ur,ux,ux,ux,ug,ub,ub,ub,ub
ux,ux,ub,ug,ux,ux,ux,ug,cg,ug,ug,ug,ux,ux,ur,ux,ub,ub,ub,ub,ub,ux,ux
ux,ux,ub,ug,ux,ux,ux,ux,ux,ug,ug,ug,ux,ug,ur,ux,ub,ub,ug,ub,ub,ub,cb
ux,ux,ub,ug,ux,ux,ux,ux,ux,ug,ug,ug,ux,ux,ur,ux,ux,ub,ub,ub,ub,ux,ux
cg,ux,ub,ug,ux,ux,ux,ux,ux,ux,ux,ug,ux,ux,ur,ux,ux,ux,ub,ur,ub,ub,ux
ux,ux,ub,ug,ux,ux,ux,ux,ux,ux,ux,ux,ux,ux,ur,ux,ux,ux,ug,ur,ug,ub,ux
ux,ux,ub,ug,ux,ux,ux,ux,ux,ux,ux,ux,ux,ux,ur,ux,ux,ux,ug,ur,ug,ux,ux
cr,ux,ub,ug,ug,ug,ug,ub,ub,ub,ub,ub,ub,ub,ub,ub,ub,ub,cb,ur,ux,ux,ux
cg,ux,ub,ub,ub,ub,ub,ub,ux,ux,ux,ux,ux,ux,ur,ux,ux,ux,ux,ur,ux,cb,cr
cr,ux,ub,ub,ux,ub,ub,ux,ux,ux,ux,ux,ux,cb,ur,ur,ur,ur,ur,ur,cb,ux,cr