ux,ux,cb,ur,ur,ur,ur,ur,ur,ur,ur,ur,ur,ur,cr,ux,ub,cr,ur,cg,ur,ur,ur
ux,ux,ur,ur,ur,ur,ur,ur,ur,ur,ur,ur,cr,ub,ub,ur,ub,ub,ur,ur,ur,ur,ur
ur,ur,ur,ur,ur,ur,ur,ur,ur,ur,ur,ur,ux,ux,ub,ur,cb,ub,ub,ur,ur,ur,ur
ur,ug,ug,ug,ug,ug,ug,ur,ur,ur,ur,ur,ur,ur,ub,ub,cb,ur,ur,ur,ur,ur,ur
ur,ug,ur,ur,ur,ur,ug,ur,ur,ur,cg,ug,ur,ur,ux,ug,ur,ug,ug,ur,ur,ur,ur
ur,ug,ug,ur,ur,ug,ug,ur,ur,ur,ur,ug,ug,ur,ug,ug,ug,ur,ug,ur,ur,ur,ur
ur,ur,ug,ug,cg,ur,ur,ur,ur,ur,ur,ur,ug,ur,ug,ur,ug,ur,ug,ug,ur,ur,ur
ur,ur,cr,ur,ur,ur,ur,ur,ur,ur,ub,ug,ug,ug,ug,ug,ug,ug,ug,ug,ug,ur,ur
ur,ur,ur,ur,ur,ux,ub,ug,ug,ug,ug,ur,ur,ur,ur,ug,ub,ug,ur,ur,ug,ux,ux
ur,ur,ur,cr,ur,ur,ub,ug,ub,ub,ug,ux,ub,ub,ux,ug,ug,ug,ug,ug,ug,ux,ux
ux,ux,ux,ux,ug,ug,ug,ug,ug,ug,ug,ug,ub,ug,ug,ug,ug,ug,ug,ur,ur,ur,ur
ux,ux,ux,ux,ub,ug,ug,ug,ux,ug,ug,ug,ub,ug,ux,ug,ug,ug,ug,ug,ub,ux,ur
cg,ux,ux,ux,ub,ux,ug,ug,ug,ug,ug,ug,ug,ug,ug,ug,ug,ux,ux,ug,ub,ux,ur
ux,ux,ux,ux,ub,ub,ug,ux,ug,ub,ub,ub,ug,ug,ux,ug,ub,ug,ug,ug,cb,ub,ur
ux,ux,ux,ux,ub,ub,ug,ug,cg,ub,ub,ub,ux,ug,ug,ug,ub,ug,ug,ub,ub,ub,ub
ux,ux,ux,ux,ux,ub,ub,ub,ub,ub,cb,ug,ux,ug,ug,ug,ub,ub,ug,ub,ub,ub,ub
ux,ux,ux,ux,ux,ub,ub,ub,ug,ub,ub,ug,ux,ug,ux,ug,ug,ug,ug,ub,ub,ub,ub
cg,ux,ux,ux,ux,ub,ub,ub,ux,ub,ub,ug,ux,ug,ux,ug,ug,ug,ug,ub,ub,ub,ub
ux,ux,ux,ux,ub,ub,ub,ug,ug,ub,ug,ug,ux,ug,ux,ug,ub,ub,ub,ub,cb,ub,ub
ux,ux,ux,ux,ux,ux,cg,ug,ug,ug,ug,ug,ug,ug,ux,ug,ub,ug,ug,ux,ub,ub,ub
cr,ur,ur,ur,ur,ur,ur,ur,ur,ur,ur,ur,ur,ur,ur,ur,ur,ur,ur,ur,ur,ub,ub
cg,ur,ux,ux,ux,ux,ux,ux,ux,ux,ux,ux,ux,ub,ux,ur,ub,ub,ub,ub,ub,cb,cr
cr,ur,ur,ur,ur,ur,ur,ur,ur,ur,cr,ux,ux,cb,ur,ur,ub,ub,ub,ub,cb,ux,cr