ur,ur,ur,ur,ur,ur,ux,ux,ux,ur,ur,ur,ur,ur,ur,ur,ub,cb,ux,ub,ub,ux,ux
ur,ur,ur,ur,ur,ur,ur,ur,ur,cr,ub,ux,ux,ur,ur,ur,ub,ub,ub,ub,ux,ux,ux
ur,ur,ur,ur,ur,ur,ur,ub,ub,ur,ub,ug,ug,ug,ux,ur,ur,ur,ub,ub,ur,ur,ur
ur,ub,ur,ur,ur,ur,ur,ub,ur,ur,ub,ux,ux,ug,ub,ub,ub,ub,ub,ub,ub,ub,ur
cr,ur,cr,ur,ur,ur,ub,ub,ug,ur,cr,ug,ug,ug,ub,ug,ug,ub,ux,ub,ub,ub,ur
ux,ub,ub,ub,ug,ur,cg,ub,ub,ub,ur,ub,ub,ub,ub,ug,ug,ub,ub,ux,ux,ux,ur
ub,ub,ur,ub,ur,ur,ug,ur,ur,cb,ur,ug,ug,ur,ub,ug,ug,ub,ub,ub,ux,ux,ur
ub,ub,ur,cb,ur,ur,ug,ug,ur,ub,ug,ub,ug,ux,ub,ug,ug,ub,ux,ux,ux,ux,ur
cg,ub,ur,ur,ur,ug,ur,ug,ug,ug,ug,ub,ug,ux,ub,ub,ub,ub,ux,ux,ux,ux,ur
ub,ub,cr,ur,ur,ug,ug,ug,ug,ub,ub,ub,ug,ub,ux,ux,ux,ub,ub,ux,ux,ux,ur
ub,ur,ur,ux,ur,ur,ur,ur,ug,ug,ub,ub,ub,ub,ux,ux,ux,ub,ub,ux,ux,ux,ur
ub,ux,ur,ur,ur,ur,ur,ur,ub,ug,ug,ug,ug,ub,ub,ux,ub,ub,ub,ub,ux,ux,ur
ub,ub,ur,ux,ux,ug,ug,ub,ux,ux,ub,ub,ug,ub,ub,ub,ub,ub,ub,ub,ux,ux,ur
ub,ub,ug,ux,ug,ug,ux,ub,ub,ub,ub,ub,cg,ub,ub,ub,ub,ub,ux,ux,ux,ux,ur
ub,ub,ub,ux,ug,ux,ug,ub,ub,ub,ub,cb,ux,ux,ub,ug,ug,ub,ux,ux,ux,ux,ur
ub,ub,ub,ux,ug,ux,ug,ub,ub,ux,ux,ux,ux,ub,ub,ug,ug,ub,ux,ub,ub,ub,ur
ub,ub,ug,ux,ug,ug,ux,ub,ub,cb,ug,ug,ux,ub,ug,ug,ux,ub,ux,ub,ux,ub,ur
cr,ub,ug,ux,ux,ug,ub,ub,ub,ux,ug,ug,ux,cb,ug,ug,ug,ub,ub,ub,ux,ub,ur
ur,ub,ub,ub,ub,ub,ub,ub,ub,ub,ub,ub,ub,ug,ub,ub,ub,ub,ub,ub,ub,ub,ur
ur,ub,ub,ub,ub,ub,ub,ub,ub,ub,ub,ub,ub,ug,cg,ux,ux,ub,ux,ux,ux,ux,ur
ur,ub,ub,ub,ub,ub,ub,ub,ub,ub,ub,ux,ug,ug,ug,ux,ux,ub,ux,ux,ux,ux,ur
ur,ux,ux,ux,ux,ux,ux,ux,ux,ub,ub,ub,ub,ub,ub,ub,ub,ub,ux,ux,ux,ux,ur
ur,ur,ur,ur,ur,ur,ur,ur,ur,ur,ur,ur,ur,ur,ur,ur,ur,ur,ur,ur,ur,ur,ur