ur,ur,ur,ur,ur,ur,ur,ur,ur,ur,ur,ur,ur,cr,ub,ur,ur,ur,ur,ur,cb,ur,cb
ur,ur,ur,ur,ur,ur,ur,ur,ur,ur,ur,ur,ur,ur,ub,ub,ur,ux,ux,ux,ub,ur,ux
ur,ur,ur,ur,ur,ur,ur,ur,ur,ur,ur,ur,ur,ur,ur,ub,ub,ub,ub,ub,ub,ur,ux
ur,ur,ur,ur,ur,ur,ur,ur,ur,ur,ur,ur,ur,ur,ur,ur,ur,ur,ur,ur,ur,ur,ux
ur,ur,ur,ur,ur,ur,ur,ur,ur,ur,ur,ur,ur,ur,ur,ur,ur,ur,ur,ur,ur,ur,ux
ur,ub,ur,ur,ur,ur,ur,ur,ur,ur,ur,ur,ur,ur,ur,ur,ur,ur,ug,ug,ug,ur,ur
ur,ur,cr,ur,ux,cr,ur,ur,ur,ur,ur,ug,cr,ur,cr,ur,ur,ur,ug,ug,ug,ur,ur
ux,ub,ub,ur,ur,ur,ug,ur,ur,ug,ur,ur,ub,ub,ur,ur,ur,ur,ug,ug,ug,ur,ur
cg,ub,ux,ux,ux,ur,ur,ur,ur,ur,ur,cb,ub,ub,ub,ug,ug,ur,ug,ug,ug,ur,ur
ur,ub,ur,ux,ux,ux,ug,ux,ux,ux,ug,ub,ub,ub,ub,ug,ug,ur,ur,ug,ug,ur,ur
ur,ub,ur,ur,ur,ux,ux,ux,ub,ub,ub,ub,ub,ub,ub,ug,ug,ug,ug,ug,ub,ur,ur
ur,ub,ur,ur,ub,ub,ub,ux,ub,ub,ub,cg,ug,ug,ug,ug,ug,ug,ug,ub,ub,ub,ur
ub,ub,ub,ub,ub,ub,ug,cb,ug,ub,ub,ug,ub,ub,ux,ux,ux,ub,ub,ux,ux,ub,ur
ub,ux,ux,ub,ub,ub,ub,ub,ug,ug,ug,ub,ub,ub,ux,ux,ux,ux,ub,ux,ux,ub,ur
ub,ux,ux,ux,ug,ug,ub,ub,ug,ug,ug,ug,ug,ug,ug,ug,ug,ug,ub,ub,ub,ug,ur
ub,ux,ux,ux,ug,ub,ub,ub,ug,ug,ug,ug,ug,ug,ug,cg,ux,ux,ux,ub,ub,ug,ur
ub,ux,ux,ux,ub,ub,cb,ub,ug,ub,ub,ux,cr,ux,ux,ux,ux,ub,ub,ub,ub,ug,ur
ub,ux,ux,ux,ub,ub,ub,ub,ub,ux,ux,ux,ur,ux,ux,ux,cb,ub,ub,ub,ub,ug,ur
ub,ux,ux,ux,ux,ub,ub,ub,ub,ux,ux,ux,ur,ux,ux,ux,ux,ux,ub,ub,ux,ug,ur
ub,ux,ux,ub,cg,ug,ub,ub,ux,ux,ux,ux,ur,ux,ux,ux,ux,ux,ux,ux,ux,ug,ur
ub,ug,ug,ub,ub,ug,ug,ub,ux,ux,ux,ux,ur,ux,ux,ux,ux,ux,ux,ux,ux,ug,ur
ub,ux,ux,ux,ux,ux,ug,ug,ug,ug,ug,ug,ur,ux,ux,ux,ux,ux,ux,ux,ux,ug,ur
ub,ub,ub,ub,ub,ub,ur,ur,ur,ur,ur,ur,ur,ur,ur,ur,ur,ur,ur,ur,ur,ur,ur