ur,ur,ur,ur,ur,ur,ur,ur,ur,ur,ur,cr,ur,ur,ub,ub,ub,ur,ur,ur,ur,ur,cb
ur,ux,ur,ux,ux,ur,ur,ur,ur,ur,ur,ur,ur,ur,ub,ub,ub,ur,ur,ur,ur,ur,ur
ur,ux,ur,ux,ur,ur,ur,ur,ur,ur,ur,ur,ug,ur,cb,ub,ub,ug,cr,ur,ub,ur,ur
ur,ur,ur,ur,ur,ub,cr,ub,ur,ur,ur,ur,ur,ur,ug,ur,ug,ur,ux,ur,ur,ux,ur
ur,ur,ur,ur,ur,ub,ur,ub,ur,ur,ur,ur,ur,ur,ug,ug,ug,ur,ur,ur,cr,ur,ur
ur,ub,ug,ug,ur,ub,cb,ub,ur,cr,ug,ur,ub,ug,ug,ug,ug,ug,ux,ux,ux,ur,ux
ub,ub,ug,ug,ug,cg,ug,ug,ug,ur,ur,ur,ug,ug,ug,ub,ug,ug,ux,ux,ux,ux,ux
ub,ub,ug,ug,ur,cg,ub,ub,ux,ub,ub,ub,ug,ug,ux,ub,ug,ug,ux,ux,ux,ux,ux
cg,ub,ug,ub,ub,ug,ub,ub,ux,ub,cb,ub,ub,ub,ub,ub,ug,ug,ux,ux,ux,ux,ux
ur,ur,ug,ug,ug,ug,ug,ug,ub,ub,ub,ub,ub,ub,ub,ub,ug,ug,ug,ur,ur,ur,ur
ur,ub,ux,ug,ug,ux,ux,ux,ub,ub,ub,ub,ub,ub,ub,ub,cb,ub,ub,ub,ux,ux,ur
ur,ux,ux,ug,ug,ux,ux,ux,ux,ux,ub,ub,ub,ub,ub,ub,ub,ub,ub,ub,ux,ux,ur
ur,ux,ux,ug,ug,ux,ug,ug,ux,ux,ub,ug,cb,ub,ug,ub,ub,ub,ub,ub,ub,ux,ur
ur,ux,ux,ug,ug,ux,ug,ug,ux,ug,ub,ug,ub,ug,ug,ug,ub,ub,ub,ux,ub,ux,ur
ur,ux,ux,ug,ug,ux,ug,ug,ux,ug,ug,ug,ug,ug,ug,ug,ug,ub,ub,ux,ub,ux,ur
ur,ux,ux,ug,ug,ur,ur,ur,ur,ur,ur,ug,ug,ug,ug,cg,ur,ur,ur,ur,ur,ur,ur
ur,ux,ux,ug,ug,ur,ug,ux,ux,ug,ug,ug,ug,ug,ug,ux,ug,ub,ub,ub,ux,ux,ux
ur,ux,ux,ug,ug,ur,ug,ug,ug,ug,ug,ug,ug,ug,ug,ux,ug,ux,ub,ub,ux,ux,ux
ur,ur,ur,ug,ug,ur,ug,ug,ug,ug,ur,ur,ur,ur,ug,ug,ug,ux,ux,ux,ux,ux,ux
ur,ur,ux,ub,ug,ur,ug,ug,ux,ux,ux,ux,ux,ux,ux,ux,ux,ux,ux,ux,ux,ux,ux
ur,ur,ub,ub,ux,ur,ux,ux,ux,ux,ux,ux,ux,ux,ux,ux,ux,ux,ux,ux,ux,ux,ux
ur,ur,ub,ux,ux,ur,ux,ux,ux,ux,ux,ux,ux,ux,ux,ux,ux,ux,ux,ux,ux,ux,ux
ur,ur,ux,ux,ux,ur,ur,ur,ur,ur,ur,cr,ux,ux,ux,ux,ux,ux,ux,ux,ux,ux,ux