ur,ur,ur,ur,ur,ur,ur,ur,ur,cg,ur,ur,ur,ur,ur,ur,ur,cb,ux,ug,ug,ub,ub
ur,ur,cr,ur,ur,ur,ur,ur,ur,ur,ur,ur,ux,ux,ub,ux,ur,ux,ux,ug,ux,cb,ub
ur,ub,ub,ur,ug,ug,ug,ur,ur,ur,ur,ux,ux,ux,ub,cr,ur,ux,ux,ug,ux,ug,ub
ur,ub,ub,ur,ur,cg,ug,ug,ur,ux,ub,ub,cb,ub,ub,ux,ug,ug,ug,ug,ux,ug,ub
ur,ub,ub,ub,cb,ug,ug,ur,ur,ub,ub,ub,ug,ub,ub,ub,ub,ug,ug,ub,ug,ug,ub
ur,ur,ur,ur,ur,ur,ur,ur,ur,ur,ub,cg,ug,ub,ub,ub,ub,ug,ug,ug,ug,ux,ub
ur,ur,ur,cr,cr,ur,ur,ur,ur,ur,ub,ub,ux,ux,ub,ub,ub,ux,ux,ug,ug,ux,ub
ur,ur,ur,ux,ux,ug,ug,ug,ug,ub,ub,cb,ux,ug,ug,ug,ug,ug,ug,ug,ug,ux,ub
ur,ur,ur,ur,ur,ur,ur,ug,ur,ub,ub,ur,ur,ur,ur,ur,ur,ur,ur,ur,ur,ux,ub
ur,ux,ur,ux,ub,ug,ug,ug,ub,ub,ub,ug,ux,ug,ug,ug,ug,ug,ug,ug,ur,ux,ub
ur,ub,cr,ub,ub,ub,ub,ub,ub,ug,ug,ug,ux,ug,ug,ug,ug,ug,ug,ux,ur,ux,ub
ur,ub,ub,ux,ub,ub,ub,ug,ub,ub,ub,ux,ub,ug,ug,ux,ug,ug,ug,ux,ur,ux,ub
ur,ub,ub,ub,ug,ub,ub,cg,ug,ug,ub,ub,ub,ub,ug,ug,ug,ux,ug,ux,ur,ux,ub
ur,ub,ub,ub,ug,ub,ug,ug,ug,ug,ub,ub,ub,ub,ug,ug,ug,ug,ug,ux,ur,ux,ub
ur,ub,ub,ub,ug,ub,ug,ug,ug,ug,ug,ug,ug,cb,ug,ug,ug,ux,ux,ux,ur,ug,ub
ur,ub,ub,ub,ug,ug,ug,ug,ug,ub,ub,ug,ug,ub,ux,ux,ug,ux,ux,ux,ur,ug,ub
ur,ub,ux,ux,ub,ug,ug,ug,ug,ug,ug,ug,ug,ux,ux,ux,ux,ux,ux,ux,ur,ug,ub
ur,ub,ub,ub,ub,ug,ug,ug,cg,ub,ux,ub,ug,ux,ux,ux,ux,ux,ux,ux,ur,ug,ub
ur,ux,ux,ux,ux,ux,ub,ug,ux,ub,ub,ug,ug,ux,ux,ux,ux,ux,ux,ux,ur,ug,ub
ur,ux,ux,ux,ux,ub,ug,ub,ub,ub,ub,ug,ug,ux,ux,ux,ux,ux,ux,ub,ur,ug,ub
ur,ur,ur,ur,ur,ur,ur,ub,ub,ub,ur,ub,ur,ur,ur,ur,ur,ur,ub,ub,ur,ug,ur
cr,ux,ux,ux,ux,ub,ub,ub,ub,ub,ub,ub,ux,ux,ux,ux,ux,ux,ub,ub,ur,ug,cb
cg,ux,ux,ux,ux,ux,ux,ux,cb,ub,ub,ub,ub,ub,ub,ub,ub,cr,ur,ur,cg,ug,ug