ur,ur,ur,ur,ur,ur,ur,ur,ur,ur,ur,ur,ur,ur,ur,ur,ur,ur,ur,ur,ur,ur,ur
ur,ur,cr,ur,ub,ur,ur,ur,ur,ur,ur,ur,ur,ur,ur,ur,ur,ur,ur,ur,ur,ur,ur
ur,ur,ub,cb,ub,ur,ux,ux,ux,ur,ur,ur,ur,ur,ur,ur,ur,ur,cb,cr,ux,ur,ur
ur,ur,ur,ur,ur,ur,ur,ur,ur,ur,ur,ur,ur,ur,ur,ur,ur,ur,ub,ub,ux,ur,ur
ur,ur,ur,ur,ur,ux,ur,ur,ur,ur,ur,ur,ur,ur,ur,ur,cr,ux,ug,ux,ux,ur,ur
ur,ur,ur,ur,ur,ur,ur,ur,ur,ur,ur,ur,ur,ur,ur,ur,ux,ux,ug,ux,ux,ur,ur
ux,ur,ur,ur,ur,ur,ur,ur,ur,ur,ur,ur,ug,ux,ux,ux,ux,ux,ug,ux,ux,ur,ur
ur,ur,ur,ur,ur,ur,ur,ur,ur,ur,ur,ur,ug,ub,ux,ux,ux,ux,ux,ux,ux,ur,ur
ur,ur,ur,ur,ur,ur,ur,ur,ur,ur,ug,ub,ug,ub,ub,ux,ux,ux,ux,ux,ux,ur,ur
ur,ur,ur,ur,ur,ur,ur,ur,ur,ur,ug,ub,ug,ub,ub,ub,ux,ux,ux,ux,ux,ur,ur
cg,ur,ur,ur,ur,ur,cr,ur,ur,ur,ug,cb,ub,ub,ub,ub,ux,ux,ux,ux,ux,ur,ur
ur,ur,ur,ur,ur,ur,ug,ug,ug,ub,ub,ub,ub,ub,ux,ux,ux,ux,ux,ux,ur,ur,ur
cb,ub,ur,ur,ur,ur,cg,ub,ub,ug,ub,ub,ub,ub,cb,ux,ux,ux,ux,ux,cr,ux,ux
cr,ub,ur,ur,ur,ur,ur,ur,ug,ux,ub,ub,ub,ub,ub,ux,ux,ux,ux,ux,ur,ux,ux
ur,ur,ur,ur,ug,ur,ur,ur,ug,ug,ub,ub,ub,ub,ux,ux,ux,ux,ux,ux,ur,ux,ux
ur,ur,ur,ux,ur,ux,ux,ux,ur,ux,ux,ux,ux,ux,ux,ux,ux,ux,ux,ux,ur,ux,ux
ub,ub,ug,ux,ur,ux,ux,ux,ur,ux,ux,ux,ux,ux,ux,ux,ux,ux,ux,ux,ur,ux,ux
ub,ur,ug,ub,ub,ub,ub,ub,ub,ub,ub,ub,ub,ub,ub,ub,ub,ub,ub,ub,ub,ub,ub
ub,ur,ug,ur,ub,ub,ub,ub,ub,ub,ub,ub,ub,ub,ub,ub,ub,ub,ub,ux,ur,ux,ub
ub,ux,ug,ux,ux,ux,ux,ux,ur,ux,ux,ux,ux,ux,ux,ux,ux,ux,ub,ub,ur,ur,ub
ub,ux,ug,ug,ug,cg,ux,ux,ur,ux,ux,ux,ux,ux,ux,ux,ux,ux,ux,ub,ub,ub,ub
ub,ub,ub,ux,ux,ux,ux,ux,ur,ux,ux,ur,ur,ur,ur,ur,ur,ur,ur,ur,ur,ur,ur
ub,ub,ux,ux,ux,ux,ux,cg,ur,ur,ur,ur,ur,ur,ur,ur,ur,ur,ur,ur,ur,cb,ur