ur,ur,cb,ur,ur,ur,ur,ur,ur,ur,ur,ur,ur,ur,ur,ur,ur,ur,ur,cg,ug,ug,ux
ur,ur,ur,ur,ur,ur,ur,ur,ur,ur,ur,ur,ur,ur,ur,ur,ur,cr,ur,ux,ug,ug,ug
ur,ur,ur,ur,ur,ur,ur,ur,ur,ur,ur,ur,ur,ur,ur,ur,ux,cg,ug,ug,ug,ux,ug
ur,ur,ur,cb,ub,ur,ur,ur,ur,ur,ur,ur,ur,ur,ur,ur,ur,ur,ux,ux,ux,ug,ug
ur,ur,ur,ur,cr,ur,ur,ur,ur,ur,ur,ur,ur,ur,ur,ux,ur,ug,ug,ux,ug,ug,ux
ur,ur,ur,ur,ur,cb,ub,cg,ug,ug,cr,cr,ur,ur,ug,ug,ug,ug,ug,ux,ug,ux,ux
ur,ur,ur,ur,ur,ur,ub,ub,cr,ur,ur,ur,ur,ug,ug,ug,ug,ug,ug,ux,ug,ux,ux
ur,ur,ur,ur,ub,ub,ub,ub,ub,ur,ur,ur,ur,ug,ug,ug,ug,ug,ug,ux,ug,ux,ux
ur,ur,ub,ub,ub,ur,ug,ur,ur,ur,ur,ur,ux,ug,ug,ug,ug,ug,ug,ur,ug,ur,ur
ur,ur,ub,ub,ug,ug,ug,ug,ug,ug,cg,ux,ub,ub,ub,ug,ug,ug,ug,ur,ug,ug,ug
ur,ub,ub,ux,ug,ur,ug,ur,ur,ur,ug,ux,ub,ub,ub,ug,ug,ug,ug,ug,ur,ur,ug
ur,ub,ub,ub,ug,ug,ug,ub,ub,ug,ub,cb,ub,ub,ug,ug,ug,ug,ug,ug,ur,ur,ug
cg,ur,ur,ub,ub,ub,ub,ub,ux,ug,ub,ub,ub,cb,ub,ub,ub,ux,ug,ug,ur,ur,ug
ur,ur,ur,ub,ub,ub,ub,ub,ux,ug,ug,ub,ub,ub,ub,ub,ub,ux,ug,ug,ur,ur,ug
ub,ub,ub,ub,ux,ug,ux,ub,ux,ub,ub,ub,ub,ub,ux,ub,ub,ux,ug,ug,ur,ur,ug
ub,ub,ub,ug,ug,ug,ug,ub,ux,ug,ub,ug,ug,ub,ux,ub,ub,ux,ux,ux,ur,ur,ug
ux,ux,ug,ug,ug,ug,cb,ub,ub,ug,ug,ub,ub,ug,ug,ub,ub,ug,ug,ug,ug,ur,ug
cg,ux,ug,ug,ux,ux,ub,ux,ub,ug,ug,ub,ug,ug,ug,ub,ub,ug,ux,ux,ug,ur,ug
ur,ur,ur,ug,ur,ur,ub,ub,ug,ug,ug,ug,cg,ur,ur,ur,ur,ur,ur,ur,ur,ur,ug
ur,ur,ur,ug,ug,ub,ub,ub,ub,ug,ug,ug,ur,ur,ur,ur,ur,ur,ur,ur,ur,cr,ug
cr,ux,ux,ux,ux,ub,ub,ub,ub,ub,ub,ug,ux,ux,ux,ux,ux,ux,ux,ux,ur,ur,ur
cg,cb,ux,ux,ux,ug,ub,ub,ub,ub,ub,ug,ux,ux,ux,ux,ux,ux,ux,ux,ur,cb,cr
cr,ux,ux,ux,ux,ux,ux,ux,ub,ux,ux,ux,ux,ux,ux,ux,ux,ux,ux,ux,cb,ux,cr