ur,ur,ur,ur,ur,ur,ur,ur,ur,ur,ur,ur,ur,ur,ur,ur,ur,ur,ur,cg,ur,ug,ug
ur,ur,ur,ur,ur,ur,ur,ur,ur,ur,ur,ur,ur,ur,ur,ur,ur,ur,ur,ur,ur,cg,ur
ur,ur,ur,ur,ur,ur,ur,ur,ur,ur,ur,ur,ur,ur,ur,ur,ur,ur,ur,ur,ur,ur,ur
ur,ur,ur,ur,ur,ur,ur,ur,ur,ur,ur,ur,ur,ur,ur,ur,ur,cg,ur,ur,ur,cr,cr
ur,ur,ur,ur,ur,ur,ur,ug,cg,ur,ur,ur,ur,ur,ur,ur,ur,ug,ur,ur,ub,ug,ug
cb,cr,ur,ur,ur,ur,ur,ug,ug,ug,ug,ur,ur,ur,ur,ur,ur,cr,ub,ub,ux,ug,ug
cr,ub,cb,ur,ur,ug,ug,ug,ug,ug,ug,ub,ub,ub,ub,ub,ub,ub,ux,ub,ub,ub,ug
ur,ub,ur,ur,ug,ug,ur,ur,ur,ur,ub,ug,ub,ub,ub,ub,cb,ub,ux,ub,ub,ub,ug
ur,ur,ur,ur,ug,ur,ub,ub,ub,ub,ub,cb,ub,ub,ub,ub,ub,ub,ub,ub,ux,ug,ug
ub,ub,ub,ux,cb,ub,ub,ub,ug,ub,ub,ub,ub,ub,ub,ub,ux,ug,ub,ub,ub,ub,ug
ub,ub,ub,ub,ub,ub,ub,ug,ug,ug,ub,ub,ub,ug,ub,ub,ug,ug,ub,ug,ug,ug,ug
ux,ub,ux,ux,ug,ug,ug,ug,ug,ub,ub,ub,ub,ub,ub,ug,ug,ux,ux,ug,ux,ug,ux
ux,ux,ug,ug,ug,ug,ug,ug,ug,ug,ub,ub,ub,ug,ug,ug,ug,ug,ug,ug,ub,ub,ub
ux,ug,ug,ug,ug,ug,ug,ug,ug,ug,ub,cb,ub,ug,ug,ug,ug,cg,ux,ub,ub,ub,ub
ux,ug,ux,ug,ug,ug,ug,ug,ub,ug,ug,ub,ux,ux,ux,ug,ug,ug,ub,ub,ub,ug,ux
ux,ug,ux,ug,ug,ug,ug,ug,ug,ug,ug,ug,ux,ug,ug,ub,ub,ug,ub,ub,ub,ub,ub
ux,ug,ux,ug,ug,ug,ug,ug,ug,ug,ug,ug,ug,ug,ug,ub,ug,ug,ub,ub,ub,ub,ub
cg,ug,ur,ug,ur,ur,ug,ug,ur,ur,ug,ug,ug,ug,ug,ub,ug,ug,ub,ub,ub,ub,ub
ux,ug,ur,ur,ur,ur,ur,ur,ur,ur,ur,ur,cr,ug,ug,ub,ug,ux,ub,ub,ub,ub,ub
ux,ug,ur,ug,ug,ug,ug,ug,ug,ug,ug,ug,ug,ug,ug,ub,ug,ug,ug,ur,ur,ur,ur
cr,ug,ur,ug,ug,ug,ug,ug,ug,ux,ux,ux,ux,ux,ux,ub,ub,ub,ub,ub,ub,ub,cb
cg,ug,ur,ur,ur,ur,ur,ur,ur,ur,ur,ur,ur,ur,ur,ur,ur,ur,ur,ur,ur,cb,cr
cr,ug,ug,ug,ug,ug,ug,ug,ug,ug,ug,ug,ug,cg,ur,ur,ur,ur,ur,ur,cb,ux,cr