ur,ur,ur,ur,ur,ur,ur,ur,ur,ur,ur,ur,ur,ur,ug,ug,ur,ur,ur,ur,ur,ub,ub
ur,ur,ur,ur,ur,ur,ur,ur,ur,ur,ur,ub,cr,ur,ub,ug,ug,ug,ug,ug,ug,ug,ug
ur,ur,ur,ur,ur,ur,ur,ur,cr,cr,ur,ub,ur,ur,ur,ur,ur,ur,ur,ur,ur,ub,ug
ur,ur,ur,ur,ur,ur,ur,ur,cr,ug,ur,ub,ub,ub,ur,ur,ug,ug,ug,ub,ub,ub,ug
ur,ur,ur,ur,ur,ur,ur,ur,ur,ur,ur,ub,ur,ur,ug,ug,ug,ux,ug,ub,ux,ux,cg
ur,ur,ur,ur,ur,ur,cr,ug,ug,ug,ux,ub,ug,ug,ug,ux,ux,ux,ug,ub,ub,ub,ub
ur,ur,ur,ur,ur,ur,ug,ug,ur,ur,ux,ux,ux,ux,ux,ux,ux,ux,ug,ux,ux,cb,ub
ur,ur,ur,ur,ur,ur,ur,ug,ux,ub,ub,ub,ux,ux,ux,ug,ug,ug,ug,ub,ub,ux,ux
cg,ux,ur,ur,ub,ur,ux,ug,ub,ub,ub,ub,ug,ug,ug,ug,ug,ug,ug,ub,ub,ub,ub
ub,ub,ub,ub,ur,ur,ux,ug,ub,ug,ux,ub,ux,ux,ub,ub,ug,ug,ug,ux,ux,ux,ub
ub,ux,ux,ub,ub,ub,ux,ug,ub,ub,ub,ub,ub,ub,ub,ug,ug,ux,ug,ux,ux,ux,ub
ub,ux,ux,ub,cb,ub,ub,ub,ub,ub,ub,ug,ug,ug,ub,ug,ux,ux,ug,ux,ux,ux,ub
ub,ux,ux,ub,ub,ub,ub,ub,ub,cb,ub,ug,ub,ug,ub,ug,ug,ug,ug,ux,ux,ux,ub
ub,ux,ux,ub,ux,ux,ub,ux,ub,ub,ub,ub,ub,ug,ug,ug,ux,ux,ux,ux,ux,ux,ub
ub,ux,ux,ub,ux,ug,cg,ux,ug,ub,ub,ub,cb,ub,ug,ug,ub,ux,ux,ux,ux,ux,ub
ub,ux,ux,ub,ux,ug,ug,ug,ug,ub,ub,ug,ug,ug,ug,ug,ub,ux,ux,ux,ux,ux,ub
ub,ux,ux,ub,ux,ux,ub,ug,ug,ub,ub,ub,ub,ug,ug,ug,ub,ux,ux,ux,ux,ux,ub
ub,ux,ux,ub,ux,ux,ux,ug,ug,ug,ug,ub,ux,ug,ug,ug,ub,ux,ux,ux,ux,ux,ub
ub,ux,ux,ub,ux,ux,ux,ug,ug,ug,ug,ub,ub,ub,cg,ug,ux,ux,ux,ux,ux,ux,ub
ub,ux,ux,cb,ux,ux,ux,ux,ub,ub,ub,ub,ub,ub,cb,ub,ux,ux,ux,ux,ux,ux,cr
ub,ux,ux,ur,ux,ux,ux,ux,ub,ub,ub,ub,ub,ub,ub,ub,ux,ux,ux,ux,ux,ux,ur
ub,ux,ux,ur,ux,ux,ux,ub,ub,ux,ub,ub,ux,ux,ux,ux,ux,ux,ux,ux,ux,ux,ur
ub,ub,ub,ur,ur,ur,ur,ur,ur,ur,ur,ur,ur,ur,ur,ur,ur,ur,ur,ur,ur,ur,ur