ur,ur,ur,ur,cr,ur,ur,ur,ur,ur,ur,ur,ur,ur,cr,ur,ur,cb,ur,ur,ur,ur,cg
ur,cb,ub,ur,cr,ug,ur,ug,ug,ug,ug,ur,ur,ur,ub,ur,ur,ur,ur,ur,ur,ur,ug
ur,cr,ub,ur,ur,ug,ur,cg,ug,ug,ug,ur,cb,ub,ub,ub,ub,ur,ur,ur,ur,ug,ug
ur,ur,ur,ur,ur,ug,ur,ur,ug,ug,ug,ug,ur,ur,ur,ug,ub,ur,ur,ur,ux,ug,ug
ur,ur,ur,ug,ug,ug,ur,ug,ug,ug,ug,ub,ub,ug,ub,ug,ub,ur,ur,ur,ug,ub,ug
ur,ur,ur,ug,ur,ub,ub,ub,ub,ub,ub,ug,ug,ug,ub,ub,ub,ur,ur,ur,ug,ug,ug
ub,ub,ub,cg,ug,ub,ug,ub,ub,cb,ub,ur,ug,ub,ub,ug,ug,ur,ur,ur,ub,ug,ug
ub,ub,ur,ur,ug,ub,ub,ub,ub,ub,ug,ug,ug,ub,ub,ug,ug,ur,ur,ur,ub,ug,ug
ux,ub,ur,ur,ug,ub,ub,cb,ux,ux,ux,ux,ug,ub,ug,ug,ug,ur,ur,ur,ub,ug,ug
ux,ub,ub,ur,ug,ub,ub,ug,ug,ug,ux,ux,ug,ub,ub,ug,ug,ur,ur,ur,ub,ug,ug
ux,ux,ub,ug,ug,ub,ux,ux,ug,ug,ub,ub,ub,ub,ub,ug,ux,ur,ur,ur,ub,ug,ug
ux,ux,ub,ug,ug,ub,ux,ux,ug,ub,ub,ub,ub,ub,ub,ug,ug,ur,ur,ur,ug,ug,ug
ub,ub,ub,ub,ug,ug,ug,ug,ug,ub,ub,ub,ub,ub,ug,ug,ug,ug,cr,ur,ux,ug,cg
ub,ub,ub,ub,ub,ub,ux,ux,ub,ub,ub,cb,ub,ub,cg,ub,ux,ug,ug,ur,ug,ug,ug
ux,ux,ux,ux,ux,ux,ux,ux,ux,ub,ub,ub,ub,ub,ub,ub,ux,ur,ux,cr,ug,ug,ug
ux,ux,ux,ux,ux,ux,ux,ux,ux,ub,ux,ux,ux,ux,ub,ub,ub,ub,cb,ug,ug,ug,ux
ux,ux,ux,ux,ux,ux,ux,ug,ug,ux,ux,ux,ux,ux,ux,ux,ug,ur,ux,ux,ux,ug,ux
cg,ux,ux,ux,ux,ux,ux,ux,ug,ug,ug,ug,ug,ug,ug,ug,ug,ur,ug,ux,ux,ug,ux
ur,ur,ur,ur,ur,ur,ur,ur,ur,ur,ur,ur,ur,ur,ur,ur,ur,ur,ug,ug,ug,ug,ux
ur,ux,ux,ux,ux,ux,ux,ux,ux,ux,ux,ux,ur,ur,ur,ur,ur,ur,ux,ur,ur,ur,ux
ur,ur,ur,ur,ur,ur,ur,ur,ur,ur,ur,ur,ur,ur,ur,ur,ur,ur,ux,ux,ur,ux,ux
cr,ux,ux,ux,ux,ux,ux,ux,ux,ux,ux,ux,ur,ur,ur,ur,ur,ur,ux,ux,ur,cb,cr
cg,ux,ux,ux,ux,ux,ux,ux,ux,ux,ux,ux,ux,ux,ux,ux,ux,ux,ux,cg,cb,ux,cr