cb,cb,cb,cr,ur,ur,ur,ur,cr,ug,ug,ur,ur,ur,ur,ur,ur,ur,ur,ub,ub,ux,cb
ur,ur,ur,ur,ur,ur,cr,ur,ur,ur,ug,ur,ur,ur,ur,ur,ur,ur,ur,ub,ub,ur,ur
ur,ug,ub,cb,ur,ur,ug,ur,ug,ur,ur,ur,ub,ub,ub,ub,ub,ub,ub,ub,ub,ur,ur
cr,cg,ub,ub,cr,ub,ug,ur,ug,cr,ur,ur,ur,ur,ur,ur,ur,ur,ur,ub,ub,ub,ub
ug,ug,ub,ug,cb,ub,ub,ub,ug,ur,ub,cb,ur,ur,ur,ur,ur,ug,ug,ug,ug,ug,ub
ux,ub,ug,ug,ub,ug,ur,ub,ug,cg,ub,ub,ug,ug,ug,ug,ug,ur,ur,ur,ur,ub,ub
ux,ub,ug,ug,ub,ub,ub,ub,ub,ug,ub,ub,ug,ug,ug,ug,ug,ug,ur,ur,ug,ub,ur
cb,ug,ug,ub,ug,ug,ub,ub,ub,ub,ub,ux,ux,ub,ub,ux,ur,ug,ux,ux,ug,ub,ub
ub,ug,ub,ub,ub,ub,ub,cg,ug,ug,ug,ug,ug,ug,ug,ug,ug,ug,ux,ux,cb,ub,ub
ug,ug,cg,ux,ug,ug,ub,ub,ub,ub,ub,ub,ub,ub,ub,ub,ub,ur,ux,ux,ug,ur,ur
ug,ug,ug,ub,ug,ub,ub,ub,ux,ub,ub,ug,ug,ux,ux,ug,ug,ug,ux,ux,ug,ur,ur
ug,ug,ug,ux,ug,ux,ub,ux,ux,ub,ug,cg,ug,ub,ug,ug,ur,ug,ux,ux,ug,ur,ur
cb,ug,ug,ub,ug,ub,ub,ug,ug,ug,ug,ub,ug,ug,ug,ug,ur,ug,ux,ux,ug,ur,ur
ug,ug,ug,ub,ug,ug,ub,ug,ug,ug,cb,ub,ub,ub,ub,ug,ug,ug,ux,ux,ug,ur,ur
ug,ug,ug,ug,ug,ub,ub,ug,ug,ug,ug,ug,ug,ug,ug,ug,ur,ur,ux,ux,ug,ur,ur
ux,ug,ux,ux,ux,ux,ux,ux,ug,ug,ux,ug,ub,ub,ub,ub,ub,ur,ub,ub,ug,ur,ur
ux,ug,ux,ux,ux,ux,ux,ux,ux,ug,ug,ug,ug,ux,ux,ux,ur,ur,ux,ux,cr,ur,ur
cr,ug,ux,ux,ux,ux,ux,ux,ux,ux,ug,ux,ug,ux,ux,ux,ur,ur,ux,ux,ur,ur,ur
cg,ug,ux,ux,ux,ux,ux,ux,ux,ux,ug,ug,ug,ux,ux,ux,ur,ur,ux,ux,ur,ur,ur
cb,ug,ux,ux,ux,ux,ux,ux,ux,ux,ux,ux,ux,ux,ux,ux,ur,ur,ur,ur,ur,ur,ur
ux,ug,ug,ug,ug,ug,ug,ug,ug,ug,ug,ug,ug,ug,ug,ug,ug,ug,ur,ur,ur,ur,cr
cr,ux,ux,ux,ux,ux,ux,ux,ux,ux,ux,ux,ux,ux,ux,ux,ux,cb,cg,ux,cb,ur,cr
cg,cb,cg,cb,ux,ux,ux,ux,ux,ux,ux,ux,ux,ux,ux,cg,ux,ux,ux,cg,cg,ur,cr