ur,cr,cb,ux,ux,ux,ux,ux,ux,cr,ux,ux,ux,ux,ux,ux,ux,ux,ux,cg,ux,ux,ux
cb,ub,ux,ux,ux,ux,ux,ux,ux,ur,ux,ur,ur,ur,ur,ur,ur,ux,ux,ux,ux,ux,cb
ub,ux,ur,ur,ur,ux,ux,ux,ux,ur,ux,ur,ur,ux,ux,ur,ur,ux,ux,ux,ux,ux,ub
ub,ux,ur,ux,ur,ux,ux,ur,ux,ur,ux,ur,ur,ur,ur,ur,ux,ux,ux,ux,ux,ux,ub
ub,ub,ur,ur,ur,ur,ur,ur,ug,ur,ur,ur,ur,ur,ur,ur,ur,ur,ur,ux,ux,ux,ub
ub,ub,ur,ur,ur,ur,ur,ur,ug,ur,ur,ur,ur,ur,ug,ur,ur,ur,ur,ux,ux,ux,ub
ur,ur,ur,ur,ur,cg,ur,ur,ug,ur,ur,ur,ur,ur,ug,ur,ur,ur,ur,ur,ur,ur,ub
ur,ur,ur,ur,ur,ug,ug,ur,ug,ug,ug,cb,ub,ug,ug,ug,ug,ur,ur,ur,ur,cr,ub
ur,ur,ur,ur,ur,ur,ug,ur,ur,ur,ur,ub,ub,ug,ug,ur,cg,ur,ug,ug,ur,ur,ub
ur,ur,ur,ur,ur,ur,ug,ur,ur,ug,ug,ur,ug,ur,cg,ub,ub,ur,ug,ur,ur,ur,ub
ur,ur,ur,ur,ur,ur,ug,ug,ug,ug,cr,ur,ug,ug,ug,ur,ug,ug,ug,ur,ur,ux,ub
ur,ur,ur,ur,cb,ub,ug,ug,ur,ur,ur,ur,ur,ur,ug,ug,ug,ug,ug,ur,ur,ux,ub
cg,ur,ur,ur,ur,ub,ur,ur,ur,ur,ur,ur,ur,ur,ug,ux,ux,ux,ug,ur,ur,ux,ub
ur,ur,ur,ur,ur,cr,ur,ur,ur,ur,ur,ux,ug,ub,ub,ux,ux,ug,ug,ur,ur,ug,ub
ur,ur,ur,ub,ug,ug,ug,ur,ur,ur,ur,ub,ug,ug,ug,ug,ug,ug,ub,ub,ur,ug,ub
ur,ur,ur,ub,ug,ub,ug,ub,ub,ug,ug,ub,ub,ub,ux,ux,ug,ug,ug,ug,ug,ug,ub
ur,ur,ur,ur,cg,ub,ug,ug,ug,ur,ur,ur,ur,ur,ur,ur,ur,ur,ur,ur,ur,ur,ub
cg,ub,ub,ur,ub,ub,ub,ub,cb,ub,ub,cb,ux,ux,ux,ub,ub,ub,ub,ub,ub,ub,ub
ub,ub,ub,ur,ux,ub,ub,ub,ub,ub,ub,ub,ub,ux,ux,ub,ux,ub,ub,ub,ur,ub,ur
ub,ub,ub,ur,ux,ub,ub,ub,ug,ug,ub,ub,ug,ug,ug,ub,ux,ub,ub,ub,ur,ub,ur
cr,ub,ug,ur,ux,ub,ub,ux,ug,ug,ug,ub,ub,ub,ug,ug,ug,ug,ug,ur,ur,ur,ur
cg,ub,ug,ur,ux,ub,ub,ux,ub,ub,ub,ub,ug,ug,ub,ug,ub,ug,ug,ur,ur,cb,cr
cr,ub,ub,ur,ur,ur,cr,ug,ub,ub,ug,ug,ug,ub,ub,ug,ug,ug,ur,ur,cb,ux,cr