cr,ur,ur,ur,ur,ur,ur,ur,ur,ur,ur,ur,ur,ur,ur,ur,ur,ur,ur,cg,ur,ur,ur
ub,ub,ub,ub,ur,ur,ur,ur,ur,ur,ur,ur,ur,ur,ur,ur,ur,ur,ur,ur,ur,ur,ur
ub,ub,ub,ub,ug,ug,ug,ug,ur,ur,ur,ur,ur,ur,ur,ur,ur,ug,ug,ur,ux,ux,ur
ur,ur,ub,ub,ur,ug,cg,cr,ur,ug,ur,ug,ug,ug,ug,ur,ur,ux,ug,ux,ux,ux,cr
ur,cr,ur,ub,cb,ur,ub,ub,ur,ur,ur,ug,ux,ur,ug,cr,ug,ug,ug,ux,ux,ux,ux
ub,ub,ur,ub,ur,ub,ub,ub,ub,ur,ug,ug,ub,ub,cg,ux,ux,ux,ux,ux,ux,ux,ux
ub,ub,ur,ur,ur,ug,ub,ub,ub,ur,ub,ub,ub,ub,ub,ux,ux,ux,ux,ux,ux,ux,ux
ub,ub,ub,ug,ug,ug,ub,ug,ug,ub,ub,ub,ub,ub,ub,ug,ug,ug,ux,ux,ux,ux,ux
ub,ub,ug,ug,ug,ug,ub,ug,ug,ug,ub,ug,ub,ub,ub,ug,ux,ux,ux,ux,ux,ux,ux
ub,ub,ub,ug,ub,ub,ub,ug,ub,ug,ub,ub,ub,cb,ub,ux,ux,ux,ux,ux,ux,ux,ux
ub,ub,ub,ub,ub,ur,ub,ux,ub,ub,ub,ub,ub,ub,ub,ug,ug,ug,ug,ug,ug,ug,ux
ub,ub,ub,ub,ur,ur,cb,ug,ub,ub,ub,ub,ub,ub,ub,ux,ux,ux,ux,ux,ux,ug,ux
ux,ub,ub,ug,ux,cg,ug,ug,ux,ug,ug,ub,cb,ub,ub,ux,ux,ux,ux,ux,ux,ug,ux
ux,ub,ux,ug,ux,ux,ux,ug,ug,ug,ug,ug,ub,ub,ub,ux,ux,ux,ux,ux,ux,ug,ux
ub,ub,ux,ug,ub,ux,ug,ug,ug,ug,ux,ug,ub,ub,ub,ux,ux,ux,ux,ug,ug,ug,ux
ub,ub,ux,ug,ug,ug,ug,ux,ux,ux,ux,ug,ub,ub,ub,ub,ub,ub,ug,ug,ux,ux,ux
ub,ub,ux,ug,ug,ug,ug,ug,ug,ug,ux,ug,ug,ub,ub,ub,ug,ub,ug,ux,ub,ub,ub
cg,ub,ux,ug,ug,ug,ug,ug,ux,ug,ug,ug,cb,ub,ub,ug,ug,ub,ug,ug,ub,ub,ub
ur,ur,ur,ur,ur,ur,ur,ur,ur,ur,ug,ug,ug,cr,ur,ur,ur,ub,ub,ub,ub,ub,ub
ur,ur,ur,ur,ur,ur,ur,ur,ur,ur,ug,ug,ug,ub,ub,ug,ug,cb,ub,ub,ub,ur,ur
cr,ur,ur,ur,ux,ux,ux,ux,ux,ux,ux,ux,ug,ux,ug,ug,ux,ux,ux,ux,cb,ur,ur
cg,ur,ux,ux,ux,ux,ux,ux,ux,ux,cg,ug,ug,ux,ug,ux,ux,ux,ux,ur,ur,cb,cr
cr,ur,ur,ur,ur,ur,ur,ur,ur,ur,ur,ur,ur,ur,cg,ur,ur,ur,ur,ur,cb,ux,cr