ur,ur,ur,ur,ur,ur,ur,ur,ur,ur,ur,ur,ur,ur,ur,ub,ub,ub,ub,ub,ur,ur,ur
ux,ur,ur,ur,ur,ur,ur,ur,ur,ur,ur,ur,ur,ur,ur,ur,ur,ur,ur,ub,ur,ur,ur
ux,ur,ur,ur,ur,ur,ur,ur,ur,ur,ur,ur,ur,ur,ur,ur,ur,ur,ur,ub,ux,ux,ux
ur,ur,ur,cr,ur,ur,ur,ur,ur,ur,ux,ur,ur,ur,ur,ur,cr,ur,ur,ub,ux,ux,cb
ur,ur,ur,ur,cr,cr,ur,ur,ur,ur,ux,ux,ur,ur,ub,ub,ub,ur,ur,ub,ux,ux,ux
ur,ub,ur,ur,cr,ur,ur,ug,ur,ur,ug,ug,ug,ur,ub,ug,ug,cg,ux,ub,ub,ux,ux
ur,ub,ur,ub,ub,ub,ug,ug,ub,ur,ug,ur,ug,ur,ub,ug,ug,ug,ux,ur,ub,ux,ux
ur,ub,ur,ub,ug,ug,ug,ux,ub,ur,ug,ur,ug,cg,ug,ug,ug,ug,ux,ux,ub,ux,ux
cg,ub,ur,cb,ur,ug,ug,ux,ub,ur,ug,ug,ug,ug,ug,ug,ug,ug,ur,ur,ub,ur,ur
ub,ub,ur,ur,ur,ur,ur,ux,ub,ur,ub,ug,ug,ug,ug,ug,ug,ug,ur,ur,ub,ur,ur
ub,ub,ur,ur,ur,ur,ub,ub,ub,ur,ur,ug,ug,ug,ug,ug,ug,ug,ug,ur,ub,ur,ur
ub,ub,ub,ur,ur,ur,ub,ur,ug,ur,ur,ug,ug,ug,ug,ug,ug,ug,ug,ur,ub,ur,ur
ub,ur,ub,ub,ur,ug,ug,ug,ug,ub,ur,ug,ug,ug,ug,ug,ur,ur,ur,ur,ub,ur,ur
ub,ub,ux,ub,ub,ug,ux,ub,ub,ub,ur,ug,ug,ug,ug,ur,cb,ur,ur,ur,ub,ub,cb
cg,ub,ux,ub,ug,ug,ub,ux,ux,ub,ur,ug,ug,ug,ug,ur,ub,ug,ug,ur,ur,ur,ur
ub,ub,ux,ub,ug,ux,ub,ux,ub,ub,ur,ug,ug,ug,ub,ur,ub,ub,ug,ur,ur,ur,ur
ub,ub,ug,ub,ug,ux,ux,ux,ux,ux,ug,ug,ub,ub,ub,ub,ub,ub,ur,ur,ur,ur,ur
ub,ub,ub,ub,ux,ux,ux,ux,ux,ux,ug,ux,ub,ub,ub,ub,ub,ub,ur,ur,ur,ur,ur
ub,ub,ug,ub,ub,ux,ux,ux,ux,ux,ug,ug,ub,ub,ub,ur,ug,ub,ur,cg,ur,ur,ur
ub,ub,ug,ux,ub,ux,ux,ux,ux,ux,ur,ug,ug,ug,ug,ug,ug,ub,cb,ug,ur,ur,ur
ub,ux,ub,ug,ub,ug,ug,ug,ug,ug,ur,ux,ux,ub,ub,ug,ug,ug,ug,ug,ur,ur,ur
ub,ub,ub,cb,ub,ub,ub,ub,ub,ub,cr,ur,ur,ur,ur,ur,ug,ub,ur,ur,ur,ur,cb
ux,ux,ux,ub,ux,ux,ux,ux,ux,cg,ur,ur,ur,ur,ur,ur,ur,ur,ur,ur,ur,ur,ur