ur,ur,ur,ur,ur,ur,ur,ur,ur,ur,ur,ur,ur,ur,ux,ux,ux,cb,ux,ux,ux,ux,ux
ur,ur,ur,ur,ur,ur,cr,ux,ux,ux,ur,ur,ur,ur,ux,ux,ux,ux,ux,ux,ux,ux,ux
ur,ur,ur,ur,ur,ur,ur,ur,ur,ur,ur,ur,ur,ur,ux,ux,ux,ux,ux,ux,ux,ux,ux
ur,ur,ur,ur,ur,ur,ur,ur,ur,ur,ur,cr,ux,ur,ug,ug,ug,ug,ug,ux,ux,ur,ur
cb,ur,ur,ur,ur,ur,ur,ur,ur,ur,ur,ur,ur,ur,ux,ux,ux,ux,ug,ux,ur,ur,ur
ur,ur,ur,ur,ur,ur,ur,ur,ur,ur,ur,ur,ug,ug,ug,ug,ug,ug,ug,ur,ur,ur,ur
ur,ur,ur,ur,cg,ur,ur,cg,ur,ur,ur,ur,ug,ug,ug,ug,ug,ug,ug,ux,ux,ur,ur
ur,ur,ur,ur,ug,cg,ur,cr,ug,ug,ur,ur,ug,ug,ug,ug,ug,ug,ug,ur,ur,ur,ur
ur,ur,ur,ur,ug,ug,ur,ur,ug,ug,ur,ug,ur,ur,ur,ur,ug,ug,ur,ur,ur,ur,ur
ur,ur,ur,ur,cr,ug,ur,ug,ug,ug,ug,ug,ug,ur,ub,ug,ug,ug,ur,ur,ux,ux,ux
ur,ur,ur,ur,ur,ug,ug,ug,ug,ug,ur,ub,ug,ub,ub,ur,ur,ub,ub,ux,ux,ux,ux
ur,ur,ur,ur,ur,ug,ur,cr,ug,ux,ur,ub,ub,ub,ub,ub,ub,ub,ub,ub,ux,ux,ux
ur,ur,ur,ur,ur,ur,ug,ur,ug,ux,ub,ub,ub,cb,ub,ub,ub,ub,ub,ub,ux,ux,cg
ur,ur,ur,ur,ur,ur,ug,ur,ug,ug,ug,ug,ug,ub,ub,ub,ub,ug,ug,ux,ux,ux,ug
ur,ur,ur,ur,ur,ur,ur,ur,ug,ug,ug,ug,ug,ub,cb,ub,ub,ub,ug,ub,ug,ug,ug
ub,ux,ux,ux,ug,ux,ux,ux,ux,ux,ux,ux,ux,ub,ub,ug,ug,ub,ub,ub,ux,ug,ug
ub,ub,ub,ub,ug,ug,ug,ug,ug,ub,ug,ug,ug,ug,ug,ug,ub,ub,ub,ub,ub,ub,ub
cg,ux,ux,ux,ux,ux,ux,ux,ux,ug,ug,ux,ub,ub,ub,ug,ug,ug,ug,ug,cb,ub,ub
ur,cr,ug,ug,ug,ug,ug,ug,ug,ug,ub,ub,ub,ub,ub,ub,ub,ub,ub,ub,ub,ub,ub
ur,ur,ur,cb,ub,ub,ub,ub,ub,ub,ub,ub,ub,ug,cg,ub,ub,ub,ub,ub,ub,ub,ub
ur,ur,ug,ub,ub,ub,ub,ub,ub,ub,ub,ub,ug,ug,ub,ug,ug,ub,ub,ub,ub,ub,ub
cr,ux,ug,ub,ub,ub,ub,ub,ug,ug,ug,ug,ug,ub,ub,ub,ub,ub,ux,ux,ux,cb,cr
cg,ux,ug,ug,ug,ug,ug,ug,ug,ux,ub,ub,ux,cb,ub,ub,ub,ub,ux,cg,cb,ux,cr