ur,cb,cb,cr,ur,ur,ur,ur,ur,ug,cg,ur,ur,ur,ur,ur,ur,ur,ur,ur,ur,ur,cb
ur,cb,cb,ur,ur,ur,ur,cr,ur,ug,ur,ur,ur,ur,ur,ur,ur,ur,ur,ur,ur,ug,ug
ur,ur,ur,ug,ug,ug,ug,ur,ug,ug,ur,cb,ur,ug,ug,ur,cr,ub,ub,ub,ub,ub,ug
ur,ur,ur,ug,ur,ur,ur,ur,ur,ur,ug,ub,ug,ug,ug,ug,ub,ub,ub,ub,ur,ub,ug
ur,ug,cr,ur,ur,ug,ug,ug,ur,ur,ug,ub,ur,ur,ub,ug,ug,ub,ub,ub,ub,ub,ug
ur,ur,ur,ug,ug,ug,ub,ug,cr,ur,ug,ub,ug,ub,ub,ug,ug,ub,ux,ub,ub,ux,ug
ug,ug,ug,ur,ur,ug,ug,ug,ux,ur,ug,cb,ub,ub,ub,cg,ug,ub,cg,ub,ub,ux,ug
cb,ur,ur,cr,ur,ub,ub,ub,ug,ug,ug,ug,ux,ug,ug,ub,ub,ub,ug,ub,ub,ux,ug
ur,ur,ur,ur,ur,ur,ub,ub,ug,ux,ub,cg,ux,ug,ug,ub,ub,ug,ug,ub,ub,ux,ug
ur,ug,ug,ug,ub,ub,ub,ub,ub,ub,ub,ub,ub,ub,ug,ub,ug,ug,ug,ub,ub,ux,ug
ur,ux,ux,ux,ux,ur,ux,ux,ux,cb,ub,ub,ug,ug,ug,ub,ux,ug,ug,ub,ub,ux,ug
ur,ur,ur,ur,ur,ur,ug,ur,ur,ur,ug,ug,ug,ug,ug,ub,ug,ug,ug,ub,ug,ug,ug
cb,ux,ux,ux,ux,ur,ug,ux,ux,ux,ug,ug,ug,ug,ug,ub,ub,ub,ug,ux,ux,ux,cg
ub,ub,ub,ub,ub,ur,ug,ub,ub,ub,ug,ug,ug,ug,ug,ug,ug,ug,ug,ug,ug,ug,ug
ux,ux,ux,ux,ux,ur,ug,ug,ug,ux,ug,ug,ug,ub,ux,ux,ux,ux,ux,ug,ux,ux,ug
ux,ux,ux,ux,ux,ur,ug,ug,ug,ug,ug,ug,ug,ug,ug,ug,ug,ug,ux,ug,ug,ug,ug
ux,ux,ux,ux,ug,ur,ub,ub,ug,ug,ug,ug,ug,ug,ub,ub,ub,ug,ug,ug,ug,ug,cb
ux,ux,ux,ux,ub,ur,ug,ug,ug,ux,ux,ux,ux,ug,ug,ug,ug,ug,ug,ug,ug,ug,ux
ux,ux,ux,ub,ub,ur,ug,ug,ug,ug,ux,ux,ux,ug,ug,ug,ug,ug,ug,ug,ug,ug,ux
ux,ub,ub,ub,ub,ub,ub,cb,ux,ug,ug,ug,ug,ug,ug,ug,ug,ug,ug,ug,ug,ug,ux
cr,ub,ub,ub,ub,ux,ur,ug,ux,ux,ux,ux,ux,ux,ux,ux,ux,ux,ux,ux,ux,ux,cr
cg,ub,ub,ub,ub,ux,ur,cg,ux,ux,ux,ux,ux,ux,ux,ux,ux,ux,ux,cb,cb,ux,cr
cr,cg,cg,cb,ub,ub,cr,ux,ux,ux,ux,ux,ux,ux,ux,cg,ux,ux,ux,cg,cg,ux,cr