cb,cb,cb,cr,ur,ur,ur,ur,ur,ur,ur,ur,ur,cr,ug,ur,ur,ur,ur,ur,ur,ur,cb
ur,ur,ur,ur,ur,ur,ur,ur,ur,ur,ur,cr,ub,ur,cg,ur,ur,ur,ur,ur,ur,ur,ur
ur,ur,ur,ur,ur,ur,ur,ur,ur,ur,ur,ur,ub,cb,ur,ur,cr,ug,ur,ur,ur,ur,ur
ur,ur,ur,ur,ur,ux,ur,ur,ur,ur,ux,ur,cg,ug,ug,ur,ur,ug,ur,ur,ur,ur,ur
ur,ur,ur,ur,ur,ur,ur,ur,ur,ur,ub,ub,ub,ub,ug,ug,ug,ug,ur,ur,ur,ur,ur
ub,ub,ub,ub,ur,ur,ur,ub,cb,ug,ub,ug,ug,ug,ug,ug,cg,ub,ur,ub,cr,ur,ur
ub,ub,ub,ub,ub,ub,cr,ub,ur,ur,ub,ur,ur,ug,ug,ug,ug,ub,ug,ug,ug,ug,ub
cb,ub,ub,ub,ub,ub,ur,ux,ub,ug,ub,ug,ug,ug,ur,ug,ug,ub,ub,ur,ur,ub,ub
ub,ub,ub,ub,ux,ug,ug,ux,ub,ug,cb,ug,ug,ug,ur,ux,ug,ug,ub,ub,ub,ub,ux
ub,ux,ux,ub,ux,ug,ug,ug,ug,ug,ug,ug,ub,ug,ur,ur,ug,ug,ur,ur,ur,ug,ur
ub,ub,ub,ug,ug,ug,ug,ug,ug,ug,ug,ug,ug,ug,ug,ug,ur,ur,ur,ur,ur,ug,ur
ub,cb,ub,ug,ug,ug,ug,ug,ug,ug,ug,ug,ug,ug,ub,ub,ub,ug,ug,ug,ug,ug,ux
cb,ub,ug,ug,ug,ug,ug,ug,ub,ug,ug,ug,ug,ug,ub,ub,cb,ub,ux,ux,ux,ug,ug
ux,ug,ug,ug,ug,ug,ug,ug,ug,ug,ug,ug,ug,ug,ub,ug,ub,ux,ux,ux,ux,ux,ug
ux,ug,ug,ug,ug,cg,ug,ug,ug,ug,ug,ug,ug,ug,cg,ug,ub,ux,ux,ux,ux,ug,ug
ux,ug,ug,ug,ug,ug,ug,ug,ug,ux,ug,ux,ug,ug,ub,ub,ux,ux,ux,ux,ux,ug,ux
ux,ug,ug,ub,ug,ux,ug,ug,ug,ux,ug,ug,ug,ug,ub,ub,ux,ux,ux,ux,ux,ug,ux
cr,ug,ux,ux,ug,ub,ug,ug,ug,ux,ur,ux,ug,ub,ug,ux,ux,ux,ux,ux,ux,ug,ux
cg,ug,ug,ug,ug,ug,ug,ug,ug,ux,ur,ux,ug,ug,ug,ux,ux,ux,ux,ux,ug,ug,ux
cb,ug,ug,ug,ug,ux,ug,ug,ub,ux,ur,ux,ur,ub,ub,ux,ux,ux,ux,ux,ux,ux,ux
ux,ug,ug,ux,ux,ux,ug,ug,ub,ux,ur,ux,ub,ub,ub,ux,ux,ux,ux,ux,ux,ux,cr
cr,ug,ug,ux,ux,ux,ub,ub,ub,ux,ur,ur,ur,ur,ur,ur,ur,cb,cg,ux,cb,ux,cr
cg,cb,cg,cb,ux,ux,ub,ub,ux,ux,ux,ur,ur,ur,ur,cg,ur,cr,ur,cg,cg,ux,cr