ur,ur,ur,ur,ur,ur,ur,ur,ur,cg,ur,ur,ur,cg,ur,ur,ur,cb,ur,ur,ur,ur,ur
ur,ur,ur,cr,ur,ur,ug,ur,ur,ur,ur,ur,ur,ug,ur,ur,ur,ur,ug,ug,ug,ug,ur
ur,ur,cr,ub,ur,ur,ur,ur,ur,ur,ur,ur,ur,ug,ur,ur,ur,ur,ug,cb,ur,ug,ur
ub,ub,ur,ur,ur,ub,cr,ur,ur,ub,ur,ub,ur,cr,ur,ug,ug,ug,ug,ub,ur,ug,ux
ur,ub,ub,ub,ur,ug,cb,ub,ub,ur,ur,ur,ur,ur,ur,ug,ur,ur,ux,ub,ux,ug,ux
ur,ur,ub,ur,ub,ug,ub,ub,ub,ur,ub,ub,ub,ub,ux,ug,ug,ug,ug,ub,cb,ug,ux
ur,ur,ub,ub,ub,ug,cg,ub,ub,ub,ub,ub,ub,ug,ug,ug,ug,ug,ug,ub,ub,ug,ux
ur,ur,ub,ub,ub,ux,ub,ub,ub,ub,ub,ug,ug,ub,ux,ug,ug,ug,ug,ub,ub,ug,ux
ur,ur,ux,ug,ug,ug,ug,ug,ub,ub,ub,ug,ug,ug,ug,ug,ub,ub,ub,ub,ub,ug,ux
ur,ur,ur,ug,ur,ur,ur,ux,ub,ub,ug,ug,ug,ug,ub,ug,ub,ub,ub,ub,ub,ug,ux
ur,ur,ur,ug,cr,ur,ux,ux,ub,ub,ub,ug,ug,ug,ub,ug,ux,ug,ug,ug,ux,ug,ux
ur,ur,ur,ur,ur,ub,ub,ub,ub,ub,ub,ug,ug,ug,ug,ug,ux,ub,cb,ub,ub,ug,ux
ur,ur,ur,ug,ur,ub,ub,ub,ub,ub,ub,ub,ub,ub,cg,ux,ub,ub,ux,ub,ub,ub,cg
ux,ux,ux,ug,ug,ug,ug,ub,ub,ur,ur,ub,ub,ub,ug,ug,cg,ub,ur,ub,ur,ug,ur
ux,ux,ub,ub,ub,ug,ug,cb,ub,ug,ub,ub,ub,ub,ug,ub,ug,ug,ug,ug,ug,ug,ur
ux,ub,ub,ub,ub,ug,ug,ug,ug,ug,ub,ub,ub,ub,ug,ub,ub,ub,ux,ux,ur,ur,ur
ux,ux,ug,ux,ux,ug,ug,ub,ug,ug,ux,ug,ug,ug,ug,ug,ub,ux,ux,ux,ur,ur,ur
cg,ur,ur,ur,ur,ur,ur,ur,ur,ur,ug,ug,ug,ug,ug,ur,ur,ur,ur,ur,ur,ux,ur
ub,ur,ug,ux,ux,ug,ug,ux,ug,ug,ug,ug,ux,ux,ux,ug,ug,ux,ux,ux,ur,ux,ur
ub,cr,ug,ub,ug,ur,ug,ug,ug,ug,ub,ub,ug,ug,ug,ug,ug,ux,ux,ux,ur,ux,ur
ub,ub,ub,ub,ub,ur,ux,ux,ub,ub,ub,ux,ux,ux,ux,ux,ug,ux,ux,ux,ur,ux,ux
cr,ug,ub,ub,ub,ur,ug,ub,ub,ub,ug,ug,ug,ug,ug,ug,ug,ux,ux,ux,ur,ux,cb
cg,ug,ug,ug,ub,ub,ub,cb,ub,ub,ur,ur,ur,ur,ur,ur,ur,ur,ur,ur,ur,ur,ur