ub,ub,ub,ub,ub,ub,ub,ub,ub,ub,ub,ur,ur,ur,ur,ur,ur,cb,ur,ur,ur,ur,ur
ub,ub,ub,ub,ur,ur,ur,ur,ur,ur,ub,ub,ub,ub,ur,ur,ur,ur,ur,ur,ur,ur,ur
ub,ub,ub,cr,ur,ur,ur,ug,ug,ug,ug,ug,ug,cr,ur,ur,cb,ug,ur,ur,cr,ur,ur
ub,ub,ub,ub,cr,ub,ur,ug,ug,ur,ur,ug,ug,ug,ug,ug,ub,ub,ub,ub,ur,ub,ur
ur,ur,ub,cb,ur,ur,ur,ur,ug,ug,ur,ug,ug,ug,cg,ub,ub,ub,ub,ub,ur,ur,ur
ur,cb,ub,ur,ur,ur,ur,ug,ug,ug,ug,ur,ug,ug,ug,ug,ub,ub,ug,ub,ub,ub,ux
ur,ur,ur,ur,ur,ur,ur,ur,ur,ug,ug,ug,ug,ug,ub,ug,cb,ub,ug,ub,ub,ub,ux
ur,ux,ur,ur,ub,ur,ur,ur,cg,ug,ur,ug,ug,ug,ub,ug,ub,ub,ug,ub,ub,ux,ux
ur,ur,ur,cr,ur,ur,ux,ur,ux,ur,ub,ug,ug,ug,ub,ug,ub,ug,ug,ub,ux,ux,ux
ug,ur,ur,ug,ug,ux,ux,ur,ur,ur,ub,ub,ug,ub,ug,cg,ug,ug,ur,ub,ux,ux,ux
ub,ux,ux,ug,ug,ug,ug,ug,ug,ug,ug,ug,ug,ub,ug,ug,ub,ub,ur,ub,ux,ux,ux
ub,ub,ux,ug,ux,ux,ux,ux,ux,ug,ub,ub,ug,ug,ug,ug,ub,ub,ur,ub,ux,ux,ux
ub,ub,ux,ug,ux,ux,ux,ux,ug,ug,ub,ub,ub,ub,ug,ux,ub,ub,ur,ub,ux,ux,cg
ub,ub,ux,ug,ux,ux,ux,ux,cb,ug,ug,ub,ug,ur,cg,ub,ug,ub,ur,ub,ux,ux,ux
ub,ub,ux,ug,ux,ux,ux,ux,ub,ub,ug,ub,ug,ug,ug,ub,ug,ub,ur,ub,ux,ux,ux
ub,ub,ux,ug,ux,ux,ux,ux,ux,ub,ub,ub,ux,ur,ug,ub,ug,ux,ur,ux,ux,ux,ux
cb,ub,ux,ug,ux,ux,ux,ux,ux,ug,ug,ug,ug,ur,ug,ub,ug,ux,ur,ux,ux,ux,ux
cg,ub,ux,ug,ux,ux,ux,ux,ux,ug,ug,ug,ug,ug,ug,ux,ug,ux,ur,ux,ux,ux,ux
ux,ub,ux,ug,ux,ux,ux,ux,ux,ux,ux,ux,ux,ur,ux,ux,ug,ux,ur,ux,ux,ux,ux
ux,ub,ux,ug,ux,ux,ux,ux,ux,ux,ux,ux,ux,ur,ux,ux,ug,ux,ur,ux,ux,ux,ux
ux,cr,ux,ug,ux,ux,ux,ux,ux,ux,ux,ux,ux,ur,ux,ux,ug,ux,ur,ux,ux,ux,ux
cr,ur,ux,ug,ux,ux,ux,ux,ux,ux,ux,ux,ux,ur,ux,ux,ug,ux,ur,ux,ux,cb,cr
cg,ur,ur,ur,ur,ur,ur,ur,ur,ur,ur,ur,ur,ur,ur,ur,ur,ur,ur,cg,cb,ux,cr