ur,ur,ux,cr,ur,ux,ur,ur,ur,ur,ur,ur,ur,ur,ur,ur,ur,cb,ur,ur,ur,ur,ur
ur,ur,ur,ux,ub,ub,cr,ur,ur,ur,ur,ub,ub,ub,ub,ug,ur,ur,ur,ur,ur,ur,ur
ur,ur,ur,ur,cb,ub,ur,ug,ur,ur,ur,ub,ur,ug,cr,cr,ur,ur,ub,ub,ub,ub,ur
ur,ur,ur,ur,ug,ub,ur,ur,ur,ur,ub,ub,ug,ub,ub,ub,ug,ur,ub,ur,ub,ur,ur
ur,ur,ur,ur,ug,ug,cg,ub,ub,ub,ub,ub,ug,ug,ug,ub,ug,ur,ur,ur,ub,ux,ug
ur,ur,ur,ug,ug,ur,ug,ur,ug,ug,ug,ug,ub,ub,ug,ux,ux,ub,cg,ug,ub,ux,ug
ur,ur,ur,ur,ug,ug,ur,ug,ug,ug,ub,ub,ub,ub,ug,ug,ux,ug,ug,ug,ub,ux,ug
ur,ur,ur,ux,ug,ug,ug,ug,ux,ug,ug,ug,ug,ug,ug,ub,ub,ug,cb,ub,ub,ub,ug
ur,ur,ur,ur,cr,ux,ug,ub,ub,ub,ub,cg,ug,ug,ug,ub,ug,ug,ug,ug,ug,ug,ug
ux,ux,ug,ux,ug,ux,ub,ub,ub,ub,ub,ug,ug,ug,ub,ug,ug,ub,ug,ug,ug,ux,ux
ux,ux,ug,ux,ug,ux,ug,ug,ug,cb,ub,ug,ub,ub,ub,ub,cb,ub,ub,ub,ux,ux,ux
ub,ux,ug,ug,ug,ux,ux,ux,ux,ux,ub,ug,ug,ug,ub,ug,ug,ub,ub,ub,ub,ub,ub
ub,ub,ux,ux,ux,ux,ux,ux,ux,ux,ux,ub,ub,ug,ug,ug,ug,ug,ug,ub,ub,ux,ub
ux,ub,ub,ub,ub,ub,ub,ub,ux,ux,ux,ux,ux,ug,ug,ug,ug,ug,ux,ux,ub,ux,ub
cg,ug,ug,ub,ub,ug,ug,ub,ub,ub,ug,ug,ux,ux,ux,ug,ug,ux,ux,ux,ub,ub,ub
ur,ur,ur,ur,ur,ur,ur,ub,ub,ub,ur,ur,ur,ur,ur,ug,ug,ug,ug,ug,ub,ur,ur
ur,ux,ux,ux,ux,ux,ux,ux,ux,ub,ub,ub,cb,ug,ug,ug,ug,ug,ug,ug,ug,ub,ur
ur,ur,ur,ur,ur,ur,ur,ur,ur,ur,ur,ur,ur,ug,ug,ug,ug,ug,ug,ug,ur,ur,ur
ur,ur,ug,ux,ug,ux,ux,ux,ux,ux,ux,ux,ux,cg,ug,ug,ug,ug,ug,ug,ug,ux,ux
ur,ur,ur,cb,ub,ub,ub,ub,ub,ub,ub,ub,ub,ub,ub,ur,ur,ur,ur,ur,ur,ur,ur
ur,ur,ur,ur,ur,ug,ug,ug,ug,ug,ug,ug,ug,ub,ub,cr,ur,ur,ur,ur,ur,ur,ur
cr,ux,ux,ux,ux,ux,ux,ux,ux,ux,ux,ux,ux,ub,ux,ub,ub,ub,ub,ub,ub,ux,cb
cg,ux,ux,ux,ux,ux,ux,ux,ux,cg,ux,ux,ux,ub,ub,ub,ub,ub,ub,ub,ub,ux,ux