ur,cr,ub,ub,ur,ur,ur,ur,ur,ur,ur,ur,ur,ur,ur,ur,ur,ur,ur,ur,ur,ur,ur
ub,cb,ub,ub,ur,ur,ur,cr,ur,ur,ur,ur,ur,ur,ur,ur,ur,ur,ur,ur,ur,ur,ur
ub,ub,ub,ub,ur,ur,ur,ur,ur,ur,ur,ur,ur,ur,ur,ur,ur,ur,ur,ur,ur,ur,cb
ub,ub,ub,ur,ur,ur,ur,ub,cr,ur,ur,ur,ur,ur,ur,ur,ur,ur,ur,ub,ur,ur,ub
ub,ur,ur,ur,ub,ur,ur,ur,ur,ub,ur,ur,ur,ur,ur,ur,ur,ur,ur,ux,ur,ur,ub
ub,ub,ub,ub,cr,ur,ux,ub,ub,ub,ur,ur,ur,ur,ur,ur,ur,ur,ur,ub,ur,ur,ub
ub,ub,ub,ub,ub,ub,ub,ub,ub,ub,ub,ub,ub,ub,ug,ux,ub,ux,ur,ub,ub,ub,ub
ub,ux,ux,ug,ub,ug,ug,ug,ub,ug,ug,ub,ub,ub,ug,ux,ub,ux,ur,ub,ub,ub,ur
ub,ux,ux,ug,ub,ug,ub,ub,ub,ub,ub,ug,ug,ug,ug,ug,ub,ub,ur,ux,ub,ub,ur
ub,ux,ux,ug,ub,ug,ub,cb,ub,ub,ub,ub,ub,ub,ub,ug,ug,ub,ur,ur,ub,ub,ub
ub,ux,ux,ug,ub,ug,ub,ug,ub,ub,ub,ub,cb,ug,ub,cb,ug,ug,ug,ur,ug,ur,ub
ub,ux,ux,ug,ub,ug,ub,ub,ub,ub,ub,ub,ug,ug,ug,ux,ux,ug,ux,ur,ux,ur,ur
ub,ur,ur,ug,ub,ug,ug,ub,ug,ub,ub,ub,ub,ub,ub,ug,ug,ug,ux,ur,ux,ur,ur
ub,ux,ux,ug,ub,ug,ug,ub,ub,ub,ub,ub,ub,ub,ub,ug,ug,ug,ux,ur,ux,ur,ur
ub,ux,ux,ug,cb,ug,ug,ub,ub,ug,ub,ug,ub,ub,ug,ug,ux,ug,ux,ur,ux,ur,ur
ub,ux,ux,ug,ug,ug,ug,ug,ug,ug,ux,ug,ug,ug,ug,ug,ug,ug,ux,ur,ux,ur,ur
ub,ux,ux,ug,ug,cg,ug,ug,ug,ug,ux,ug,ux,ux,ux,ux,ux,ux,ux,cr,ux,ur,ur
ub,ux,ux,ug,ug,ux,ug,ug,ug,ug,ug,ug,ux,ux,ux,ux,ux,ux,ux,ux,ux,ur,ur
ub,ux,ux,ug,ug,ux,cg,ug,ug,ux,ux,ux,ux,ux,ux,ux,ux,ux,ux,ux,ux,ur,ur
ub,ux,ux,ux,ux,ux,ux,ux,ux,ux,ux,ux,ux,ux,ux,ux,ux,ux,ux,ux,ux,ur,ur
ub,ux,ux,ux,ux,ux,ux,ux,ux,ux,ux,ux,ux,ux,ux,ux,ux,ux,ux,ux,ux,ur,ur
ub,ux,ux,ux,ux,ux,ux,ux,ux,ux,ux,ux,ux,ux,ux,ux,ux,ux,ux,ux,ux,ur,ur
ub,ub,ux,ux,ux,ux,ux,ux,cg,ug,ug,ug,ug,ug,ug,ug,ug,ug,ug,ug,ug,cr,ur