ur,ur,ur,ur,ur,ur,ur,ur,cb,ub,ub,ub,ub,ur,ur,ur,ur,ur,ur,ur,ur,ug,ug
ur,ur,ur,ur,ur,ur,ur,cr,ur,cr,ub,ub,ub,ur,ug,ur,ur,ur,ux,ur,ur,ux,ug
ur,ur,ur,ur,ur,ur,ur,ur,cr,ur,ub,ub,ur,ur,ur,ur,ub,ub,ub,ub,ux,ux,ug
ur,ur,ur,ur,ur,ur,ur,ur,ur,ur,ub,ub,ub,ub,ub,ub,ub,ub,ux,ub,ub,ux,ug
ur,ur,ur,ur,ur,ur,ur,ub,ub,ub,ub,ub,ub,ug,ug,ug,ug,ug,ux,ux,ub,ub,ug
ur,ur,ur,ur,ur,ur,ur,ub,ur,ug,ur,ug,ub,ub,ub,ub,cb,cg,ux,ux,ux,ux,ug
ur,ub,ur,ur,cr,ur,ur,ub,ub,ug,ub,ug,ug,ug,ux,ux,ux,ub,ub,ub,ub,ux,ug
ur,ur,cr,ub,ub,ub,ux,ux,ub,ug,ug,ug,ug,ug,ug,cg,ux,ux,ux,ux,ub,ux,ug
cg,ux,ux,ux,ux,ux,ux,ub,ub,ub,ug,ug,ug,ug,ug,ug,ub,ux,ux,ux,ub,ux,ug
ux,ux,ux,ub,ub,ub,ux,ub,ub,ub,ub,ug,ub,ug,ug,ug,ub,ux,ux,ux,ub,ux,ug
ux,ux,ux,ub,ub,ub,ux,ub,ub,ub,ub,ub,ub,ub,ub,ub,ug,ug,ug,ug,ug,ux,ug
ux,ux,ux,ub,ub,ux,ug,ug,ug,ug,ub,ub,ub,ub,ub,ub,ug,ug,ug,ux,ug,ux,ug
ux,ux,ux,ub,ub,ub,ug,ug,ug,cb,ub,ub,ub,cb,ug,ug,ug,ux,ug,ug,ug,ux,ug
ux,ux,ux,ub,cb,ub,ux,ux,ux,ux,ub,ub,ub,ug,ux,ux,ux,ux,ug,ug,ub,ux,ug
ux,ux,ux,ux,ub,ub,ux,ux,ux,ug,ug,ug,ub,ux,ux,ux,ux,ux,ug,ug,ub,ux,ug
ug,ug,ug,ug,ug,ug,ug,ug,ug,ug,ug,ug,ug,ub,ub,ub,ux,ux,ug,ug,ub,ux,ug
ug,ur,ur,ur,ur,ur,ur,ur,ug,ug,ug,ur,ug,ug,ug,ug,ug,ug,ug,ug,ub,ur,ug
ug,ur,ur,ur,ur,ur,ur,ur,ug,ub,ug,ug,ug,ug,ub,ub,ug,ug,ug,ug,ub,ux,ug
ug,ur,ur,ur,ur,ur,ux,ur,ug,ux,ux,ux,ub,ug,ug,ug,ug,ug,ug,ux,ub,ux,ug
ug,ur,ur,ur,ur,ur,ux,ur,ug,ux,ux,ux,ux,ux,ux,ux,ux,ux,ux,ux,ub,ux,ug
cg,ub,ub,ub,ur,ur,ux,ur,ug,ux,ux,ux,ux,ux,ux,ux,ub,ub,ub,ub,ub,ux,ug
ub,ur,ur,ub,ur,ur,ux,ur,ug,ub,ub,ub,ub,ub,ub,ub,ub,ux,ux,ux,ux,ux,cb
ub,ub,ur,ub,ub,ur,ur,ur,ur,ur,ur,ur,ur,cr,ub,ub,ub,ub,ub,ub,ub,ub,ub