ur,ur,cb,ur,ur,ur,ur,cb,ug,ug,ug,cr,ug,ug,cg,ur,ur,ur,ur,cg,ug,ug,ug
ur,ur,ur,ur,ur,cr,ur,ub,ur,ub,ur,ur,ur,ur,ur,ur,ur,ur,ur,ur,ur,ug,cr
ur,ur,ur,ur,ux,ur,ur,ub,ub,ub,ur,ug,ug,ug,ug,ur,ur,ur,ur,ur,ur,ur,ur
ur,ur,ur,ur,ur,ur,ur,ub,ub,ur,ur,ug,ur,ur,ug,ur,ur,ur,ur,ub,ur,ug,ug
ur,ur,ur,ur,ur,ug,ug,ug,ug,ug,ur,ug,ur,ug,ug,ug,ug,ug,ub,ux,ur,ux,ug
ur,cr,ur,ur,ur,ux,ux,ur,ur,ug,ug,ug,ur,ug,ur,ug,ux,ug,ux,ux,ur,ux,ug
ur,ur,ur,ux,ux,ux,ur,ur,ur,ur,ur,ur,ug,ug,ur,ug,ux,ug,ux,ux,ur,ux,ug
ur,ur,ur,ur,ur,ur,ur,ur,ur,ur,ug,ur,ug,cb,ub,ug,ug,ug,ux,ux,ur,ug,ug
ur,ur,ur,ur,ur,ur,ur,ur,ur,ug,ug,ub,ub,ub,ug,ug,ub,ug,ub,ux,ur,ux,ug
ur,ur,ur,ur,ur,ur,ur,ur,ur,cr,ug,ub,ub,ub,ug,ug,ub,ug,ub,ux,ur,ux,ug
ur,ur,ur,ur,ur,ur,ur,ur,ug,ug,ug,ub,ub,cb,ub,ug,ub,ug,ub,ub,ur,ub,ub
ur,ur,ur,ur,ux,ux,ug,ug,ug,ub,ug,ug,ug,ub,ub,cg,ub,ug,ux,ug,ur,ug,ub
cg,ux,ux,ux,ux,ux,ug,ug,ug,ux,ug,ug,ug,ub,ug,ug,ub,ug,ub,ub,ur,ug,ub
ux,ux,ux,ux,ux,ux,ug,ux,ug,ug,ug,ub,ug,ub,ub,ug,ub,ug,ub,ub,ur,ug,ub
ux,ux,ux,ux,ux,ux,ug,ug,ug,ug,ub,ub,ub,ub,ub,ug,ub,ug,ub,ub,ur,ug,ub
ux,ux,ux,ux,ux,ux,ux,ux,ux,ug,ux,ub,ub,cb,ub,ub,ub,ug,ub,ub,ur,ug,ub
ux,ux,ug,ug,ug,ug,ug,ug,ug,ux,ux,ub,ub,ug,ub,ub,ub,ug,ug,ug,ur,ug,ub
cg,ux,ug,ux,ux,ux,ux,ux,ug,ux,ux,ub,ub,ug,ub,ub,ub,cg,ug,ug,ub,ub,ub
ux,ux,ug,ux,ux,ux,ux,ux,ug,ux,ux,ub,ub,ug,ub,ub,ub,ub,ux,ux,ub,ub,ub
ux,ux,ug,ux,ux,ux,ux,ux,ug,ug,ug,ug,ub,ub,ub,ub,ub,ub,ub,ub,ub,ub,ub
cr,ux,ug,ux,ux,ux,ux,ux,ux,ux,ug,cg,ub,ug,ub,ub,ub,ub,ub,ub,ub,ub,ub
cg,cb,ug,cr,ur,ur,ur,ur,ur,ur,ur,ub,ub,ur,ur,ur,ur,ub,ub,ub,ub,cb,cr
cr,ux,ug,ug,ug,ug,ug,ug,ug,cb,ub,ub,ub,ub,ug,ug,ub,ub,ub,ub,cb,ux,cr