cb,cb,cb,cr,ur,ub,ub,cb,ur,ur,ur,ur,ur,ur,ur,ur,ur,ur,ur,ur,ur,ur,cb
ur,ur,ur,ur,ur,cr,ur,ur,ur,ur,cb,ur,ur,ur,ur,ub,ub,ub,cb,ur,ur,ur,ur
ur,ur,ur,ur,cr,ug,ug,cg,ur,ur,ub,ur,ur,ur,ur,ub,ub,ub,ub,ur,ur,ur,ur
ur,ur,ur,ur,ur,ur,ur,ur,ur,ub,ub,ur,ur,ux,ur,ub,ub,ur,ur,ur,ur,ur,ur
ur,ur,ur,ug,ur,ur,ur,ur,ur,ub,ur,ux,ur,ur,ur,ub,ur,ur,ur,ur,ur,ur,ur
ur,ur,cr,ug,ur,ur,ur,ur,ur,ub,ur,ur,ur,ur,ur,ur,ur,ur,ur,ur,ur,ur,cr
ub,ug,cg,ub,ug,ub,ur,ur,ur,ub,ug,ux,ux,ux,ux,ux,ur,ur,cr,ur,ub,ux,ux
cb,ug,ug,ub,ug,ug,ub,ub,ub,ub,ug,ux,ux,ux,ux,ux,ur,ug,ug,ug,ug,ux,ux
ux,ur,ur,ub,ug,ug,ub,ub,ub,ub,ug,ux,ux,ug,ug,ug,ur,ug,ug,ug,ug,ug,ux
ux,ub,ub,ub,ug,ur,ub,ub,ub,ub,ub,ub,ux,ug,ux,ug,ur,ug,ug,ug,ux,ug,ux
ux,ub,ub,ur,ug,ug,ub,ub,ub,ub,ub,ub,ug,ug,ux,ug,ur,ug,ug,ug,ux,ug,ux
ux,ur,ub,ur,ur,ug,ub,ug,ug,ub,ub,ub,ug,ug,ug,ug,ug,ug,cg,ug,cg,ug,ux
cb,ux,ub,ub,cb,ur,ub,ub,ub,ub,ub,ub,ub,ug,ug,ug,ug,ug,ur,ug,ug,ug,ux
ub,ub,ub,ub,ub,ub,ub,ub,ub,ub,ub,cb,ub,ug,ug,ug,ug,ug,ur,ug,ug,ug,ux
ub,ub,ub,ub,ug,ub,ub,ub,ub,ub,ug,ub,ub,ug,ug,ug,ug,ug,ur,ug,ug,ug,ux
ux,ux,ux,ux,ug,ub,ux,ux,ux,ub,ug,ug,ug,ug,ux,ux,ug,ug,ur,ug,ug,ug,ux
ux,ux,ux,ux,ub,ub,ux,ux,ux,ux,ug,ux,ug,ug,ug,ug,ug,ux,ur,ug,ug,ug,ux
cr,ux,ux,ux,ub,ux,ux,ux,ux,ux,ug,ug,ug,ug,ub,ub,ur,ub,ur,ug,ug,ug,ub
cg,ux,ux,ux,ub,ux,ux,ux,ux,ux,ux,ux,ux,ug,ux,ux,ur,ux,ur,ux,ux,ug,ub
cb,ub,ub,ub,ub,ub,ub,ub,ub,cg,ug,ug,ug,ug,ub,ub,ur,ug,ur,ug,ug,ug,ub
ux,ub,ux,ux,ux,ux,ux,ux,ux,ux,ux,ux,ux,ux,ux,ux,ur,ux,ur,ur,ur,ur,cr
cr,ub,ub,ub,ub,ub,ub,ub,ub,ub,ub,ub,ub,ub,ub,ub,ur,cb,cg,ux,cb,cr,cr
cg,cb,cg,cb,ux,ux,ux,ux,ux,ux,ux,ux,ux,ux,ux,cg,ur,ur,ur,cg,cg,ux,cr