ur,ur,ub,cr,ub,ub,ub,ur,ur,ur,ur,ur,ur,ur,ur,ub,ub,ub,ur,ub,ur,ub,ub
ur,ur,ub,ur,ub,ur,cb,ur,ur,ur,ur,ur,ur,ur,ur,ub,ur,ub,ub,ub,ub,ub,ur
ur,ur,cb,ur,ub,ur,ur,ur,ur,ur,ur,ur,ur,ur,ur,ub,ur,ur,ub,ux,ux,ub,ub
ur,ur,ur,cr,ub,ur,ur,ur,ur,ur,ur,ur,ux,ux,ub,ub,ux,ux,ux,ux,ux,ux,ub
ur,ur,ur,ur,ur,ux,ur,ur,ur,ur,ur,ur,ur,ur,ub,ug,ug,ug,ug,ug,ur,ur,ub
ur,ur,ur,ur,ur,ur,ur,ur,ur,ur,ur,ur,ur,ub,ub,ug,ug,ug,ug,ug,ur,ur,ub
ur,ur,ur,ur,ur,ur,ur,ur,ur,ur,ur,ur,ub,ub,ug,ug,ug,ug,ug,ug,ub,ub,ub
ur,ur,ur,ur,ur,ur,ur,ur,ur,ur,ur,ur,ub,ur,ug,ur,ug,ug,ug,ug,ub,ur,cb
cg,ur,ur,ur,ur,ur,ur,ur,ur,ur,ur,ur,ub,ug,ur,ur,ug,ux,ug,ug,ur,ur,ur
ur,ur,cr,ur,ur,cr,ux,ur,ur,ur,ug,ug,ub,ub,ub,cg,ug,ur,ug,ug,ur,ur,ur
cr,ux,ux,ux,ux,ug,ug,ug,ug,ug,ug,ug,ug,ug,ub,ug,ug,ug,ug,ug,ur,ur,ur
ub,ux,ux,ux,ux,ug,ub,ug,ug,ug,ug,ur,ug,ub,cb,ug,ug,ug,ug,ug,ur,ux,ux
ub,ux,ux,ux,ux,ug,ug,ug,ur,cb,ub,ub,ub,ub,ug,ug,ug,ug,ur,ug,ur,ux,ux
ub,ub,ub,ub,ux,ux,ux,ug,ub,ub,ug,ug,ug,ub,ub,ub,cg,ug,ug,ug,ur,ur,ux
cg,ux,ux,ux,ux,ux,ux,ug,ub,ub,ub,ub,ub,ub,ub,ub,ur,ur,ur,ur,ur,ur,ux
ug,ug,ug,ug,ug,ug,ug,ug,ug,ug,ug,ug,ug,ub,cb,ug,ug,ug,ug,ug,ug,cg,ur
ug,ux,ux,ux,ux,ux,ux,ug,ur,ux,ub,ub,ub,ub,ux,ub,ub,ub,ux,ux,ux,ug,ur
ug,ux,ux,ux,ux,ux,ux,ug,ur,ux,ub,ux,ux,ub,ub,ub,ux,ub,ux,ux,ux,ug,ur
ug,ux,ux,ux,ux,ux,ux,ug,ur,ux,ub,ub,ub,ub,ub,ub,ub,ub,ux,ux,ux,ug,ur
ug,ux,ux,ux,ux,ux,ux,ug,ur,ux,ug,ux,ux,ub,ux,ux,ux,ux,ux,ux,ux,ug,ur
ug,ux,ux,ux,ux,ux,ux,ug,ur,ux,ug,ux,ux,ux,ux,ux,ux,ux,ux,ux,ux,ug,ur
ug,ux,ux,ux,ux,ux,ux,ug,ur,ux,ug,ux,ux,ux,ux,ux,ux,ux,ux,ux,ux,ug,ur
ug,ug,ug,ug,ug,ug,ug,ug,ur,cg,ug,ug,ug,ug,ug,ug,ug,ug,ug,ug,ug,cr,ur