ur,cg,cb,ur,ur,ur,ur,ur,ur,ur,ur,ur,ur,ur,ur,ur,ur,ur,ur,ur,ur,ur,ur
ub,ug,ur,ur,ur,ur,ur,ur,cr,ub,ur,ur,ub,ur,ub,cr,cb,ur,ur,ur,ur,ur,ug
ub,ug,ur,ur,ur,ur,ux,ur,ur,ur,ur,ur,ub,ub,ub,ub,ub,ug,ur,ur,ur,ur,ug
ub,ub,ur,ub,ur,ur,ur,ur,ur,ur,ur,ux,ug,ug,ug,ub,ug,ug,ur,ur,ur,ur,ug
ub,cb,ur,ub,ur,ur,ur,ur,ur,ur,ur,ur,ug,ug,ug,ug,ug,ug,ug,ug,ub,cr,ur
ub,ug,cr,ug,ur,ug,ug,ug,ur,ug,ug,ug,ug,ug,ug,ub,ux,ux,ur,ug,ur,cg,ug
ux,ux,ub,ug,ug,ug,ur,ug,ur,ug,ur,ug,cg,ug,ug,ug,ug,ug,ur,ug,ub,ub,ug
ux,ux,ub,ux,ux,ux,ux,ug,ug,ug,ug,ug,ug,ux,ug,ug,ug,ug,ug,ug,ur,ug,ug
ux,ux,ub,ux,ux,ux,ux,ux,ug,ug,ug,ug,ug,ug,ug,ub,ug,ub,ub,ur,ug,ug,ub
ux,ux,ub,ux,ux,ux,ux,ux,ug,ug,ug,ug,cb,ug,ub,ub,ub,ub,ur,ur,ug,ur,ur
ux,ux,ub,ux,ux,ux,ux,ux,ug,ug,ug,ux,ub,ub,ug,ug,ug,ug,cg,ur,ug,ur,cb
ux,ux,ub,ug,ug,ug,ux,ug,ug,ug,ug,ug,ub,ug,ug,ub,ub,ug,ug,ur,ug,ur,ur
ux,ux,ub,ug,ug,ug,ux,ug,ug,ug,ug,ug,ub,ub,ug,ug,ug,ug,ub,ub,ug,ur,ur
ux,ux,ub,ug,ug,ug,ux,ux,ug,ug,ug,ug,ug,ub,ub,ug,ug,ug,ub,ub,ug,ur,ur
ux,ux,ub,ug,ux,ug,ug,ug,ug,ug,ug,ug,ug,ub,ug,ug,ug,ug,ur,ub,ur,ur,ur
cg,ug,ub,ug,ux,ux,ug,ug,ug,ux,ug,ug,ug,ux,ug,ug,ug,ug,ug,ub,ur,ur,ur
ux,ug,ub,ux,ux,ux,ux,ug,ug,ug,ug,ug,ug,ug,ug,ug,ux,ux,ug,ub,ur,ur,ur
ug,ug,ub,ub,ub,ub,ub,ug,ug,ug,ug,ug,ug,ug,ug,ug,ux,ux,ug,ub,ur,ur,ur
ug,ux,ux,ux,ux,ux,ub,ug,ug,ux,ux,ux,ux,ux,ux,ug,ug,ug,ug,ub,ur,ur,ur
ux,ux,ux,ub,ub,ub,ub,ug,ug,ux,ux,ux,ux,ux,cg,ug,ug,cb,ub,ub,ur,cr,ur
cr,ug,ug,ub,ug,ug,ug,ug,ug,ug,ug,ug,ug,ug,ug,ug,ug,ug,ug,ur,ur,cr,ur
cg,ug,ux,ub,ux,ux,ug,ug,ug,ug,ug,ug,ug,ug,ug,ug,ug,ug,ug,ur,ur,cb,cr
cr,ug,ug,cb,ug,ug,ug,ug,ug,ug,ur,ur,ur,ur,ur,ur,ur,ur,ur,cg,cb,ux,cr