ur,ur,ur,ur,ur,ur,ur,ur,ur,ur,ur,ur,ur,ur,ur,ur,ur,ur,ur,ur,ur,ur,ur
ur,ur,ur,ur,ur,ur,ur,ur,ur,ur,ux,ux,ur,ur,ur,ur,ur,ur,ur,ur,ur,ur,ur
ur,ug,ug,ug,ug,ux,ur,ux,ur,ux,ux,ux,ur,ur,ux,ur,ur,ur,ur,ur,ub,ub,ub
ur,ug,ug,ug,ug,ux,ur,ur,ur,ur,ur,ur,ur,ur,ur,ur,ur,ur,cb,ub,ub,ur,ub
ur,ug,ug,ug,ug,ug,ur,ur,ur,ur,ur,ur,ur,ur,ur,ur,ur,ur,ur,cr,ub,ur,ur
ur,ur,ur,ur,ug,cg,ur,ur,ur,cg,ur,ur,ur,ur,ur,ur,ur,cb,ub,cr,ub,ub,ub
ur,ur,ur,ur,ur,ur,ur,ur,ur,ug,cr,ur,cr,ur,ur,ur,ur,ur,ur,ur,ub,ub,ub
ur,ur,ur,ur,ur,ur,ur,ur,ur,ur,ur,ur,ur,ur,ur,ur,ur,ur,ur,ur,ub,ub,ub
cg,ur,ur,ux,ur,ux,ur,ur,ub,ub,ub,ub,ur,cr,ur,ub,ub,ur,ur,ur,ur,ur,ur
ur,ur,ur,ux,ur,ur,ur,ub,ub,ub,ub,ub,ub,ux,ug,ub,ub,ub,ub,ub,ub,ub,ur
ux,ux,ur,ur,ur,ur,ur,ub,ub,cb,ub,ub,ub,ug,ub,ux,cb,ub,ub,ub,ub,ub,cr
ux,ux,ug,ug,ug,ug,ux,ub,ur,ub,ub,ub,cb,ub,ub,ux,ux,ux,ub,cb,ug,ux,ur
ux,ux,ug,ug,ux,ux,ux,ub,ur,ub,ub,ub,ug,ug,ug,ux,ux,ux,ub,ux,ug,ux,ur
ux,ux,ux,ux,ux,ux,ux,ub,ur,ub,ux,ub,ug,ug,ug,ug,ug,ux,ub,ub,ub,ub,ub
cg,ux,ux,ux,ux,ux,ux,ux,ur,ub,ub,ux,ug,ug,ug,ug,ux,ux,ux,ux,ug,ub,ub
ug,ug,ug,ug,ug,ug,ug,ug,ug,ug,ug,ub,ug,ug,ug,ug,ug,ux,ux,ux,ug,ub,ub
ug,ux,ux,ux,ux,ux,ux,ux,ur,ub,ug,ub,ug,ug,ug,ug,ug,ux,ux,ub,ug,ub,ub
ug,ux,ux,ux,ux,ux,ux,ux,ur,ub,ug,ub,ug,ug,ug,ug,ug,ux,ux,ub,ug,ub,ub
ug,ux,ux,ux,ux,ux,ux,ux,ur,ux,ug,ux,ub,ux,ug,ug,ug,ux,ux,ub,ub,ub,ub
ug,ux,ux,ux,cg,ug,ug,ug,ug,ug,ug,ux,ub,ux,ux,ux,ux,ux,ux,ub,ub,ub,ub
ug,ug,ug,ug,ug,ug,ug,ug,ur,ug,ug,ug,ug,ug,ug,ur,ur,ur,ur,ub,ub,ub,ub
ur,ux,ux,ux,ux,ux,ux,ux,ur,ux,ux,ux,ux,ux,ug,ug,ux,ux,ux,ub,ub,ub,cb
ur,ur,ur,ur,ur,ur,ur,ur,ur,cg,ux,ux,ux,ux,ux,ug,ug,ug,ug,ub,ub,ux,ux