ux,ur,cb,ur,ur,ur,ur,ur,ub,ub,ub,ub,ub,ub,ub,ub,ur,cr,ur,cg,ug,ug,ug
ux,ur,ub,ur,ur,ur,ur,ur,ub,ur,ur,ur,ur,ur,ur,ur,ur,ub,ur,ur,ur,ug,cr
ur,ur,ur,ur,ur,ur,ur,ur,ub,ub,cb,ur,ur,ur,ur,ur,ur,ur,ur,ur,ur,ur,ur
cr,ux,ur,ur,ur,ur,ur,ur,ur,ur,ur,ur,ur,ur,ur,ur,ur,ur,ur,ub,ug,ug,ug
ux,ur,ur,ur,ur,ur,ur,ur,ur,cg,ur,ur,ur,ur,ur,ur,ub,ub,ub,ur,ug,ur,ug
ur,ur,ur,ur,ur,ur,ur,ur,ur,ug,cr,ur,ur,ur,ur,ur,ub,ub,ub,ur,ug,ur,cg
ur,ur,ur,ur,ur,ur,ur,ur,cg,ur,ur,ur,ur,ub,ub,ub,ur,ub,ub,ux,ug,ur,ur
cr,ur,ur,ur,ur,ur,ur,ur,ug,ug,cr,ug,ub,ub,ub,ub,ug,ub,ur,ux,ug,ug,ur
ur,ur,ur,ur,ur,ur,ur,ur,ur,ur,ur,ub,ub,ub,ug,ub,cb,ur,ur,ux,ux,ur,ur
ur,ur,ug,ug,ug,ug,ug,ux,ub,ub,ug,ub,ub,ub,ub,ub,ub,ug,ug,ux,ux,ur,ur
ub,ug,ug,ug,ug,ub,ug,ux,ub,ub,ub,ub,ub,ub,ub,ub,ub,ux,ug,ug,ug,ug,ur
ux,ug,ug,ug,ug,ug,ug,ug,ux,ub,ub,ub,ug,ub,ub,ub,ub,ub,ug,ug,ug,ug,ur
cg,ux,ug,ug,ub,ug,ub,ug,ux,ub,ub,ug,ug,ub,ub,ug,ug,ub,ub,ug,ug,ug,ur
ug,ug,ug,ug,ug,ug,ug,ug,ux,ub,cb,ug,ub,ub,ug,ug,ug,ug,ug,ub,ug,cg,ur
ug,ug,ug,ug,ug,ug,ux,ux,ux,ug,ug,ub,ub,ux,ug,cb,ub,ug,ug,ub,ub,ur,ur
ug,ug,ug,ug,ug,ug,ug,ux,ux,ug,ux,ux,ub,ub,ug,ug,ub,ub,ub,ub,ux,ur,ur
ug,ug,ug,ug,ux,ux,ug,ux,ux,ux,ux,ux,ub,ub,ug,ub,ug,ub,ug,ug,ux,ur,ur
cg,ug,ug,ug,ug,ux,ug,ux,ux,ux,ux,cb,ub,ug,ug,ug,ug,ug,ug,ug,ub,ur,ur
ux,ux,ug,ux,ug,ux,ug,ug,ug,ug,ug,ub,ub,ug,ug,ug,ug,ug,ug,ug,ug,ur,ur
ux,ux,ug,ux,ug,ug,ux,ux,ux,ux,ug,ug,ug,ux,ux,ux,ux,ux,ux,ux,ux,ur,ur
cr,ux,ug,ux,ux,ug,ux,ux,ux,ux,ug,ux,ux,ux,ux,ux,ux,ux,ux,ux,ux,ur,ur
cg,cb,ug,ug,ug,ug,ug,ug,ug,ug,ug,ux,ux,ux,ux,ux,ux,ux,ux,ux,ux,cb,cr
cr,ux,ux,ux,ux,ux,ux,ux,ux,ux,ux,ux,ux,ux,ux,ux,ux,ux,ux,ux,cb,ux,cr