ub,ub,ub,ub,ub,ub,ub,ub,ub,ub,ub,ub,ub,ub,ub,ub,ub,ub,ub,cr,cg,ur,cb
ub,ub,ub,ur,ur,ur,ur,ur,ur,ur,ur,ur,ur,ur,ur,ur,ur,ur,ur,ur,ug,ur,ur
ur,ur,ub,ur,ur,ur,ur,ur,ur,ur,ur,ur,ur,ur,ur,ur,ur,ur,ur,ur,ug,ug,ug
ub,ub,ub,ur,ur,ur,ur,ur,ur,ur,ur,ur,ur,ur,ur,ur,ur,ur,ur,ur,ur,ur,ug
cb,ur,ur,ur,ur,ur,ur,ur,ur,ur,ur,ur,ur,ur,ur,ur,ur,ug,ug,ur,ur,ur,ug
ur,ur,ur,ur,ur,ur,ug,ug,cr,ur,ur,ug,ug,cr,ug,ug,cg,ug,ug,ur,ur,ur,ug
ur,ur,ur,ur,ur,ur,ug,ug,ug,ug,ur,ug,ug,ur,ur,ur,ur,ur,ur,ur,ur,ur,ug
ur,ur,ur,ur,ur,ur,ur,ug,ug,ug,ur,ug,ug,ug,ur,ux,ur,ur,ur,ur,ur,ur,ug
cg,ur,ur,ur,ur,ur,ur,cr,ug,ug,ur,cg,ug,ug,ur,ur,ur,ur,ur,ur,ur,ur,ug
ur,ur,ux,ur,ur,ur,ux,ur,ur,ur,ug,ur,ug,ug,ur,ur,ur,ur,ur,ur,ur,ur,ug
ur,cr,ux,ur,ux,ux,ux,ug,cb,cb,ub,ub,ub,ub,ub,ur,ur,ur,ur,ub,ub,ub,ug
ur,ur,ur,ub,ub,ub,ub,ub,ub,ub,ur,ur,ub,ur,ur,ur,ur,ur,ur,ub,ux,ux,ug
ur,ur,ur,ur,ur,ux,ux,ub,ub,ub,ub,cb,ub,ur,ur,ur,ur,ub,ub,ub,ux,ux,ug
ux,ux,ux,ug,ux,ux,ub,ub,ug,ub,ub,ub,ug,ug,ub,ub,ub,ux,ux,ub,ux,ux,ug
ux,ux,ux,ug,ux,ub,ub,ub,ug,ub,ug,ug,ug,ug,ub,ub,ub,ux,ux,ub,ux,ux,ug
ux,ux,ux,ug,ub,ub,ub,ug,ug,ub,ub,ug,ug,ux,ux,ub,ux,ux,ux,ub,ux,ux,ug
ub,ub,ub,ug,ub,ub,ub,ub,ug,ug,ug,ug,ug,ub,ub,ub,ub,ub,ub,ub,ub,ub,ug
ub,ux,ux,ug,ux,ux,ub,ub,ub,ub,ux,ux,ux,ux,ux,ux,ux,ux,ux,ub,ux,ux,ug
ub,ux,ux,ug,ux,ux,ub,ub,ub,ub,ux,ux,ux,ux,ux,ux,ux,ux,ux,ub,ux,ux,cr
ub,ux,ux,ug,ux,ux,ux,ub,ux,ux,ux,ux,ux,ux,ux,ux,ux,ux,ux,ub,ux,ux,ur
ub,ux,ux,ug,ux,ux,ux,ux,ux,ux,ux,ux,ux,ux,ux,ux,ux,ux,ux,ub,ux,ux,ur
ub,ux,ux,ug,ux,ux,ux,ux,ux,ux,ux,ux,ux,ux,ux,ux,ux,ux,ux,ub,ux,ux,cb
ub,ub,ub,ug,ug,ug,ug,ug,ug,ug,ug,ug,ug,ug,ug,ug,ug,ug,ug,ub,ub,ub,ub