ub,cb,cb,cr,ur,ur,ur,ur,ur,ur,ur,ur,ur,ur,ur,ur,ub,ub,ub,ub,ux,ux,cb
ur,ur,cb,ur,ur,ur,ub,ur,ur,ur,ur,cr,ur,ur,cr,ub,ub,ur,ur,ub,ur,ur,ur
ub,ub,cb,ur,ur,ub,ub,ur,ux,ur,ur,ub,ub,ur,ub,ub,ur,ur,ur,ur,ur,ur,ur
ub,ub,ub,ub,ub,ub,ur,ur,ur,ux,ur,ur,ur,ur,ur,ur,ur,ur,ur,ur,ur,ur,ur
ur,ur,ur,ur,ur,ur,ur,ur,ur,ur,ur,ur,ur,ur,ur,ur,ur,ur,ur,ur,ur,ur,ur
ur,ur,ur,ur,ur,ur,ur,ug,ug,ug,ur,cg,ug,ur,ur,ur,ur,ur,ur,ur,ur,ur,ur
ur,ur,ur,ur,ug,ug,ug,ug,ur,ug,ug,ur,ug,ug,ug,cr,ur,ur,ur,ur,cr,ug,ub
cb,ub,ub,ug,ug,ur,ur,ur,ug,ug,ug,ur,ug,ug,ug,ug,ug,ug,ug,ug,ug,ug,ub
ur,cb,ub,ug,ur,ur,ur,cg,ug,ur,ur,ug,ug,ug,ug,ug,ug,ug,ug,ug,ug,ug,ub
ur,cr,ub,ug,ug,ub,ux,ug,ur,ur,ub,ug,ug,ug,ux,ug,ug,ug,ug,ug,ug,ug,ub
ub,ub,ub,ub,ug,ub,ub,ug,ub,ub,ub,ug,ug,ug,ug,ug,ug,ux,ug,cg,ug,ug,ub
ux,ub,ub,ub,ug,ug,ug,ug,ub,ug,ug,ug,ug,ug,ug,ug,ux,ux,ug,ub,ug,ug,ub
cb,ub,ub,ub,ub,ug,ug,ug,ug,ub,ug,ug,ub,ug,ug,ug,ux,ux,ug,ub,ug,ug,ux
ub,cb,ug,ug,ub,ug,ug,ug,ug,ug,ub,ub,ub,ug,ug,ur,ub,ux,ug,ub,ug,ug,ux
ux,ux,ug,ug,ug,ug,ug,ug,ug,ug,ug,ug,ub,ug,ug,ur,ub,ux,ug,ub,ug,ug,ub
ux,ux,ug,ug,ug,ug,ug,ux,ug,ux,ux,ub,cb,ub,ug,ur,ub,ub,ug,ug,ug,ug,ub
ux,ux,ug,ug,ub,ug,ug,ug,ug,ux,ub,ub,ub,ur,cg,ug,ub,ub,ub,ug,ug,ug,ub
cr,ug,ug,ug,ug,ug,ug,ug,ur,ur,ur,ur,ur,ur,ur,ur,ur,cr,ub,ug,ug,ug,ub
cg,ug,ug,ug,ug,ux,ug,ur,ub,ux,ux,ux,ux,ur,ug,ug,ug,ux,ux,ug,ug,ug,ux
cb,ux,ug,ug,ug,ug,ub,ub,ub,ug,ug,ug,ug,ug,ug,ug,ug,ug,ug,ug,ug,ug,ux
ux,ur,ur,cg,cb,ub,ub,cg,ub,ub,ub,ug,ug,ur,ug,ug,ug,ug,ug,ug,ug,ug,cr
cr,ur,ur,ur,ub,ub,ur,ug,ub,ub,ub,ur,ug,ur,ug,ug,ug,ub,ub,cb,cb,ug,cr
cg,ur,cg,cb,ux,ug,ug,ug,ux,ur,ug,ug,ug,ur,ur,cg,ux,ux,ux,cg,cg,ug,cr