cb,cb,cb,cr,ur,ur,ur,ur,ur,ur,ur,ur,ub,ub,ub,ub,cb,ur,ur,ur,ur,ur,cb
ur,ur,ur,ur,ur,ur,ur,ur,ur,ur,ur,ur,ub,ur,ur,ub,cb,ur,ur,ur,cb,ub,ub
ur,ur,ur,ur,cr,ub,cb,ur,ur,ur,ur,ur,ub,ur,ur,cr,ur,ur,ur,ur,ur,ur,cr
ur,ur,ur,ug,ug,ug,ur,ur,ur,ur,ur,ur,ub,ur,ur,ur,cr,ur,ur,ur,ur,ur,ur
ug,ug,cg,ug,ug,ug,ur,ur,ur,ur,ux,ur,ub,ur,ur,ur,ug,ur,ur,ur,ur,ux,ux
ug,ug,ug,ug,ug,ug,ur,ur,ur,ub,ur,ur,ub,ur,ur,ur,ug,cg,ur,ur,ub,ur,ur
ug,ug,ug,ug,ug,ug,ug,ug,ur,ur,ur,ux,cr,ur,ur,ur,ub,ub,ug,ub,ub,ur,ur
cb,ug,ug,ug,ug,ug,ug,ug,ug,ug,ug,ug,ub,ub,ub,ug,ug,ug,ub,ub,ub,ur,ur
ux,ux,ux,ub,ux,ub,ub,ux,ux,ux,ux,ux,ux,ug,cg,ug,ug,ug,ur,ur,ur,ur,ur
ux,ub,ub,ub,ub,ub,ub,ub,ub,ug,ug,ug,ux,ug,ug,ur,ub,ug,ur,ur,ur,cg,ur
ux,ub,ub,ub,ux,ux,ub,ux,ub,ug,ub,ug,ug,ug,ug,ur,ub,ug,ur,ur,ur,ug,ur
ux,ux,ub,ub,ub,ub,ub,ux,ux,ug,ub,ug,ug,ug,ug,ur,ub,ug,ur,ur,ur,ug,ur
cb,ux,ub,ub,ub,ux,ug,ug,ug,ug,ug,ug,ub,ub,ug,ub,ub,ug,ug,ug,ug,ug,ur
ub,ub,ub,ub,ub,ub,ug,ux,ug,ug,ub,ub,ub,ub,ug,ub,ug,ug,ug,ug,ug,ug,ur
ur,ur,ur,ur,ug,ug,ug,ug,ug,ug,ug,ub,ug,ug,ug,ug,ug,ug,ug,ug,ug,ug,ur
ur,ux,ux,ux,ug,ub,ug,ug,ug,ug,ub,cb,ub,ub,ub,ub,ub,ub,ug,ug,ug,ug,ug
ur,ur,cg,ug,ug,ur,ur,ur,ur,ur,ur,ur,ur,ur,ur,ur,ur,ur,ur,ur,ur,cr,ug
cr,ux,ug,ug,ub,ux,ug,ug,ug,ug,ug,ug,ug,ug,ux,ux,ux,ug,ug,ug,ug,ug,ug
cg,ux,ug,ug,ub,ux,ux,ux,ux,ug,ug,ug,ug,ug,ux,ux,ux,ug,ug,ug,ug,ug,ug
cb,ux,ug,ug,ub,ub,ub,ub,ux,ug,ug,ug,ug,ug,ux,ux,ux,ug,ug,ug,ug,ug,ug
ux,ux,ux,ux,ux,ux,ux,ux,ux,ux,ux,ux,ux,ux,ux,ux,ux,ux,ur,ur,ur,ur,cr
cr,ux,ux,ux,ux,ux,ux,ux,ux,ux,ux,ux,ux,ux,ux,ux,ux,cb,cg,ux,cb,ur,cr
cg,cb,cg,cb,ux,ux,ux,ux,ux,ux,ux,ux,ux,ux,ux,cg,ux,ux,ux,cg,cg,ur,cr