ux,cb,cb,cr,cb,ur,ur,ur,ur,ur,ur,ur,ur,ur,ur,ur,ur,ur,ur,ur,ur,ur,cb
ux,ux,cb,ux,ur,ur,ur,ur,ur,ur,ux,ux,cr,ur,ur,ur,ur,ur,ur,ur,ur,ur,ur
ux,ux,ux,ux,ur,ur,ur,ur,ur,ur,ur,cb,ur,ur,ur,ur,ur,ur,ur,ur,ur,ur,ur
ur,ur,ur,ur,ur,ur,ur,ur,ur,ur,ur,ub,ur,ur,ug,ug,ux,ur,ur,ur,ur,cr,ug
ur,ur,ur,ur,ur,ur,ur,ur,ur,ur,cr,ub,ur,ug,ug,ug,ur,ur,ur,ur,ur,ux,ug
ur,ur,ur,ur,ur,cg,ug,ur,ur,ur,ur,ur,ur,ug,ug,ug,ur,ug,ux,ux,ux,ux,ug
ur,ur,ur,ur,cr,ug,ug,ur,ur,cr,ur,ur,ur,ug,ug,ug,ug,ug,ux,ux,ux,ux,ug
cb,ur,ur,ur,ur,ur,ur,ur,cg,ug,ug,ur,ur,cg,ug,ur,ug,ur,ux,ux,ux,ux,ug
ur,ur,ur,ur,ur,ur,ur,ur,ur,ug,ur,ur,ug,ug,ug,ug,ux,ux,ux,ux,ux,ux,ug
ur,ur,ur,ur,ur,ur,ur,ur,ug,cg,ux,ux,ug,ug,ug,ug,ux,ux,ux,ux,ux,ux,ug
ur,ur,ur,ur,ur,ur,ur,ur,ug,ux,ux,ux,ug,ug,ug,ug,ux,ux,ux,ug,ux,ux,ug
ur,ug,ug,ug,ug,ug,ug,ug,ug,ux,ub,ub,ug,ug,ug,ug,ug,ub,ub,ub,ub,ub,cb
cb,ub,ub,ub,ub,ux,ux,ux,ux,ux,ub,ug,ug,ug,ug,ug,ug,ug,ug,ug,ux,ug,cg
ub,cb,ub,ub,ub,ub,ug,ug,ub,ub,ub,ug,ug,ug,ug,ug,ug,ug,ug,ug,ux,ug,ux
ug,ug,ub,ug,ug,ug,ug,ub,ub,ub,ub,ug,ug,ug,ug,ug,ug,ug,ux,ux,ub,cb,ux
ug,ug,ug,ug,ug,ug,ug,ug,ub,ub,ub,ub,ug,ug,ur,ug,ux,ux,ux,ux,ub,ub,ub
ug,ug,ug,ug,ug,ug,ug,ug,ub,ub,ub,ux,ux,ug,ub,ub,ub,ub,ub,ub,ub,ub,ub
ug,ug,ug,ug,ug,ug,ug,ug,ur,ur,ub,ub,ub,ub,ub,ur,ur,ur,ur,ur,ur,ur,ur
ub,ug,ug,ug,ug,ug,ug,ug,ux,ux,ux,ux,ux,ux,ug,ux,ux,ux,ub,ub,ub,ub,ur
cr,ur,ur,ur,ur,ur,ug,ug,ug,ur,ur,ur,ur,ur,ur,ur,ur,ur,ur,ur,ur,ur,ur
cg,ur,ug,ug,ug,ux,cg,ug,ug,ux,ux,ux,ux,ux,ug,ug,ug,ug,ux,ux,ux,ux,cr
cr,ur,ur,ur,ur,ur,ur,ur,ug,ux,ux,ux,ux,ug,ug,ug,ug,ug,ux,cb,cb,ux,cr
cg,ur,cg,cb,ug,ug,ug,ur,ur,cr,ug,ug,ug,ug,ur,cg,ug,ug,ux,cg,cg,cb,cr