ux,ux,ur,ur,ur,ur,ur,cr,ug,ug,ug,ub,ub,ub,ub,ur,ur,cb,ub,ub,ub,ub,ub
ux,ux,ur,ug,ug,ug,ur,ur,ur,ur,ug,ub,ur,ur,ub,ub,ur,ur,ub,ur,ur,ur,ub
ux,ux,ug,ug,ug,cg,ur,ur,ur,ur,ug,ub,cb,ug,ug,ug,ur,ur,ub,ub,ur,ux,ub
ux,ux,ug,ug,ug,ur,cr,ug,cr,ur,cg,ur,ur,ur,cb,ub,cg,cr,ur,ub,ur,ux,ub
ux,ux,ux,ug,ug,ug,ur,ug,ur,ug,cr,ur,ur,ur,ur,ub,ur,ub,ug,ug,ux,ux,ub
ux,ux,ux,ux,ux,ug,ur,ug,ur,ur,ur,ug,ur,ug,cr,ur,ub,ub,ug,ux,ux,ux,ub
ux,ux,ux,ux,ux,ug,ur,ug,ur,ug,ur,ur,ur,ug,ug,ub,ub,ub,ub,ux,ux,ux,ub
ux,ux,ux,ux,ur,ug,ug,ug,ur,ug,ug,ug,ug,ug,ub,ub,ug,ub,ub,ub,ux,ux,ub
ux,ux,ux,ux,ux,ug,ux,ux,ur,ux,ux,ux,ux,ub,ub,ub,ub,ub,ub,ub,ux,ux,ub
ux,ux,ux,ux,ux,ug,ux,ux,ur,ub,ub,ub,ux,ub,ux,ub,ub,cb,ub,ub,ux,ux,ub
ux,ux,ux,ux,ux,ug,ug,ux,ur,ub,ub,ub,ug,ug,ug,ug,ug,ub,ub,ub,ub,ux,ub
ux,ux,ux,ux,ux,ug,ug,ub,ur,ub,ub,cb,ub,ug,ug,ug,ug,ug,ux,ux,ub,ux,ub
ux,ux,ux,ux,ux,ug,ux,ub,ur,ub,ub,ub,ub,ub,ug,ub,ug,ug,ux,ux,ub,ux,ub
ux,ux,ux,ux,ux,ux,ux,ub,ur,ub,ub,ub,ub,ub,ug,ub,ux,ug,ug,ug,ug,ux,ub
cg,ux,ux,ux,ux,ux,ux,ub,ur,ub,ug,ug,ug,ug,ug,ug,ug,ug,ug,ux,ug,ug,ub
ux,ux,ux,ux,ux,ux,ux,ux,ur,ug,ug,ug,ug,ug,ug,ug,ug,ug,ug,ug,ug,ug,ub
ux,ux,ux,ux,ux,ux,ux,ux,ur,ux,ug,ug,ug,ug,ug,ug,ug,ug,ug,ug,ub,ur,ub
ub,ub,ub,ub,ub,ub,ub,ub,ur,ub,ub,ub,ub,ub,ub,ug,ug,ug,ug,ug,ub,ur,ub
ub,ub,ub,ub,ub,ub,ub,ux,ur,ux,ux,ux,ux,ux,ux,ux,ux,ux,ux,ug,ur,ur,ub
ub,ub,ub,ub,ub,ub,ub,ub,ur,ub,ub,ub,ub,cg,ug,ug,ug,ug,ug,ug,ub,ur,ub
ub,ub,ub,ub,ub,ub,ub,ub,ur,ub,ub,ub,ub,ub,ub,ub,ub,ub,ub,ur,ub,ub,ub
cr,ux,ub,ub,ux,ub,ub,ux,ur,ub,ub,ub,ub,ub,ub,ub,ub,ub,ur,ur,ub,ub,cb
cg,cb,ub,ub,ux,ub,ub,ur,ur,cg,ub,cb,ub,ub,ub,ub,ub,ub,ur,ur,ub,ub,ur