ur,cb,cb,cr,ur,ur,ur,ur,ur,ur,ur,ur,ur,ur,ur,ux,ur,ur,ur,ur,ux,ux,cb
ur,cb,cb,ur,ur,cg,cr,cb,ur,ur,ur,ur,ur,ur,ur,ur,ur,ur,ur,ur,ur,ur,ur
ur,ur,ur,ur,ur,ug,ur,ub,ub,ub,cr,ur,ur,ur,ur,ur,ur,ur,ur,ur,ur,ur,ur
ur,ur,ur,ur,ur,ur,ur,ub,ub,cr,ur,ur,ur,ur,ur,ur,ur,ur,ur,ur,ur,ur,ur
ur,ug,ug,cg,ur,ur,ur,cb,ur,ur,ug,ur,ur,ur,ur,ur,ur,ub,ur,ur,ur,ur,ur
ur,cr,ur,ur,ur,ur,ur,ur,cr,ug,ur,ur,ur,ur,ub,ub,ur,ub,ub,ub,ur,ur,ur
ur,ur,ur,ur,ur,ur,ug,ug,ug,ug,ur,ur,ur,ur,ur,ug,ur,ux,ug,ub,ur,ur,ur
cb,ug,ug,ug,ur,ug,ug,ur,ug,ug,ur,ur,ur,ur,ur,ug,ur,ur,ug,ug,cg,ur,ur
ug,ug,ug,ur,ux,ug,ug,ux,ug,ur,ur,ur,ur,ur,ur,ug,ug,ug,ug,ug,ug,ub,ub
ug,ug,ug,ur,ug,ug,ug,ug,ug,ur,ur,ur,ur,ur,ur,ug,ug,ug,ug,ub,ub,ux,ub
ug,ug,ur,ur,ug,ug,ug,ug,ug,ur,ur,ur,ur,ur,ur,ug,ug,ug,ug,ub,ub,ub,ub
ur,ur,ur,ug,ug,ug,ub,ub,ug,ug,ur,ur,ug,ug,ug,ug,ug,ug,ug,ux,ux,ux,ux
cb,ux,ux,ug,ug,ug,ub,ub,ug,ug,cg,ur,ug,ug,ug,ug,ux,ux,ug,ux,ux,ux,ux
ub,ub,ug,ug,ug,ug,ug,ub,ug,ug,ug,ug,ug,ug,ug,ug,cr,ux,ug,ux,ux,ux,ux
ub,ub,ug,ug,ug,ug,ug,cb,ub,ug,ug,ug,ug,ug,ux,ug,ur,ug,ug,ug,ux,ux,ux
ub,ug,ug,ug,ug,ug,ub,ub,ug,ug,ub,ub,ub,ug,ug,ug,ur,ug,ug,ug,ux,ux,ux
ug,ug,ug,ug,ug,ug,ux,ug,ux,ux,ug,cg,ux,ux,ux,ux,ur,ug,ug,ug,ux,ux,cb
ug,ug,ug,ug,ug,ug,ux,ux,ux,ux,ug,ux,ux,ux,ux,ux,ur,ug,ug,ug,ux,ux,ux
ug,ug,ug,ug,ub,ug,ug,ux,ux,ux,ug,ux,ux,ux,ux,ux,ur,ug,ug,ug,ux,ux,ux
ug,ug,ug,ug,ug,ug,ug,ug,ug,ug,ug,ug,ug,ug,ug,ug,ur,ub,ur,ur,ur,ur,ux
cr,ur,ug,ug,ug,cb,ub,ub,ub,cg,ub,ub,ub,ub,ub,ub,ur,ub,ur,ur,ur,ur,cr
cg,ur,ur,ur,ur,ur,ub,ub,ur,ub,ub,ub,ub,ub,ur,ur,ur,ur,ur,cb,cb,ur,cr
cr,cg,cg,cb,ug,ub,ub,ux,ub,ub,ux,ub,ub,ux,ux,cg,ur,ur,ur,cg,cg,ur,cr