ur,ur,ur,ur,ur,ux,ur,ur,ur,ur,ur,ur,ur,ur,ur,ur,ur,ur,ur,ur,ur,ur,ur
ur,ur,ur,ur,ur,ug,ug,ug,ug,cr,ur,ur,ur,ur,ur,ur,ur,ur,ur,ur,ur,ur,ur
ur,ur,ur,ur,ur,ug,ur,ur,ur,ur,ug,ug,ug,ug,ug,ur,ur,ur,ur,ur,ur,ur,ur
ur,ur,ur,ur,cg,ug,ur,ur,ur,ur,ug,ur,ur,ur,ug,ur,ur,ug,ur,ur,ur,ur,ur
ur,ur,ur,ur,ur,cg,ug,ug,ug,ug,ug,ur,ur,ur,ug,ur,ug,ur,ur,ur,ur,ur,ux
ur,ur,ur,ur,ur,ur,ur,ur,ur,ur,ur,ur,ur,ur,ug,ug,ug,ur,ur,ur,ur,ub,ux
ur,ur,ur,ur,ur,ur,ur,ur,ur,ur,ur,ur,ur,ug,ug,ur,ur,ur,ur,ur,ur,cr,ux
ur,ur,ur,ur,ur,ur,ur,ur,ur,ur,ur,ur,ur,ug,ug,ug,ug,ur,ur,ur,ux,ub,ux
ur,ur,ur,ur,cr,ug,ug,ug,ug,ug,cr,ur,ur,cg,ug,ug,ug,ug,ur,ur,ux,ub,ux
ur,ur,ur,ur,ur,ug,ug,ug,ug,ug,ug,ug,ux,ug,ug,ug,ug,ug,cb,ux,ux,ub,ux
ur,ur,ur,ur,ur,ur,ug,ug,ug,ur,ur,ug,ug,ug,ug,ug,ug,ug,ub,ux,ux,ub,ur
ur,ur,ur,ur,ur,ur,ug,ug,ug,ur,ur,ub,ub,ug,ug,ug,ug,ug,ub,ub,ub,ub,ur
ur,cb,ub,ur,ur,ur,ug,ug,ug,ub,ub,ub,ub,ub,ug,ug,ug,ug,ug,ux,ub,ub,ux
ur,ur,cr,ur,ub,ub,ub,ub,ub,ub,ub,ub,ub,ub,ux,ug,ub,ub,ub,ub,ub,ub,ur
ub,ub,ub,ug,ub,ub,ub,ub,ub,ur,ub,ub,ub,ub,ub,ug,ub,ub,ub,ub,ub,ub,ur
ub,ub,ug,ug,ux,ub,ub,ub,ub,cb,cg,ug,ug,ug,ug,ug,ur,ur,ur,ur,ur,ur,ur
ub,ub,ug,ux,ux,ub,ub,ub,ub,ub,cb,ux,ux,ub,ub,ur,ub,ux,ux,ux,ub,ur,ur
ub,ub,ug,ub,ub,ub,ub,ub,ux,ux,ux,ux,ux,ub,ub,ur,ub,ux,ux,ux,ub,ur,ur
ub,ub,ug,ub,ug,ug,ub,ux,ux,ux,ux,ux,ux,ux,ub,ur,ux,ux,ux,ux,ub,ur,ur
ub,ub,ux,ub,ub,ub,ub,ux,ux,ux,ux,ux,ux,ux,ub,ur,ux,ux,ux,ux,ub,ur,ur
ub,ub,ux,ux,ux,ux,ur,ux,ux,ux,ux,ux,ux,ux,ux,ur,ux,ux,ux,ux,ub,ur,ur
ub,ub,ug,ug,ug,ug,ur,ux,ux,ux,ux,ux,ux,ux,ux,ur,ur,ur,ur,ur,ub,cr,ub
ub,ub,ux,ux,ux,ux,ur,ur,ur,ur,ur,ur,ur,ur,ur,ur,ur,ur,ur,ur,ur,cb,cb