ur,ur,cb,ur,ur,ur,ur,ur,ur,ur,ur,ur,ur,cr,ug,ur,ur,ur,ur,cg,ux,cr,ux
ur,ur,ur,ur,ur,ur,ur,ur,ur,ur,ur,ur,ur,ur,ug,ur,ur,ur,ur,ux,ux,ur,ur
ur,ur,ur,ur,ur,ur,ur,ur,ur,ur,ur,ur,ur,ug,ug,ux,ur,ur,ur,ur,ur,ux,ur
ur,ur,ur,ur,ur,ur,ug,ug,ug,ur,ur,ur,ur,ur,ug,ux,ux,ux,ux,ux,ur,ux,ux
ur,ur,ur,ur,ur,ur,cg,ur,ug,ur,ur,ur,ur,ur,cr,ug,ug,ub,ub,ub,ub,ub,ub
ur,ur,ur,ur,ur,ur,ug,ug,ug,ur,ur,ug,cr,ur,ur,ug,ub,ub,ub,ub,ub,ub,ub
ur,ur,ur,ur,ur,ur,ug,ur,ur,ur,ur,ur,ur,ub,ub,ub,ub,ug,ub,ub,ub,ub,cb
ur,ur,ur,ur,ur,ur,ug,ug,ur,ur,ub,ub,ub,ub,ub,ug,ux,ug,ux,ux,ur,ux,ux
ur,ur,ur,ur,ur,ur,cr,ug,ug,ug,ug,ug,ug,ub,ub,ug,ub,ub,ub,ux,ur,ux,ug
ux,ux,ur,ur,ur,ug,ug,ug,ug,ug,ug,ug,ug,ub,ub,ub,ub,ub,ub,ux,ur,ux,ug
ur,ur,ur,ur,ur,ur,ur,ur,ug,ug,ug,ug,ug,ub,ub,ug,ug,ug,ub,ub,ur,ub,ub
ur,ur,ur,ur,ux,ux,ug,ug,ug,ux,ug,ug,ub,cb,ub,ub,ug,ug,ux,ux,ur,ux,ub
cg,ux,ux,ux,ux,ux,ug,ug,ug,ux,ug,ug,ub,ug,ub,ub,ug,ug,ub,ub,ur,ux,ub
ux,ux,ux,ux,ux,ux,ug,ux,ub,ug,ub,ug,ub,cg,ug,ug,ug,ug,ub,ux,ur,ux,ub
ux,ux,ux,ux,ux,ux,ug,ug,cb,ub,ub,cg,ug,ug,ug,ug,ug,ug,ub,ux,ur,ux,ub
ux,ux,ux,ux,ux,ux,ux,ux,ub,ub,ux,ux,ug,ug,ug,ug,ug,ug,ux,ux,ur,ux,ub
ux,ux,ug,ug,ug,ug,ug,ug,ug,ux,ux,ux,ug,ug,ub,ug,ub,ub,ub,ub,ur,ug,ub
cg,ux,ug,ug,ug,ux,ub,ub,ub,ux,ux,ux,ug,ug,ug,ug,ug,ug,ux,ub,ub,ub,ub
ux,cg,ug,ux,ug,ub,ub,ub,ub,ux,ux,ub,ub,ub,ub,ub,ub,ub,ux,ub,ub,ub,ub
ux,ux,ug,ux,ub,ub,ux,ub,ub,ub,ug,ux,ub,ub,ub,ub,ub,ub,ub,ub,ub,ub,ub
cr,ux,ug,ux,ub,ux,ux,ub,ub,ux,ug,ug,ub,ub,ub,ub,ub,ub,ub,ub,ub,ub,ub
cg,cb,ur,ug,cb,ug,ug,ub,ub,ub,ub,ug,ub,ub,ub,ub,ub,ub,ub,ub,ub,cb,cr
cr,ux,ur,ug,ug,ug,ug,ug,ub,ub,ub,ur,ub,ub,ub,ub,ub,cr,ur,cb,cb,ux,cr