ur,ur,ur,ur,ur,ur,ur,ur,ur,ur,ur,ur,ur,ur,ur,ur,ur,ur,ur,ur,ur,ur,ur
ur,ur,cr,cr,ur,ur,ur,ur,ur,ug,ug,ug,ug,ug,ug,ug,ur,ur,ur,ur,ur,ur,ur
ub,ur,ub,ug,ug,ur,ur,ur,ur,ur,ur,ur,ur,ur,ur,cg,ur,ur,cb,ur,ur,ur,ur
ur,ur,ub,ur,ug,ur,ur,ux,ub,ub,ub,ub,ub,ub,ur,ur,ur,cr,ub,ur,ur,ur,ur
cb,ub,ub,ur,ug,ug,ur,ur,ur,ur,ug,ur,ub,ug,ug,ur,ur,ub,ub,ub,ub,cr,ur
ux,ux,ur,ur,ur,ug,ub,ub,ub,ub,ub,ub,ub,ub,ub,ub,ub,ub,ub,ub,ux,ux,ux
ux,ux,ux,ub,ub,ub,ub,ub,ur,ur,ub,ub,ub,ub,ug,ub,cb,ub,ub,ux,ux,ux,ux
ur,ur,ux,ub,ug,cr,ur,ur,ur,ug,ug,ub,ub,ug,ug,ub,ub,ux,ux,ux,ux,ux,ux
cg,ur,ur,ub,ub,ur,ur,ur,ur,ug,ub,ub,ub,ub,ub,ub,ux,ux,ux,ux,ux,ux,ux
ur,ur,ur,ub,ub,ug,ug,ug,ur,ug,ub,ub,cb,ug,ux,ux,ux,ux,ux,ux,ux,ux,ux
ur,ux,ux,ub,ub,ug,ug,ug,ur,ug,ug,ug,ug,ug,ub,ub,ux,ux,ux,ux,ux,ux,ux
ur,ux,ux,ux,ur,ub,ug,ug,ur,ug,ub,ub,ug,ub,ub,ub,ux,ux,ux,ux,ux,ux,ux
ur,ur,ur,ur,ur,ub,ug,ug,ur,ug,ug,ub,cg,ug,ub,ub,ub,ux,ux,ux,ux,ux,ux
ux,ux,ux,ux,ux,ub,ub,ub,ur,ur,ug,ub,ug,ub,ub,ub,ub,ub,ux,ux,ux,ux,ux
cg,ux,ux,ux,ub,ub,ub,ub,ur,ur,ux,ux,ub,ub,ub,ub,ub,ub,ub,ux,ux,ux,ux
ub,ub,ub,ub,ub,ub,ub,ub,ur,ur,ug,ug,ug,ug,ub,ub,ug,ub,ub,ug,ug,ug,ug
ub,ux,ux,ux,ux,ub,ub,ub,ur,ur,ux,ux,ub,ub,ub,ub,ux,ux,ux,ux,ux,ux,ug
ub,ux,ux,ux,ux,ux,ux,ub,ur,ur,ux,ux,cb,ub,ux,ux,ux,ux,ux,ux,ux,ux,ug
ub,ux,ux,ux,ux,ux,ux,cb,ur,ur,ux,ux,ux,ux,ux,ux,ux,ux,ux,ux,ux,ux,ug
ub,ux,ux,ux,ux,ux,ux,ur,ur,ur,ux,ux,ux,ux,ux,ux,ux,ux,ux,ux,ux,ux,ug
cg,ug,ug,ug,ug,ug,ug,ur,ug,ug,ug,ug,ug,ug,ug,ug,ug,ug,ug,ug,ug,ug,ug
ur,ux,ux,ux,ux,ux,ux,cr,ux,ur,ux,ux,ux,ux,ux,ux,ux,ux,ux,ux,ux,ux,cb
ur,ux,ux,ux,ux,ux,ux,ux,ux,cg,ux,ux,ux,ux,ux,ux,ux,ux,ux,ux,ux,ux,ux