ur,ur,ur,ur,ur,ur,ur,ur,ur,ur,ur,ur,ur,ur,ur,ur,ur,cb,ur,ur,ur,ub,ub
ur,ur,ur,ur,ur,ur,ur,cb,ur,ur,ur,ur,ur,ur,ur,ur,ur,ur,ur,ur,ur,ub,ub
ur,ur,ur,cr,ug,ug,cr,ub,ur,cg,ug,ug,cr,cr,ur,ur,ur,ur,ur,ur,ur,ub,ub
ur,ur,ur,ur,ug,ug,ub,ub,ug,ug,ur,ur,ur,ur,ur,ur,ur,ur,ur,ur,ur,ur,ub
ur,ur,ur,ur,ug,ur,ur,ug,ur,ur,ur,ur,ur,ur,ug,ur,ur,ur,ur,ux,ux,ur,ub
ur,ur,ur,ur,cg,ur,ur,cr,ug,cg,ur,ur,ur,ur,ug,ug,ug,ug,ug,ux,ux,ur,ub
ur,ur,ur,ur,ur,ur,ur,ur,ug,ug,ug,ug,ug,ug,ug,ux,ub,ub,ub,ub,ub,ur,ub
ur,ur,ur,ur,ur,ur,ur,ur,ug,ug,ug,ub,cg,ub,ub,ux,ug,ug,ub,ub,ub,ur,ub
ur,ur,ur,ur,ux,ux,ux,cb,ub,ub,ug,ub,ub,ug,ub,ug,ug,ug,ux,ux,ub,ur,ub
ur,ur,ur,ur,ur,ur,ur,ub,ug,ug,ug,ub,ub,ub,ub,ub,ux,ug,ub,ub,ub,ur,ub
ub,ur,ur,ur,ux,ub,ub,ub,ug,ug,ug,ub,ub,ub,ub,ub,ub,ug,ug,ux,ux,ur,cb
ub,ub,ux,ug,ux,ub,ux,ug,ug,ug,ug,ug,ub,ub,ub,ub,ub,ub,ub,ux,ub,ur,ur
ux,ub,ub,ub,ub,ub,ux,ug,ux,ug,ub,ug,ub,ub,ub,ub,ub,ub,ug,ux,ub,ur,ur
ux,ux,ux,ux,ub,ub,ux,ug,ub,ug,ug,ug,ub,ub,ub,ub,ug,ub,ug,ux,ub,ur,cr
cg,ux,ux,ux,ux,ux,ux,ug,ug,ug,ug,ub,ub,cb,ub,ub,ux,ub,cb,ux,ub,ur,ux
ux,ux,ux,ux,ux,ux,ux,ux,ux,ux,ug,ug,ub,ub,ub,ub,ux,ug,ug,ug,ub,ur,ux
ux,ux,ux,ux,ux,ux,ux,ux,ux,ux,ug,ur,ux,ux,ug,ug,ux,ug,ug,cb,ub,ur,ux
ub,ub,ub,ub,ub,ub,ub,ub,ub,ub,ub,ub,ub,ub,ub,ub,ub,ub,ub,ub,ub,ur,ux
ub,ub,ub,ub,ux,ux,ux,ux,ux,ux,ux,ur,ux,ux,ux,ux,ux,ux,ux,ux,ub,ur,ux
ux,ux,ux,ub,ub,ub,ub,ub,ub,ub,ub,ub,ub,ub,ub,ub,ub,ub,ub,ub,ub,ur,ux
ux,ux,ux,ux,ux,ux,ux,ux,ux,ux,ux,ur,ux,ux,ux,ux,ux,ux,ux,ux,ux,ur,ux
cr,ux,ux,ux,ux,ux,ux,ux,ux,ux,ux,ur,ux,ux,ux,ux,ux,ux,ux,ux,ux,ur,cb
cg,ux,ux,ux,ux,ux,ux,ux,ux,cg,ux,ur,ur,ur,ur,ur,ur,ur,ur,ur,ur,ur,ur