ur,ur,ur,ur,ur,ur,ur,ur,ur,ur,ur,ur,cb,ub,ub,ub,ub,cr,ub,ub,ub,ur,cb
ur,ur,ur,ur,ur,ur,ur,ur,ur,ur,ur,ur,ur,ur,ur,ur,ur,ur,ux,ux,ub,ur,ux
ur,ur,ur,ur,ur,ur,ur,ur,ur,ur,ur,ur,ur,ur,ur,ur,ur,ur,ub,ub,ub,ur,ux
ur,ur,ur,ur,ur,ur,ur,ur,ur,ur,ur,ur,ur,ur,ur,ur,ur,ur,ur,ur,ur,ur,ux
ur,ur,ur,ur,ur,ur,ur,ur,ur,ur,ur,ur,ur,ur,ur,ur,ur,ur,ur,ur,ur,ur,ux
cr,ub,ur,ur,ur,ur,ur,ur,ur,ur,ur,ur,ur,ur,ur,ur,ur,ur,ug,ug,ug,ur,ur
ur,ur,ur,ur,ur,ur,ur,ur,ur,ur,ur,ur,ur,ur,ur,ur,ur,ur,ug,ug,ug,ur,ur
ur,ur,ur,ur,ur,ur,ux,ur,ur,ux,ur,ur,ur,ur,ur,ur,ur,ur,ug,ug,ug,ux,ur
cg,ub,cr,ux,ub,ub,ub,ub,ur,ur,cr,ur,ur,ur,cr,ug,ug,ur,ug,ug,ug,ur,ur
ur,ub,ur,ur,cb,cg,ux,ub,ux,ux,ub,ub,ur,cr,ub,ug,ug,ur,ux,ug,ug,ur,ur
ur,ub,ur,ur,ur,ug,ux,ub,ub,cb,ub,ub,ur,ub,ub,ug,ug,ug,ug,ug,ub,ur,ur
ur,ub,ur,ur,ub,ug,ug,ug,ug,ug,ug,ug,ur,ug,ug,ug,ug,ug,ug,ub,ub,ub,ur
ub,ub,ub,ub,ub,ub,ug,ub,ug,ub,ub,ug,ur,ub,ux,ux,ux,ub,ub,ux,ux,ub,ur
ub,ux,ux,ub,ub,ub,ub,ub,ug,ug,ug,ub,ur,ub,ux,ux,ux,ux,ub,ux,ux,ub,ur
ub,ux,ux,ux,ug,ug,ub,ub,ug,ub,cb,ug,ur,ug,ug,ug,ug,ug,ub,ub,ub,ug,ur
ub,ux,ux,ux,ug,ub,ub,ub,ug,ub,ub,ug,ur,ug,ug,ug,ug,ug,ux,ub,ub,ug,ur
ub,ux,ux,ux,ub,ub,ub,ub,ub,ub,ub,ux,ur,ux,ux,ux,ux,ug,cg,ug,ub,ug,ur
ug,ug,cg,ux,ub,ub,ub,ub,ub,ux,ux,ux,ur,ux,ux,ux,ub,ug,ug,ug,ub,ug,ur
ug,ux,ux,ux,ux,ub,ub,ub,ub,ux,ux,ux,ur,cb,ub,ub,ub,ux,ub,ub,ux,ug,ur
ug,ug,ug,ug,ug,ug,ub,ux,ux,ux,ux,ux,ur,ub,ub,ux,ux,ux,ux,ux,ux,ug,ur
ub,ux,ux,ub,ub,ug,ug,ux,ux,ux,ux,ux,ur,ub,ub,ux,ux,ux,ux,ux,ux,ug,ur
ub,ux,ux,ux,ux,ux,ug,ug,ug,ug,ug,ug,ur,ux,ux,ux,ux,ux,ux,ux,ux,ug,ur
ub,ub,ux,ux,ux,ux,ur,ur,ur,ur,ur,ur,ur,ur,ur,ur,ur,ur,ur,ur,ur,ur,ur