ux,ux,cb,ux,ux,ur,ur,ur,ur,ur,ur,ur,ur,ur,ur,ur,ur,ur,ur,cg,ur,ur,ur
ux,ux,ux,ux,ur,ur,ur,ur,ur,ur,ur,ur,ur,ur,ur,ur,ur,ux,ur,ux,ur,ur,ur
ux,ux,ur,ur,ur,ur,ur,ur,ur,ur,ur,ur,ur,ur,ur,ur,ur,ur,ur,ur,ur,ur,ur
cr,ux,ur,ur,ur,ur,ur,ur,ur,ur,ur,ur,ur,ur,ur,ur,ur,ur,ur,ur,ur,ur,ur
ur,cb,ur,ur,ur,ur,ur,ur,ur,ur,ur,ur,ur,ur,ur,ur,ur,ur,ur,ur,ur,ur,ur
ub,ub,ur,ur,ur,ur,ur,ur,ur,ur,ur,ur,ur,cr,ug,ug,cg,ur,ur,ur,ur,ur,ur
ur,ur,ur,ur,ur,ur,ur,ur,ur,ur,ug,ug,ub,ur,ur,ur,ur,ur,ur,ur,ur,ur,ur
ur,ur,ur,ur,ur,ur,ur,ur,ur,cr,ug,ug,ug,ug,ur,ur,ur,ub,ur,ur,ur,ur,ur
ur,ur,ur,ug,ub,ub,ug,ug,ug,ug,ug,ug,ub,ub,cr,ur,ub,ur,ug,ug,cg,ur,ur
ur,ur,ur,ug,ur,ug,ub,ub,ub,ug,ug,ug,ub,ub,cb,ug,ug,ur,ug,ur,ug,ur,ur
ur,ur,ur,cr,ub,ub,ub,ub,ub,ug,ug,ug,ug,ub,ub,ur,ug,ug,ug,ur,ub,ub,ur
ur,ug,ur,ug,ub,cb,ub,ub,ub,ub,ub,ug,ub,ug,ug,ug,ug,ug,ug,ur,ub,ub,ur
cg,ug,ux,ug,ux,ug,ug,ug,ug,ug,ub,ub,ub,ug,ug,ub,ug,ug,ug,ur,ub,ub,ur
ux,ug,ux,ug,ug,ug,ug,ug,ug,ub,ux,ub,ub,ub,ub,ug,ug,cg,ug,ur,ub,ub,ur
ux,ug,ux,ux,ux,ux,ur,ug,ub,cb,ub,ub,ub,ub,ug,ug,ux,ub,ub,ub,ub,ub,ur
ux,ug,ux,ux,ux,ux,ug,ug,ub,ux,ub,ub,ub,ub,ub,ug,ux,ub,ux,ub,ub,ub,ur
ux,ug,ug,ug,ub,ub,ub,ub,ub,ub,ub,ub,ux,ux,ux,ux,ux,ub,ub,ub,ub,ub,ur
cg,ux,ug,ub,ub,ub,ub,ub,ub,ub,ub,ub,ux,ux,ux,ux,ux,ub,ub,ub,ux,ux,ur
cb,ux,cg,ug,ug,ub,ug,ux,ux,ux,ux,ux,ux,ux,ux,ux,ux,ub,ub,ub,ub,ub,ur
ub,ub,ub,ub,ug,ux,ug,ug,ug,ug,ux,ux,ug,ug,ug,ug,ug,ub,ub,ub,ub,ub,ur
cr,ub,ub,ub,ug,ux,ur,ux,ux,ug,ug,ux,ug,ug,ug,ug,ug,ub,ug,ur,cr,ur,ur
cg,ub,ub,ux,ug,ug,ur,ug,ug,ug,ug,ux,ux,ux,ux,ux,ux,cb,ux,ur,ux,cb,cr
cr,ub,ub,ux,ux,ux,ur,ur,ur,ur,ur,ur,ur,ur,ur,ur,ur,ur,ur,ur,cb,ux,cr