ur,ur,ur,ur,ur,ur,ur,ur,ur,ur,ur,ur,ur,ur,ur,ur,ur,ur,ur,ur,ur,cr,cb
ur,ur,ur,ur,ur,ur,ur,ur,ur,ur,ur,cb,ub,ub,ur,ur,ur,ur,ur,cr,ur,ur,ur
ug,ug,ug,ug,ug,ug,ug,ug,ug,cr,ur,ur,ur,ub,ur,ur,ur,ub,ub,ub,cr,ux,ub
cg,ur,ur,ur,ur,ur,ur,ur,ur,ur,ur,ur,ur,ub,ur,ur,ub,ub,ug,ug,ux,ux,ub
ur,ur,ur,ur,ur,ur,ur,ur,ur,ur,ur,ur,ur,ub,ub,ub,ub,ug,ur,ug,ug,ug,ub
ur,ur,ur,ur,ur,cg,ur,ur,ur,ur,ur,ur,ur,ur,ur,ur,ur,ug,ug,ub,ub,ug,ux
ur,ur,ur,ur,ur,cr,ur,ur,ur,ux,ux,ux,ur,ur,ux,ux,ug,ug,ug,ub,ug,ug,ux
ur,ur,ur,ur,ur,ur,ur,ur,ug,ug,ur,ur,ur,ur,ur,ur,ug,ug,ug,ub,ug,ug,ux
cg,ur,ur,ur,ur,ur,ur,ur,ur,ur,ub,ub,ug,ug,ug,ug,ug,ub,ub,ug,ug,ug,ux
ur,ur,ur,ur,ur,ur,ur,ug,ug,ug,ug,ug,ug,ug,ug,ug,ug,ug,ug,ug,ug,ug,ux
ur,ur,ur,ur,ur,ur,ur,ug,ug,ug,ug,cg,ub,ub,ub,ub,ub,ub,ub,ug,ug,ug,ux
ub,ub,ub,ub,ub,ub,ub,ub,ub,ub,ub,ub,ub,ub,ub,cb,ub,ub,ub,ug,ug,ur,ux
ub,ux,ux,ub,ux,ux,ux,ux,ux,ub,ub,ub,ub,ub,ub,ub,ub,ub,ub,ux,ug,ux,ux
ub,ux,ux,ub,ug,ug,ug,ug,ug,ub,ub,ub,ub,ub,ub,ub,ub,ux,ux,ux,ug,ux,ux
ub,ux,ux,ub,ug,ub,ub,ub,ub,cb,ux,ub,ub,ug,cb,ub,ub,ux,ux,ux,ug,ux,ux
ub,ux,ux,ub,ug,ux,ug,ux,ug,ub,ux,ub,ub,ug,ub,ub,ug,ug,ug,ux,ug,ux,ux
ub,ux,ux,ux,cr,ur,ur,cb,ub,ub,ub,ub,ub,ub,ub,ub,ub,ub,ub,ub,ub,ub,ub
ub,ux,ux,ux,ux,ux,ux,ub,ux,ug,ux,ub,ub,ux,ux,ux,ux,ux,ug,ux,ug,ux,ub
ub,ux,ux,ux,ux,ux,ux,ub,ub,ug,ux,ub,ub,ub,ub,ux,ux,ux,ug,ug,ug,ux,ub
ub,ux,ux,ux,ux,ux,ux,ub,ub,ug,ux,ub,ub,ub,ux,ux,ux,ux,ux,ux,ux,ux,ub
ub,ux,ux,ux,ux,ux,ux,ub,ub,ug,ux,ub,ux,ux,ux,ux,ux,ux,ux,ux,ux,ux,ub
ub,ux,ux,ux,ux,ux,ux,ub,ux,ux,ux,ub,ux,ux,ux,ux,ux,ux,ux,ux,ux,ux,ub
ub,ub,ub,ub,ub,ub,ub,ub,ub,ub,ub,ub,ub,ub,ub,ub,ub,ub,ub,ub,ub,ub,ub