ur,ur,ur,ur,ur,ur,ur,ur,ur,ur,ur,cr,cr,ur,ur,ur,ur,ur,ug,ug,ug,ug,ug
ur,ur,ur,ur,ur,ur,ur,ur,ur,ur,ur,ur,ur,ur,ur,ur,ur,ur,ur,ur,ur,ur,ug
ur,ur,ur,cg,ug,ur,ur,ur,ur,ur,ur,ur,ur,ur,ur,ur,ur,ur,ur,ur,ur,ur,cg
ur,ur,ur,ur,ug,ur,ur,ur,ur,ur,ur,ur,ur,ur,ur,ur,ur,ur,cr,ub,ur,ur,ur
ur,ur,ur,ur,ug,ug,ur,ur,ur,ur,ur,ur,ur,ur,ur,ur,ur,ur,ur,cb,ur,ur,ur
ur,ur,ur,ur,ur,ug,ur,ur,ur,ur,ur,ur,ur,ur,ug,cr,ur,ur,ur,ur,ur,ur,ur
ur,ur,ur,ur,ur,ur,ur,ur,ur,ur,cb,ur,ur,ur,cr,ug,ur,ur,ur,ux,ub,ub,ub
ur,ur,ur,ur,ur,ur,ur,ub,cb,ur,ub,ur,ur,ug,ug,ub,ub,ux,ux,ux,ub,ub,ub
cg,ur,ur,ur,ur,ur,ur,ur,ub,ur,ub,ur,ur,ub,ug,ug,ux,ux,ux,ux,ub,ub,ub
ur,ur,ur,ur,ur,ur,ur,ur,ub,ur,ub,ub,ub,ub,ug,ux,ux,ux,ux,ux,ub,ub,ub
ur,ur,ur,ux,ux,ux,ug,ux,ub,ub,ub,ub,ub,ub,ug,ub,ux,ux,ux,ux,ub,ub,ub
ux,ux,ux,ux,ux,ux,ug,ux,ub,ub,ub,ub,ub,ub,ug,ug,ux,ux,ux,ux,ub,ub,ub
ux,ux,ux,ux,ux,ux,ug,ug,ug,ub,ub,ub,ub,ub,ub,ug,ub,ux,ux,ux,ub,ub,ub
ux,ux,ux,ux,ub,ub,ub,ux,ug,ub,ub,ub,ub,ub,ub,ug,ug,ub,ub,ub,ub,ub,ub
cg,ux,ux,ux,ub,ux,ub,ux,ug,ug,ug,ub,ub,ub,cg,ug,ug,ub,ub,ub,ub,ub,ub
ug,ug,ug,ug,ub,ug,ub,ub,ub,ug,ug,ub,ub,cb,ug,ug,ug,ug,ug,ux,ub,ub,ub
ug,ux,ux,ux,ub,ux,ux,ub,ub,ux,ug,ub,ub,ub,ub,ub,ux,ux,ug,ux,ub,ub,ub
ug,ux,ux,ux,ub,ux,ux,ub,ub,ux,ug,ub,ub,ub,ux,ux,ux,ux,ub,ub,ub,ub,ub
ug,ux,ux,ux,cb,ux,ux,ub,ub,ux,ug,ub,ub,ub,ub,ub,ub,ub,ub,ux,ux,ub,ub
ug,ux,ux,ux,ux,ux,ux,ub,ub,ub,ub,cr,ub,ub,ux,ux,ux,ux,ug,ux,ux,ub,ub
ug,ug,ug,ug,ug,ug,ug,ub,ub,ub,ug,ur,ub,ub,ub,ub,ub,ub,ug,ub,ub,ub,ub
ux,ux,ux,ux,ux,ux,ux,ub,ub,ub,ub,ur,ub,ub,ub,ub,ub,ub,ub,ub,ub,ub,cb
ux,ux,ux,ux,ux,ux,ux,ub,ub,cg,ub,cb,ur,ur,ur,ur,ur,ur,ur,ur,ur,ur,ur