ub,cr,ur,ur,ur,cr,ux,ur,ur,ur,ur,ur,ur,ur,ur,ur,ur,ur,ur,ur,ur,ur,cb
ub,ub,ub,ub,ur,ur,ur,ur,ur,ur,ur,ur,ur,ur,ur,ur,ur,ur,ur,ur,ur,ur,ur
ub,ub,ub,ub,ur,ur,ur,ur,ur,ur,ur,ur,ur,ur,ur,ur,ur,ur,ur,ur,ur,ur,ur
ur,ur,ur,ur,ur,ur,ur,cg,ug,ub,ub,ub,ub,cr,ur,ub,ub,ub,cb,ur,ur,ur,ur
ur,ur,ur,ur,ur,ug,ug,ur,ug,ur,ur,ug,ug,ug,ur,ur,ur,ug,ug,ur,ur,ur,ur
ur,ur,ur,ur,ur,ug,ur,ur,ug,ug,ug,ug,ur,ur,ug,ug,ur,ug,ug,ur,ur,ur,ur
ur,ur,ur,ur,ur,ur,ur,ur,ur,ur,ur,ur,ur,ur,ur,ur,ur,ur,ur,ur,ur,ur,ur
ur,ur,ur,ur,ur,ur,ur,ur,ug,ug,ux,ur,ur,ur,ur,ur,ur,ur,ur,ur,ur,ur,cr
cg,ur,ur,ur,ur,ur,ur,ur,ur,ur,ur,ur,ur,ur,ur,ur,ur,ur,ur,ur,ur,ur,ur
ur,ur,ur,ur,ur,ur,ur,ur,ur,ur,ur,ur,ur,ug,ug,ug,ug,ug,ug,ug,ug,ug,ux
ur,ur,ur,ur,ur,ur,ur,ur,ur,ur,ur,ur,ug,ub,ub,ub,ub,ub,ub,ug,ug,ug,ux
ur,ur,ur,ur,ur,ur,ur,cr,ub,ug,ug,ug,ug,ub,ub,cb,ub,ub,ub,ug,ug,ux,ux
ur,ur,ur,ur,ur,ux,ux,ub,ug,ug,ug,ug,ug,ub,cb,ub,ub,ub,ub,ux,ug,ux,ux
ux,ux,ux,ug,ux,ux,ub,ub,ug,ug,ug,ug,ug,ug,ub,ub,ub,ux,ux,ux,ug,ux,ux
ux,ux,ux,ug,ux,ux,ub,ub,ug,ug,ug,ug,ug,ug,ub,ub,ub,ux,ux,ux,ug,ux,ux
ux,ux,ux,ug,ux,ux,cb,ub,ug,ug,ug,ug,ug,ux,ub,ub,ug,ug,ug,ux,ug,ux,ux
ub,ub,ub,ug,ub,ub,ub,ub,ub,ub,cg,ug,ug,ub,ub,ub,ub,ub,ub,ub,ub,ub,ub
ub,ux,ux,ug,ux,ux,ux,ux,ub,ub,ux,ub,ub,ux,ux,ux,ux,ux,ug,ux,ug,ux,ub
ub,ux,ux,ug,ux,ux,ux,ux,ub,ub,ux,ub,ub,ub,ub,ux,ux,ux,ug,ug,ug,ux,ub
ub,ux,ux,ug,ux,ux,ux,ux,ux,ux,ux,ub,ub,ub,ux,ux,ux,ux,ux,ux,ux,ux,ub
ub,ux,ux,ug,ux,ux,ux,ux,ux,ux,ux,ub,ux,ux,ux,ux,ux,ux,ux,ux,ux,ux,ub
ub,ux,ux,ug,ux,ux,ux,ux,ux,ux,ux,ub,ux,ux,ux,ux,ux,ux,ux,ux,ux,ux,cr
ub,ub,ub,ug,ug,ug,ug,ug,ug,ug,ug,ug,ug,ug,cg,ub,ub,ub,ub,ub,cb,ur,ur