ur,ur,ur,ur,ur,ur,ur,ur,ur,cg,ur,cb,ub,ub,ub,ux,ux,cb,ux,ux,ux,ur,ur
ur,ur,cb,ub,cr,ur,ur,ur,ur,ur,ur,ux,ux,ux,ub,ux,ux,ux,ux,cg,ux,ur,ur
ur,ur,cr,ub,ur,ur,ur,ur,ug,ur,ur,ur,ub,ub,ub,ug,ug,ub,ub,ug,ub,ur,ur
ur,ur,cg,ug,ug,ur,ur,ug,ug,ur,ur,ur,ub,ub,ub,ux,ug,ug,ug,ug,ug,ur,ur
ur,ur,ur,ug,ug,ur,ug,ug,cg,ur,ur,ur,ub,ub,ub,ub,ub,ub,ub,ub,ug,ur,ur
ur,cr,ur,ub,cr,ur,ug,ug,ug,ur,ur,ur,ub,ub,ub,ub,ub,ux,ux,ux,ug,ur,ur
ur,ur,ur,ur,cr,ug,ug,ug,ug,ug,ux,ux,ux,ux,ub,ub,ub,ux,ux,ub,ub,ur,ur
ur,ug,ug,ux,ug,ug,ug,ub,ug,ug,ub,ub,ub,ug,ug,ug,ug,ug,ug,ug,ux,ur,ur
ur,ur,ur,cr,ub,ug,ub,ug,ub,ug,ug,ug,ub,ug,ug,ug,ug,ug,ug,ug,ux,ur,ur
ur,ux,ub,ub,ub,ug,ug,ug,cg,ug,ug,ug,ub,ug,ug,ug,ug,ug,ug,ug,ux,ur,ur
ur,ub,ub,ub,ub,ub,ub,ug,ub,ug,ug,ug,ux,ug,ug,ug,ug,ug,ug,ux,ug,ur,ur
ur,ub,ub,ub,ub,ub,ug,ug,ub,ub,ub,ub,ub,ug,ug,ux,ug,ug,ug,ux,ug,ur,ur
ur,ub,ub,ub,ub,ug,ug,ug,ub,ub,ub,ub,ug,ug,ug,ug,ug,ub,ug,ux,ux,ur,ur
ur,ub,ub,ub,ub,ub,ub,cb,ub,ub,ub,ub,ug,ub,ug,ug,ug,ug,ug,ux,ux,ur,ur
ur,ub,ub,ub,ub,ub,ub,ug,ug,ug,ug,ub,ug,ub,ug,ug,ug,ux,ux,ux,ux,ur,ur
ur,ub,ub,ub,ub,ub,ub,ug,ug,cb,ub,ub,cg,ub,ug,ug,ug,ug,ux,ux,ux,ur,ur
ur,ub,ub,ug,ub,cb,ub,ub,ug,ug,ub,ub,ub,ub,ug,ug,ux,ug,ux,ux,ux,ur,ur
ur,ub,ub,ub,ub,ub,ub,ub,ug,ug,ub,ub,ub,ub,ug,ug,ug,ug,ux,ux,ux,ur,ur
ur,ux,ux,ug,ug,ug,ub,ub,ub,ug,ug,ug,ux,ux,ug,ug,ux,ux,ux,ux,ux,ur,ur
ur,ux,ux,ub,ux,ub,ug,ub,ub,ub,ub,ub,ux,ub,ub,ub,ub,ux,ux,ux,ux,ur,ur
ur,ur,ur,ur,ur,ur,ur,ur,ur,ur,ur,ub,ur,ur,ur,ur,ur,ur,ur,ur,ur,ur,ur
cr,ux,ub,ub,ux,ub,ub,ub,ub,ux,ux,ub,ux,ux,ur,ub,ub,ub,ux,ux,ux,ur,cb
cg,ux,ub,ub,ux,ux,ux,ux,ux,ux,ux,ub,ub,ub,ub,ub,ub,ub,cb,ur,ur,ur,ur