ur,ur,ur,ur,ur,ur,ur,ur,ur,ur,ur,ur,ur,ur,ur,ur,ur,ur,ur,ur,ur,ur,ur
ur,ur,ur,ur,ux,ur,ur,ur,ur,ur,ur,ur,ur,ur,ur,ur,ur,ur,ur,ur,ur,ur,ur
ur,ur,ur,ur,ur,ur,ur,ur,ur,ur,ur,ur,ur,ur,ur,ux,ux,ux,cr,ur,ur,ur,ur
ur,ur,ur,ur,ur,cg,ug,ug,cr,ur,ur,ur,ur,ur,ur,ub,ub,ub,ub,ur,ur,ur,ur
ur,ur,ur,ur,ur,ur,ur,cr,ug,ur,ur,ur,ur,ub,ub,ub,ux,ux,ub,ub,ub,ur,ur
ur,ur,ur,ur,ur,ur,ur,ur,ur,ub,ur,ur,ub,ub,cr,cb,ur,ur,ur,ur,ur,ur,ur
ur,ur,ur,ur,ur,ur,ur,ur,ur,ur,ur,ub,ub,ur,ub,ub,ub,ux,ux,ux,ux,ur,ur
ur,ur,ur,ur,ur,ur,ur,ur,ur,ub,ub,ub,ub,ur,ub,ux,ug,ug,ug,ux,ur,ur,ur
ur,ur,ur,ur,ur,ur,ur,ur,ur,ug,ug,ub,ub,ub,ub,ub,ub,ug,ug,ux,ux,ux,ur
ur,ur,ur,ur,ur,ur,ur,ur,cr,ug,ug,ub,ug,ur,ub,ub,ub,ug,ub,ub,ux,ux,ur
ur,ur,ur,ur,ur,ur,ur,ur,ur,ur,ur,cr,cb,ub,ur,ub,ub,ug,ur,ub,ub,ub,ur
ur,ur,ur,ur,ur,ur,ur,ur,ur,ur,ur,ur,ug,ub,ub,ub,ub,ub,ub,ux,ux,ub,ur
ur,ur,ur,ur,ur,ur,ur,ur,ur,ux,ug,ug,ug,ub,ub,ug,ug,ug,ub,ub,ub,ub,ur
ur,ur,ur,ur,ur,ur,ur,ur,ur,ug,ug,ub,cg,ug,ug,ug,ug,ub,ub,ub,ub,ub,ur
ur,ur,ur,ur,ur,ur,ug,ug,ug,ug,ub,ub,ub,ur,ug,ug,ug,ug,ub,ub,ub,ub,ur
ur,ur,ur,ug,ug,ug,ug,ur,ub,ub,ub,ug,ux,ur,ug,ug,ug,ug,cg,ug,ub,ub,ur
ux,ug,ux,ug,ux,ux,ux,ug,ux,ub,ub,ug,ug,ur,ub,ub,ug,ug,ug,ug,ub,ub,ur
ux,ug,ux,ug,ux,ux,ux,ug,ug,ug,ug,ux,ux,ub,ub,ub,ub,ub,ub,ub,ub,ub,ur
ur,ur,ur,ug,ur,ur,ur,ur,ur,ur,ug,ug,ug,ub,ub,ub,ur,ub,ub,ub,ub,ub,ur
ur,ug,ux,ug,ug,ux,ux,ux,ux,ux,ux,ux,ux,ub,cb,ub,ub,ub,ur,ub,ub,ub,ur
ur,ug,ux,ux,ug,ug,ug,ug,ug,ug,ug,ug,ug,ub,ub,ub,ub,ur,ur,ub,ub,ub,ur
ur,ur,ur,ur,ur,ur,ur,ur,cb,ur,ur,ur,ur,ur,ur,ur,ub,ur,ur,ur,ur,ur,ur
cb,ux,ux,ux,ux,ux,ux,ux,ub,ub,ub,ub,ub,ub,ub,ub,ub,ux,ux,ux,ux,cb,ur