ur,ur,ur,ux,ur,ur,ur,ur,ur,cg,ur,ur,ur,ur,cr,ub,ub,cb,ux,ub,ub,ub,ub
ur,ur,ur,ur,ur,ur,ur,ur,ur,cr,ug,ur,ur,ur,ur,cb,ub,ux,ux,ub,ub,ub,ux
ur,ub,cr,ub,cr,ur,ub,ur,ur,ur,ur,ur,ur,ur,ur,ur,ur,ug,ug,ug,ub,ub,ux
ur,ur,ur,ub,ur,ur,ub,ur,ur,ug,ur,ug,ug,ug,ub,ur,cr,ur,ub,ug,ub,ub,ux
ur,ub,ub,ub,ub,ur,ub,ub,ub,cb,ug,ug,ur,ug,ux,ug,ug,ug,ug,ug,ub,ub,ux
ub,ub,ub,ub,ur,ur,ux,ur,ur,ug,ur,ug,ug,ug,ux,ug,ug,ug,ug,ug,ug,ub,ux
ub,ub,ur,ur,ur,ug,ug,ug,ub,ub,ub,ub,ug,ux,ux,ux,ux,ux,ub,ux,ug,ug,ux
ur,ub,ur,ur,ur,ub,ub,ug,ub,ub,ub,ub,ug,ug,ug,ug,ug,ug,ug,ug,ub,cg,ur
ux,ub,ug,ug,ug,ub,cg,ug,ug,ub,ub,ub,ub,cb,ub,ub,ub,ug,ub,ug,ub,ub,ur
ur,ub,ub,ub,ug,ug,ug,ug,ub,ub,ub,ug,ub,ub,ub,ub,ub,ub,ub,ug,ub,ub,ur
ur,ug,ur,ub,ug,ug,ub,ug,ub,ub,ub,ug,ub,ug,ub,ub,ug,ub,ug,ug,ub,ub,ub
ux,ug,ux,ub,ux,ux,ub,ub,ub,ub,ub,cg,ug,ug,ug,ug,ug,ub,ug,ug,ug,ux,ub
ux,ug,ux,ub,ub,ub,ub,ub,ub,ub,ub,ub,ug,ug,ug,ug,ug,ub,ug,ug,ug,ux,ub
ux,ug,ug,ur,ub,ub,ux,ug,ux,ub,ug,ug,ug,ug,ug,ug,ug,cb,ub,ub,ug,ub,ub
ux,ux,ug,ur,ux,ux,ub,ub,ub,cg,ug,ug,ug,ug,ug,ug,ug,ub,ub,ub,ug,ux,ur
ux,ux,ug,ug,ux,ux,ub,ug,ux,ub,ug,ug,ug,ug,ug,ug,ug,ub,ug,ux,ug,ux,ur
ux,ux,ux,ug,ux,ux,ub,ub,ux,ux,ux,ub,ux,ug,ux,ug,ug,ub,ub,ub,cb,ux,ur
cr,ux,ux,ug,ux,ux,ux,ub,ub,ug,ug,ub,ux,ug,ug,ug,ug,ug,ub,ug,ug,ux,ur
ur,ux,ux,ug,ux,ug,ug,ug,ub,ug,ux,ub,ux,ug,ux,ug,ux,ux,ub,ug,ug,ux,ur
ur,ux,ux,ug,ux,ug,ux,ux,ub,ub,ub,ub,ux,ux,ux,ug,ux,ux,cg,ug,ug,ux,ur
ur,ur,ur,ur,ur,ur,ur,ur,ur,ur,ur,ur,ur,ur,ur,ur,ur,ur,ur,ur,ur,ur,ur
cr,ub,ub,ug,ux,ub,ub,ub,ub,ub,ub,ub,ub,ub,ub,ug,ux,ux,ux,ub,ub,ux,cb
cg,ub,ub,ug,ug,ug,ug,ug,ug,ug,ub,ub,cb,ub,ub,ur,ur,ur,ur,ub,ub,ug,ug