ur,cb,cb,cr,cr,ur,ur,ur,ux,cr,ub,cb,ug,ug,ug,ug,cg,ur,ur,ur,ur,ur,cb
ur,ur,cb,ur,ub,ub,ur,ur,ux,ur,ur,ur,ur,ur,ur,ur,ur,ur,ur,ur,ur,ur,ux
ur,ur,ur,ur,ur,cb,ur,ur,ur,ur,ur,ur,ur,ur,ur,ur,ug,ug,cr,ub,ub,ux,ux
ur,ur,ur,ur,ur,ur,ur,cr,ug,cb,ub,ur,ur,ur,ur,ur,ug,ur,ur,ur,ur,ux,ux
ur,ur,ur,ur,ur,ur,ug,ur,ur,ux,ub,ur,ur,ur,ur,ur,ug,ur,ur,ur,ur,ux,ux
ur,ur,ur,ur,ur,cg,ug,ug,ub,ub,ub,ug,ug,ug,ug,ug,ug,ug,ug,ug,ux,ux,ux
ur,ur,ur,ur,ur,ur,ur,ur,ub,ub,ub,ur,ug,ug,ug,ug,ug,ug,ug,ug,ug,ur,ur
cb,ur,ur,ur,ur,ur,ur,ux,ug,ub,ub,ug,ug,ug,ug,ug,ug,ug,ug,ug,ug,ur,ur
ur,ur,ur,ur,cr,ur,ug,ur,ug,ub,ub,ug,ug,ug,ur,ug,ur,ur,ur,ur,ur,ur,ur
ur,ur,ur,ub,ub,ur,ur,cg,ub,ub,ub,ub,ub,ug,ur,ug,ug,ug,ug,ug,ug,ux,ur
ur,ug,ur,ur,ug,ug,ug,ug,ub,ub,ux,ux,ug,ug,ug,ug,ug,ug,ug,ug,ug,ux,ur
ur,ur,ur,ur,ug,ug,ux,ub,ub,ux,ux,ux,ux,cg,ug,ug,ux,ug,ug,ug,ug,ux,ur
cb,ur,ur,ur,ur,ug,ug,ub,cb,ug,ug,ug,ug,ug,ug,ux,ux,ug,ux,ug,ug,ux,ur
ur,ur,ur,ur,ur,ux,ux,ux,ux,ux,ux,ux,ux,ug,ug,ug,ug,ug,ux,ug,ug,ux,ur
ur,ur,ur,ur,ug,ug,ux,ux,ux,ux,ux,ux,ux,ug,ug,ug,ug,ug,ug,ug,ug,ux,ur
ux,ux,ux,ux,ur,ug,ux,ux,ux,ux,ux,ub,ug,ug,ug,ug,ug,ug,ux,ux,ug,ux,ur
ux,ux,ux,ug,ug,ug,ux,ux,ux,ux,ux,ug,ug,ug,ug,ug,ug,cg,ux,ux,ug,cr,ur
ur,ux,ux,ug,ur,ux,ux,ug,ug,ug,ug,ug,ug,ug,ug,ug,ug,ug,ug,ug,ug,ur,ur
ur,ux,ux,ug,ug,ug,ub,ub,ub,ub,ux,ux,ug,ug,ug,ug,ug,ug,ux,ux,ux,ux,ur
cr,ug,ug,ub,ub,ub,cb,ug,ub,ub,ub,ub,ub,ug,ug,ug,ug,ug,ug,ub,ub,ub,cb
cg,ug,ug,ub,ub,ub,cg,ug,ub,ub,ug,ux,ux,ur,ur,ug,ug,ux,ux,ux,ux,ux,cr
cr,ub,ub,ub,ub,ub,ub,ug,ug,ug,ug,ux,ux,ur,ur,ux,ux,ux,ux,cb,cb,ux,cr
cg,ux,cg,cb,ux,ux,ux,ux,ux,ux,ux,ux,ux,ur,ur,cg,ux,ux,ux,cg,cg,ux,cr