ur,cb,cb,cr,ur,ur,ur,ur,ur,ur,ur,ur,ur,ur,ur,ur,ur,ur,ur,ub,ub,ux,cb
ur,cb,cb,ur,ur,ur,ur,ur,ur,ur,ur,ur,ur,ur,ur,ur,ub,ur,ub,ub,ub,ux,ux
ur,ur,ur,ur,ur,ur,ur,ur,ur,cr,ug,ur,ug,ur,ur,ur,ur,ur,ub,ub,ub,ux,ux
ur,ur,ur,ur,ur,ur,ur,ur,ur,ur,ur,ur,cr,cr,ur,ux,ub,ug,ub,ux,ux,ux,ux
ur,ur,ur,ug,ug,cr,cg,ur,ur,ur,ug,ur,ur,ug,ug,ur,ur,ur,ur,ur,ur,ur,ur
ur,ur,ur,ug,ug,ur,ug,ug,ur,cr,ug,ur,ur,ub,ug,ux,ub,ug,ux,ux,ux,ub,ur
ur,ur,ur,ur,ur,ur,ug,ug,ug,ur,ug,ur,ur,ub,cg,ux,ub,ub,ux,ux,ux,ub,ur
cb,ur,ur,ur,ug,ug,ug,ur,ug,ug,ug,ur,ur,ub,ub,ux,ug,ub,ux,ux,ux,ub,ur
ub,ur,ur,ug,ug,ug,ug,ux,ux,ux,ux,ur,ur,ub,ug,ug,cg,ug,ug,ug,ux,ub,ur
ub,ux,ur,ur,ux,ug,ug,ub,ub,ub,ub,ub,ub,ub,cb,ug,ug,ug,ux,ug,ux,ub,ur
ub,ux,ux,ux,ux,ug,ux,ux,ub,ub,ub,cb,ub,ub,ug,ug,ug,ug,ug,ug,ub,ub,ur
ub,ub,ub,ub,ux,ug,ux,ux,ub,ub,ub,ub,ur,ug,ub,ug,ug,ug,ug,ur,ur,ur,ur
cb,ux,ux,ub,ux,ug,ux,ux,ug,ub,ub,ub,ur,ub,ub,ux,cb,ub,ub,ub,ub,ub,cg
ux,ux,ux,ub,ux,ug,ux,ux,ug,ug,ug,ub,ur,ug,ub,ux,ub,ub,ub,ub,ub,ub,ub
ux,ux,ux,ub,ux,ug,ux,ux,ux,ug,ub,ub,ur,ug,ub,ux,ub,ub,ub,ub,ub,ub,ub
ux,ub,ub,ub,ub,ug,ux,ux,ub,ub,ub,ur,ur,ug,ub,ux,ub,ub,ub,ub,ux,ux,ux
ug,ub,ub,ub,ub,ug,ug,ug,ug,ug,ug,ug,ur,ug,ub,ug,ub,ug,ug,ux,ux,ux,cb
ug,ub,ub,ub,ug,ub,ug,ux,ux,ux,ug,ug,cr,ur,ub,ub,ub,ux,ug,ux,ux,ux,ux
ug,ub,ub,ub,ug,ub,ug,ug,ug,ug,ug,ur,ub,ur,ug,ux,ux,ug,ug,ux,ux,ux,ux
ug,cg,ug,ub,ug,ug,ug,ug,ug,ug,ug,cg,ug,ug,ug,ug,ug,ug,ux,ux,ux,ux,ux
cr,ug,cb,ub,ug,ug,ug,ug,ug,ug,ug,ug,ug,ug,ug,ux,ux,ux,ux,ux,ux,ux,cr
cg,ub,ub,ub,ug,ux,ux,ux,ux,ux,ux,ur,ug,ug,ug,ux,ux,ux,ux,cb,cb,ux,cr
cr,cg,cg,cb,ug,ug,ug,ug,ug,ug,ug,ug,ug,ug,ug,cg,ux,ux,ux,cg,cg,ux,cr