cb,cb,cb,cr,ur,ur,ur,ur,ur,ur,ur,ur,ur,ur,ur,ur,ur,ur,ur,ur,ur,ur,cb
ur,ur,ur,ur,ur,ur,ur,ur,ur,ub,ub,ub,ub,cr,ur,ur,ur,ur,ur,ub,cb,ub,ur
ur,ur,ur,ur,ur,ur,ur,ur,ur,cb,ur,ug,ur,ub,ub,ub,ur,ur,ub,ub,ub,ur,ur
ur,ur,ur,ur,ur,ur,ur,ur,cr,ux,ur,ug,ug,ur,ub,ub,ur,ur,ur,ub,ur,ur,ur
ur,ur,ur,ur,ur,ur,ur,ur,ug,ug,ur,ur,ug,ug,ub,ub,ub,ur,ub,ub,ur,ur,ur
ur,ug,cg,ur,ur,ug,ur,ur,ug,ug,ug,ug,ug,ug,ub,ug,ug,ur,ur,ub,ug,ub,ub
ur,cr,ur,ur,cr,ug,ug,ug,ug,ug,ur,ug,ug,ug,ub,ub,ux,ub,ub,ub,ug,ux,ub
cb,ur,ur,ur,ur,ug,ur,ug,ug,ug,ur,ug,ub,ug,ub,ug,ug,ub,ux,ux,ug,ux,ub
ur,ur,ur,ur,ur,ug,ug,ug,ur,cb,ub,ug,ug,ug,ub,ug,ug,ub,ux,ux,ug,ug,ub
ur,ur,ur,ur,ur,ur,ug,ug,ug,ug,cg,ub,ux,ug,ub,ub,ug,ux,ux,ux,ub,ug,ub
ur,ur,ur,ur,ur,ur,cg,cb,ug,ub,ub,ub,ug,ug,ug,ub,ub,ub,ub,ub,ub,ug,ub
ur,ur,ur,ur,ur,ur,ub,ug,ug,ug,ug,ub,ub,ub,ub,ub,ub,ub,ub,ub,ub,ug,ub
cb,ur,ur,ur,ur,ur,ub,ub,ub,ub,ug,ub,ub,ub,ub,ug,ub,ub,ub,ub,ub,ug,ub
ur,ur,ux,cr,ux,ur,ux,ub,ub,ub,ug,ug,ug,ug,ub,ub,ub,ux,ug,ug,ug,ug,ub
ur,ux,ux,ug,ug,ur,ub,ub,ub,ub,ug,ug,ub,ug,ub,ub,ub,ux,ug,ug,ug,ug,ub
ur,ur,ur,ux,ux,ur,ux,ub,ux,ub,ug,ug,ug,ug,ug,ux,ub,ub,ub,ub,ub,ug,ub
ux,ur,ur,ur,ur,ur,ux,ux,ux,ux,ug,ux,ux,ux,ux,ux,ux,ux,ug,ux,ux,ug,ub
cr,ux,ux,ux,ux,ub,ub,ub,ub,ub,ug,cg,ub,ub,ub,ub,ub,ub,ub,ub,ub,ug,ub
cg,ux,ux,ux,ux,ub,ux,ux,ux,ux,ux,ux,ux,ux,ux,ux,ux,ux,ux,ux,ux,ug,ub
cb,ux,ux,cr,ur,cb,ub,ub,ub,ub,ub,ub,ub,ub,ub,ub,cg,ug,ug,ug,ug,ug,ub
ux,ux,ux,ux,ux,ux,ux,ux,ux,ux,ux,ux,ux,ux,ux,ux,ux,ux,ux,ux,ux,ux,cr
cr,ux,ux,ux,ux,ux,ux,ux,ux,ux,ux,ux,ux,ux,ux,ux,ux,cb,cg,ux,cb,ux,cr
cg,cb,cg,cb,ux,ux,ux,ux,ux,ux,ux,ux,ux,ux,ux,cg,ux,ux,ux,cg,cg,ux,cr