ur,ur,cb,ur,ur,cr,ur,ur,ur,ur,ur,ur,ur,ur,ur,ur,ur,ur,ur,cg,ug,ug,ur
ur,ur,ur,ur,ub,cr,ur,ur,ur,ur,ur,ur,ur,cg,ur,ur,ur,ur,ur,ur,ur,ug,ug
ur,ur,ur,ur,cb,ur,ur,ur,ur,ur,ur,ur,ur,ug,ur,ur,ur,ur,ur,ur,ur,ur,ug
ur,ur,ur,ur,ug,ur,ur,ur,ur,ur,ur,ur,ur,ug,ug,ug,ug,ug,ug,ug,ug,ug,ug
ur,ur,ur,ur,cg,ug,ur,ur,ur,ur,ur,ug,ug,ub,ur,ur,ur,ur,ur,ur,ur,ur,ur
ur,ur,ur,ur,ur,ug,ug,ug,ug,ug,ug,ug,ug,ug,ub,ur,ur,ug,ug,ur,ur,ur,ur
ur,ur,ub,cr,ur,ug,ug,ug,ug,ug,ug,ug,ub,ug,ug,ug,ug,ug,ug,ur,ur,ur,ur
ub,ur,ur,ug,ug,ug,ug,ug,ug,ug,ux,ux,ub,ub,ub,ug,ur,ug,ug,ur,ur,ur,ur
ub,ur,ur,ug,ug,ub,ug,ug,ug,ug,ux,ux,ub,ub,ub,ug,ur,ug,cg,ur,ur,ur,ur
ub,ub,ux,ug,ug,ub,ug,ug,ug,ug,ug,ub,ub,ub,ub,cb,ur,ur,ur,ur,ur,ur,ur
cb,ub,ux,ub,ug,ub,ux,ug,ub,ub,ub,ub,ub,ub,ub,ub,ur,ur,ur,ur,ur,ur,ur
ux,ub,ux,ub,ug,ub,ug,ug,ub,ub,ub,ub,ub,ub,ub,ub,ug,cr,cr,cr,ur,ub,ur
ub,ub,ux,ub,ux,ub,ug,ug,ug,ug,ub,ub,ub,ug,ub,ub,ug,ux,ur,ub,cb,ub,ur
ub,ub,ub,ub,ux,ub,ug,ub,ub,ug,ug,ub,ub,ug,ub,ug,ug,ub,ur,ub,ux,ux,ur
ux,ux,ux,ux,ux,ub,ug,ub,ub,ug,ug,ug,ug,ub,ub,ug,ug,ub,ur,ub,ug,ux,ur
cg,ug,ug,ug,ug,ub,ug,ub,ub,ub,ub,ug,ub,ub,ub,ub,ub,ub,ur,ub,ug,ux,ur
ux,ug,ux,ux,ug,ug,ug,ub,cb,ub,ub,ug,ub,ub,ug,ug,ug,ug,ur,ub,ug,ux,ur
ux,ug,ux,ux,ug,ug,cb,ub,ub,ub,ug,ug,ug,ug,ug,ux,ug,ug,ur,ub,ux,ux,ur
ux,ug,ux,ux,ug,ug,ug,ub,ub,ub,ub,ub,ug,ub,ug,ug,ug,ux,ur,ub,ux,ux,ur
ux,ug,ux,ub,ug,ug,ub,ub,ub,ub,ub,ux,ux,ug,ug,ug,ux,ux,ur,ub,ux,ux,ur
cr,ug,ux,ug,ug,ug,ux,ux,cg,ub,ub,ur,ur,ug,ug,ug,ur,ur,ur,ur,ur,ur,ur
cg,ug,ux,cg,ug,ug,ux,ug,ug,ug,ug,ug,ug,ug,ur,ur,ur,ur,ur,ur,ux,cb,cr
cr,ug,ug,ub,ub,ub,ug,ug,ub,ub,ub,ur,ur,ur,ur,ur,ur,ur,ur,ur,cb,ux,cr