ur,cb,cb,cr,ur,cr,ur,ur,ur,ur,ux,ux,ur,ur,ur,ur,ur,ur,ur,ur,ur,cr,cb
ur,cb,cb,ux,ur,ur,ur,ur,ub,ur,ur,ux,ur,ur,ur,ur,ub,ur,ub,ub,ub,ur,ur
cr,ur,ur,ur,ur,ub,ub,ub,ub,ub,ur,ux,ur,ur,ur,ur,ur,ur,ur,ur,ub,ub,ub
ur,ur,ur,ur,ur,ub,ur,ur,ur,ub,ub,ub,ur,ur,ur,ur,ur,ug,ug,ug,ur,cb,ub
ur,ur,ur,ur,ur,ub,ur,ur,ug,ug,ug,ug,ug,ur,ux,ur,ur,cg,ur,ug,ur,ur,ur
ur,ur,ur,ur,ur,ub,ub,ub,cb,ur,ug,ur,ug,cg,ub,ur,cr,ur,ur,ur,ur,ub,ub
ur,ur,ur,ur,ur,ug,ug,ug,ur,ux,ug,ub,cr,ur,ur,ur,ur,ur,ur,ug,ur,ur,ub
cb,ux,ux,ug,ux,ur,ur,ug,ur,ug,ug,ub,ug,ug,ub,ub,ub,ur,ub,ub,ub,ub,ur
ux,ux,ux,ug,ux,ur,ur,ug,ur,ug,ug,ub,ub,ub,ub,ub,ub,ur,ub,ub,ub,ub,ur
ux,ux,ux,ug,ux,ux,ux,ug,ux,cg,ug,ub,ub,ub,cb,ub,ub,ur,ub,ub,ub,ub,ux
ux,ux,ux,ug,ux,ux,cg,ug,ug,ug,ug,cb,ub,ug,ub,ug,ur,ur,ub,ub,ub,ub,ux
ux,ug,ug,ug,ux,ux,ug,ug,ug,ug,ug,ub,ub,ub,ub,ug,ur,ur,ug,ug,ux,ux,ux
cb,ug,ug,ug,ug,ug,ug,ug,ug,ug,ug,ug,ug,ug,ug,ug,ur,ur,ux,ug,ux,ux,cg
ug,ug,ug,ug,ug,ug,ug,ug,ug,ug,ug,ug,ug,ug,ug,ug,ug,ur,ug,ug,ux,ux,ux
ug,ug,ug,ug,ug,ug,ug,ug,ug,ug,ug,ug,ug,ug,ug,ug,ug,ur,ux,ux,ux,ux,ux
ug,ug,ug,ug,ug,ug,ug,ug,ug,ug,ug,ug,ug,ug,ug,ug,ug,ur,ux,ux,ux,ux,ux
ug,ug,ug,ug,ug,ug,ug,ug,ug,ug,ug,ux,ux,ux,ug,ur,ur,ur,ux,cg,ux,ux,cb
ug,ug,ug,ug,ug,ug,ug,ug,ug,ug,ug,ug,ux,ug,ug,ug,ug,ur,ug,ug,ug,ug,ug
ug,ug,ug,ug,ug,ug,ug,ug,ug,ug,ux,ug,ub,ug,ub,ug,ug,ug,ug,ug,ux,cr,ug
ug,ug,ug,ug,ug,ug,ug,ug,ug,ux,ug,ug,ug,ug,ur,ug,ug,ur,ug,ug,ug,ur,ug
cr,ug,ug,ug,ux,ux,ux,ux,ug,ug,ug,ug,ub,ug,ug,ug,ug,ur,ur,ur,ur,ur,cr
cg,ug,ug,ug,ug,ug,ug,ug,ug,ug,ub,ub,ub,ug,ug,ug,ug,ur,ur,cb,cb,ur,cr
cr,cg,cg,cb,ux,ux,ux,ux,ux,ug,ug,ug,ug,ug,ux,cg,ur,ur,ur,cg,cg,ur,cr