ur,ur,ur,cr,ur,ug,ug,ug,ug,ug,ug,cg,ur,ur,ur,ur,ux,cb,ur,ur,ur,ur,ur
ur,ur,ur,ug,ur,ug,ur,ur,ur,ur,ur,ur,ur,ur,ub,ur,ux,ux,ur,ur,ur,ur,ur
ub,ur,ub,ug,ug,ug,ug,ur,ur,cr,ur,ur,ur,ur,ur,ur,ub,ur,ur,ur,ur,ur,ur
ub,ux,ub,ug,ub,ug,ug,ug,ug,cr,ur,ur,ug,ug,ug,ug,ug,ug,cg,ur,ur,ux,ur
ub,ub,ub,ug,ug,ug,ug,ug,ur,ug,ur,ug,ug,cr,ur,ur,ur,cr,ux,ur,ur,ur,ur
ug,ur,ub,ub,ub,ug,ux,ux,ug,ug,ug,ug,ur,ur,ur,ur,ur,ur,ur,ur,ug,ux,ux
ug,ux,ug,ux,ub,ub,ux,ux,ug,ux,ux,ur,ur,ux,ub,ug,ug,ux,ur,ux,ug,ux,ux
ub,ub,ub,ub,ub,ub,ug,ug,ug,ux,ux,ux,ur,ur,ug,ub,ub,ub,ub,ux,ug,ux,ux
ub,ub,cb,ug,ug,ug,ug,ux,ux,ux,ux,ux,ub,ub,ug,ub,cb,ub,ub,ux,ug,ux,ux
ug,ug,ux,ux,ux,ux,ug,ug,ug,ub,ux,ub,ub,ub,cb,ub,ug,ub,ub,ux,ug,ug,ux
ux,ug,ux,ux,ux,ux,ub,ub,ug,ug,ub,ub,ub,ub,ug,ub,cg,ub,ux,ux,ux,ug,ux
ux,ug,ux,ux,ug,ug,ug,ug,ug,ug,ug,ub,ub,ub,ug,ug,ug,ub,ub,ub,ub,ug,ux
ux,ug,ux,ux,ug,ug,ug,ux,ur,ur,ug,ub,ub,ug,ug,ug,ug,ub,ub,ub,ub,ur,ur
ux,ug,ux,ux,ug,ug,ug,ug,ug,ug,ug,ux,ub,ug,ug,ug,ug,ub,ub,ub,cr,ur,ur
cg,ug,ux,ux,ug,ug,ug,ug,ub,ub,ub,ub,ub,ug,ug,ub,ub,ub,ub,cb,ub,ur,ur
ub,ub,ub,ug,ug,ug,ug,ug,ug,ug,ug,ug,ur,ug,ug,ub,ug,ux,ub,ub,ub,ur,ur
ub,ub,ub,ug,ug,ug,ug,ug,ug,ub,ub,cb,ur,ub,ug,ug,ug,ux,ux,ux,ux,ur,ur
ub,ub,ux,ug,ug,ub,ug,ug,ug,ux,ux,ub,ur,ux,ux,ux,ux,ux,ux,ux,ux,ur,ur
ub,ub,ux,ug,ub,ub,ub,ub,ub,ub,ub,ub,ur,ub,ux,ux,ux,ux,ux,ux,ux,ur,ur
ub,ub,ub,ug,ug,ug,ug,ug,cg,ux,ux,ux,ur,ur,ur,ur,ur,ur,ur,ur,ur,ur,ur
ub,ub,ub,ub,ub,ur,ur,ur,ur,ur,ur,ur,ur,ur,ur,ur,ur,ur,ur,ur,ur,ur,ur
cr,ux,ux,ux,ux,ux,ux,ux,ur,ux,ux,ux,ux,ux,ux,ux,ux,ux,ux,ux,ux,ux,cb
cg,ux,ux,ux,ux,ux,ux,ux,ux,cg,ux,ux,ux,ux,ux,ux,ux,ux,ux,ux,ux,ux,cb