cr,ur,cb,ur,ur,ur,ur,ur,ur,ur,ur,cb,ub,cr,ur,ur,ur,ur,ux,cg,ux,ur,cg
ug,ur,ur,ur,ur,ur,ub,ub,ur,cr,ur,ur,ur,ur,ur,ur,ur,ur,ur,ur,ur,ur,ug
ug,ug,cg,ub,ur,cg,ur,ur,ur,ur,ug,ur,cr,ug,ur,ur,ur,ug,ug,ux,ur,ux,ug
ub,ub,ub,ub,ur,ug,ur,ur,ur,ur,ur,ur,ug,ug,ux,ur,ug,ur,ug,ux,ur,ur,ug
ur,ub,cb,ub,ur,ug,ux,ug,ug,ug,ug,ug,ug,ug,ug,ug,ug,ug,ug,ux,ur,ub,ug
ur,ur,ur,ub,ub,ug,ub,ug,ub,ub,ub,ux,ux,ug,ur,ur,ur,ur,ur,ur,ur,ur,ur
ur,ur,ur,ur,ur,ug,ug,ug,ug,ub,ub,ug,ug,ug,ug,ug,ug,ur,ub,ub,ur,ub,ur
ur,ur,ur,ur,ur,ur,ug,ux,ug,ub,ub,ug,ub,ub,ub,ux,ux,ur,ug,ub,ur,ub,ur
ur,ur,ur,ur,ur,cr,ug,ug,ug,ug,ub,ub,ub,ub,ub,ub,ub,ur,ug,ub,ur,ub,cr
ux,ux,ux,ug,ug,ur,ur,ux,ub,ub,cb,ub,ub,ub,ub,ug,ug,ur,ug,ug,ur,ug,ug
ux,ux,ux,cb,ub,ub,ub,ub,ub,ub,ub,ub,ub,ub,cg,ug,cb,ub,ub,ub,ur,ub,ub
ux,ux,ux,ug,ug,ug,ub,ub,ub,ug,ug,ub,ub,ub,ub,ub,ub,ub,ug,ug,ur,ub,ux
ux,ux,ux,ug,ug,ug,ub,ub,ub,ux,ug,ug,ub,ub,ub,ux,ub,ub,ug,ug,ur,ub,ux
ux,ux,ug,ug,ug,ug,ub,ux,ux,ug,ug,ug,ub,ub,ux,ux,ub,ub,ug,ug,ur,ub,ux
ux,ug,ug,ub,ub,ub,ub,ux,ux,ux,ug,ug,ug,ub,ub,ux,ux,ub,ub,ug,ur,ub,ux
cg,ug,ug,ug,ug,ub,ux,ux,ux,ux,ux,ug,ug,ux,ub,ub,ub,ub,ub,ux,ur,ub,ux
ux,ug,ug,ux,ug,ug,ug,ug,ux,ux,ux,ux,ux,ub,ub,ub,ub,ur,ub,ux,ur,ub,ux
ux,ug,ug,ug,ug,ux,ux,ug,ug,ub,ub,ub,ub,ub,ux,ux,ux,ur,ux,ux,ur,ub,ub
ux,ug,ug,ug,ug,cg,ux,ug,ug,ub,ux,ux,ub,ux,ux,ux,ux,ur,ux,ux,ur,ub,ub
ux,ug,ug,ug,ug,ug,ug,ug,cb,ub,ux,ux,ux,ux,ux,ux,ux,ur,ux,ux,ur,ub,ub
cr,ug,ug,ug,ug,ug,ug,ug,ug,ub,ux,ux,ux,ux,ux,ux,ux,ur,ux,ur,ur,ub,ub
cg,ug,ug,ug,ug,ug,ug,ug,ub,ub,ux,ux,ux,ux,ux,ux,ux,ur,ur,ur,ux,cb,cr
cr,ug,ug,ug,ug,ug,ug,ux,ux,ux,ux,ux,ux,ux,ux,ux,ux,ux,ur,ur,cb,ux,cr