ur,ur,ur,ur,ur,ur,ub,ux,ur,ur,ur,ur,ur,ur,ur,ux,ux,cg,ux,cg,ur,ur,ur
ur,cr,cr,ur,ur,ur,ur,ur,ur,ur,ur,ur,ur,cr,ur,ur,ur,ug,ux,ux,ur,ur,ur
cb,ub,ur,ur,ur,ur,ur,ur,ur,ur,ur,ur,ur,ur,ur,ur,ux,ug,ug,ux,ur,ur,ur
ub,ub,ur,ub,ur,ur,ur,ur,ur,ur,ur,ur,ur,ur,ur,ug,ug,ug,ug,ur,ur,ug,ur
ur,ur,ur,ub,ur,ur,ur,ur,ug,ug,ug,ug,ug,ug,ug,ug,ur,ug,ug,ur,ug,ug,ug
ur,ub,cr,ur,ur,ug,ug,ur,ug,ur,ur,ug,ug,ug,ug,ur,ur,cg,ug,ux,ux,ur,ug
ur,ur,ur,ur,ur,ug,ug,ub,cb,ug,ug,ug,ug,ug,ug,ux,ur,ur,ug,ux,ux,ur,ug
ur,ur,ur,ur,ur,ug,ug,ub,ub,ug,ug,ug,ug,ub,ux,ux,ux,ux,ug,ux,ub,ur,ug
ur,ur,ur,ur,ur,ug,ug,ug,ub,ug,ub,ub,cb,ub,ux,ux,ux,ux,ug,ug,ub,ur,ug
ub,ur,ur,ur,ur,ug,ug,ug,ub,ug,ub,ub,ub,ub,ub,ub,ub,ub,ub,ug,ug,ug,ug
ub,ub,ub,cr,ub,ug,ug,ug,ub,ug,ub,ub,ub,ub,ub,ub,ub,ug,ug,ux,ux,ug,ug
ub,ux,ub,ub,ub,cg,ug,ux,ub,ub,cb,ub,ub,ub,ug,ug,ug,ug,ug,ug,ux,ug,ug
ub,ur,ur,ur,ur,ur,ug,ur,ub,cb,ub,ub,ub,ub,ug,ug,ug,cg,ug,ug,ur,ug,ug
ub,ub,ub,ub,ub,ub,ug,ub,ub,ub,ug,ug,ug,ub,ug,ug,ug,ug,ug,ug,ug,ug,ug
ur,ux,ub,ux,ug,ub,ug,ub,ub,ub,ug,ub,ug,ub,ub,ug,ug,ug,ug,ug,ub,ug,ug
ur,ux,ub,ux,ug,ub,ug,ub,cg,ug,ug,ub,ug,ub,ub,ub,ug,ug,ug,ug,ub,ug,ug
ur,ur,ub,ur,ub,ub,ub,ub,ub,ub,ug,ug,ug,ug,ur,ur,ur,ur,ur,ur,ur,ur,ur
cg,ux,ub,ux,ub,ux,ub,ub,ub,ub,ub,ug,ug,ug,ug,ub,ug,ug,ug,ux,ug,ub,ur
ux,ux,ub,ux,ub,ug,ub,ub,ub,ub,ub,ug,ug,ug,ug,ub,ug,ug,ug,ux,ux,ug,ur
ux,ux,ub,ub,ub,ug,ub,ub,ub,ub,ub,ug,ux,ug,ug,ub,ux,ug,ux,ug,ug,ug,ur
cr,ux,cb,ub,cb,ug,ub,ub,ub,cr,ur,ur,ur,ur,ur,ur,ur,ur,ur,ur,ur,ur,ur
cg,ux,ug,ub,ub,ux,ub,ub,ub,ub,ug,ug,ux,ux,ux,ux,ux,ux,ug,ux,ux,cb,cr
cr,ux,ug,ub,ub,ug,ub,ub,ub,ub,ux,ug,ug,ug,ug,ug,ug,ug,ug,ux,cb,ux,cr