ur,ur,ur,ur,ur,ur,ur,ur,ur,ur,ur,ur,ub,cr,ur,ur,ur,ur,ur,ur,ur,ur,ur
ur,ur,ur,ub,cb,ur,ur,ur,ur,ur,ur,ub,cb,ur,ur,ur,ur,ur,ur,ur,ur,ur,ur
ur,ur,ur,cr,ur,ur,ur,ur,ur,ur,ur,ub,ux,ux,ux,ub,ub,ub,ug,ux,ux,ur,ur
ur,ur,ux,ux,ur,ur,ux,cr,ur,ur,ub,ub,ub,ub,ub,ub,ux,ub,ug,ux,ux,ur,ur
ur,ur,cr,cg,ug,ur,ux,ur,ur,ur,ub,ub,ub,ub,ug,ug,ub,ub,ug,ux,ux,ur,ur
ur,ur,ur,ur,ug,ug,ug,ur,ur,ur,ug,ub,ub,ub,ub,ug,ux,ub,ug,ux,ux,ur,ur
ur,ur,ur,ur,ug,ug,ur,ur,ug,ug,ub,ub,ub,ub,ux,ug,ux,ub,ug,ux,ux,ur,ur
ur,ur,ur,ur,ug,ug,ug,ur,ur,ug,ub,ub,ub,ub,ux,ug,ub,ub,ug,ux,ux,ur,ur
ur,ur,ur,ur,ug,ug,ug,ur,ug,ug,ub,ub,ub,ub,ub,ug,ux,ux,ug,ux,ux,ur,ur
ur,ur,ur,ur,ug,ub,ub,ur,ug,ug,ub,ub,ub,ub,ub,ub,ux,ux,ug,ux,ux,ur,ur
cg,ur,ur,ur,ug,ub,ub,ub,ub,cb,ub,ub,ub,ub,ub,ub,ux,ux,ug,ux,ux,ur,cr
ur,ur,ur,ur,cb,ub,ug,ug,ub,ub,ug,ug,ur,ur,ur,ur,ur,ur,ug,ur,ur,ur,ur
ur,ur,ur,ur,ur,ur,ur,ug,ug,ub,ub,ub,ub,ub,ux,ux,ux,ux,ug,ux,ur,ux,ur
ur,ur,ur,ur,ur,ur,ur,ub,ug,ub,ux,ub,ub,ub,ux,ux,ux,ux,ug,ux,ur,ux,ur
ur,ur,ur,ur,ur,ur,ur,cr,cg,ub,ub,ub,ub,ub,ux,ux,ux,ux,ug,ux,ur,ux,ur
ur,ur,ur,ur,ur,ux,ux,ux,ur,ux,ux,ux,ux,ux,ux,ux,ux,ux,ug,ux,ur,ux,ur
ur,ur,ur,ur,ur,ux,ux,ux,ur,ux,ux,ux,ux,ux,ux,ux,ux,ux,ug,ux,ur,ux,ur
ur,ur,ur,ur,ur,ug,ug,ug,ur,ug,ug,ug,ug,ug,ug,ug,ug,ug,ug,ux,ur,ur,ur
ur,ur,ur,ur,ub,ub,ub,ub,ub,ub,ub,ub,ub,ub,ub,ub,ub,ub,ub,ux,ur,ur,ux
ur,ur,ur,ux,ux,ux,ux,ux,ur,ux,ux,ux,ux,ux,ux,ux,ux,ux,ub,ub,ur,ur,ur
ur,ur,ur,ux,ux,ux,ux,ux,ur,ux,ux,ux,ux,ux,ux,ux,ux,ux,ux,ub,cb,ur,ur
ur,ur,ur,ur,ur,ur,ur,ur,ur,ur,ur,ur,ur,ur,ur,ur,ur,ur,ur,ur,ur,ur,ur
ux,ux,ux,ux,ux,ux,ux,cg,ur,ur,ur,ur,ur,ur,ur,ur,ur,ur,ur,ur,ur,cb,ur