ur,ur,ur,ur,ur,ur,ur,ur,ub,cr,cr,ur,ur,ur,ur,ur,ur,ur,ur,ur,ur,ur,ur
ur,ur,ur,ur,cg,ug,ur,ur,cb,ur,ur,ur,ur,ur,ur,ur,ur,ur,ur,ur,cr,ub,cr
ur,ur,ur,ug,ug,ug,ur,ur,ur,ur,ur,ur,ur,cg,ur,ur,ur,ur,ur,ur,ub,ur,ux
ur,ur,ug,ug,ug,ug,ur,ur,ur,ur,ug,ug,ug,ug,ur,ur,ur,ur,ur,ur,ub,ur,cb
ux,ur,ug,ug,ug,ur,ur,ur,ur,ur,ur,ur,ug,ug,ug,ug,ug,ug,ug,cb,ub,ug,ug
ux,ur,ux,ug,ur,ur,ur,ur,ur,ur,ur,ur,ur,ur,ur,ur,ur,ur,ug,ur,ux,ur,ug
ur,ur,ur,ug,ug,ug,ur,ub,cr,ur,ur,ur,ur,ur,ur,ur,ur,ur,ux,ux,ux,ux,ug
ur,ur,ux,ug,ug,ug,ur,ub,ub,ub,ur,ur,ub,ur,ur,ur,ur,ur,ux,ux,ux,ux,ug
cg,ux,ux,ug,ug,ug,ur,ub,ub,ub,ug,ug,ub,ur,cg,ug,ug,ug,ux,ux,ux,ux,ug
ux,ux,ux,ug,ug,ug,ur,ug,ub,cb,ub,ug,ug,ug,ug,ug,ug,ug,ux,ux,ux,ux,ug
ux,ux,ux,ug,ug,ug,ur,ub,ub,ur,ug,ug,ub,ug,ug,ug,ug,ug,ur,ux,ux,ux,ug
ux,ux,ux,ug,ug,ug,ug,ub,cb,cr,ux,ub,ub,ub,ug,ug,ug,ug,ur,ur,ur,ur,ug
ux,ux,ux,ug,ug,ux,ug,ux,ub,ub,ub,ub,ub,ub,ub,ub,ub,ub,ub,ub,ub,ub,ug
ux,ux,ux,ux,ux,ux,ug,ux,ub,ug,ug,ub,cb,ub,ub,ub,ub,ub,ub,ux,ux,ux,ug
cg,ux,ux,ux,ux,ux,ug,ux,ub,ug,ug,ug,ug,ub,ub,ub,ub,ub,ub,ux,ux,ux,ug
ux,ux,ux,ux,ux,ux,ug,ug,ub,ux,ug,ug,ub,ub,ub,ub,ub,ux,ux,ux,ux,ux,ug
ux,ux,ux,ux,ux,ux,ux,ux,ub,ux,ux,ux,ub,ub,ub,ug,ub,ub,ub,ub,ux,ux,ug
ux,ux,ux,ux,ux,ux,ux,ux,ub,ux,ub,ub,ub,ux,ub,ug,ub,ub,ux,ux,ux,ux,ug
ux,ux,ux,ux,ux,ux,ux,ux,ub,ub,ub,ux,ux,ux,ub,ug,ug,ub,ux,ux,ux,ux,ug
ux,ux,ux,ux,ux,ux,ux,ux,ub,ux,ux,ux,ux,ux,ux,ug,ux,ux,ux,ux,ux,ux,ug
ub,ub,ub,ub,ub,ub,ub,ub,ub,ub,ub,ub,ub,ub,ub,ug,ug,ug,ug,ug,ug,ug,ug
ub,ux,ux,ux,ux,ux,ux,ux,ub,ux,ug,ug,ug,ug,ug,ug,ux,ux,ux,ux,ux,ux,cb
ub,ub,ub,ub,ub,ub,ub,ub,ub,cg,ux,ux,ux,ux,ux,ux,ux,ux,ux,ux,ux,ux,ux