ur,cb,cb,cr,ur,ur,ur,ur,ur,ur,ur,ur,ur,ur,ur,ur,ur,ur,ur,ur,ur,ur,cb
ur,cb,cb,ur,ur,ur,ur,ur,ur,ur,ug,ug,ug,ug,ug,ug,ug,ug,cg,ur,ur,ur,ur
ur,ur,ur,ur,ur,ur,ur,ur,ur,ur,ug,ur,ur,ub,ug,ub,cr,ur,ur,ur,ur,ub,ur
cr,ur,ub,ub,cb,ur,ur,ug,ug,ug,ug,ur,ub,ug,ug,ur,cr,ur,ur,ur,ur,ub,ur
ug,ug,cr,ur,ur,ur,ur,ug,ur,ux,ub,ub,ur,ug,ub,ug,ug,ug,ug,ug,ub,ub,ur
ug,ug,cg,ub,ub,ub,ub,ug,ub,ub,ub,ug,ug,ug,ur,ug,ug,ug,ub,ug,ub,ux,ur
ug,ug,ug,ug,ur,ug,ug,ug,ur,ur,ux,ux,ur,ub,ur,ug,ug,ug,ub,ug,ub,ub,ur
cb,ur,ur,ur,cr,ur,ug,ur,ur,ur,ur,ur,ur,ug,ur,ug,ug,ug,ub,ug,ub,ub,ur
ug,ug,ug,ug,ug,ur,ur,ur,ur,ur,ux,ux,ug,ug,ur,ug,ug,ug,ug,ug,ub,ux,cr
ug,ug,ug,ug,ug,ur,ur,ug,ur,ug,ug,ug,ug,ug,ur,ur,ug,ug,ug,ug,cb,ux,ub
ux,ur,ur,ur,ug,ur,ur,ug,ux,ug,ug,ux,ux,ur,ur,ub,ux,ug,ug,ug,ug,ux,ub
ux,ux,ug,ug,ug,ug,ub,ug,ux,ug,ug,ug,ux,ur,cg,ug,ug,ug,ug,ug,ug,ub,ub
cb,ug,ug,ub,ub,ug,ub,ug,ug,ug,ux,ug,ux,ub,ub,ug,ug,ug,ug,ux,ux,ux,cg
cb,ug,ug,ug,ub,ug,ug,ug,ug,ux,ux,ub,ub,ub,ub,ub,ub,ub,ub,ux,ux,ux,ux
ux,ug,ug,ug,ub,ux,ux,ub,ug,ug,ug,ub,ub,ub,ub,ux,ub,ub,ub,ux,ub,ub,ux
ux,ux,ux,ux,ub,ux,ug,ug,ub,ub,ub,ub,ub,ub,ub,ub,ub,ub,ub,ux,ub,ub,ux
ux,ux,ux,ux,ug,ug,ub,ub,ug,ug,ug,ug,ug,ug,ub,ub,ub,ub,ub,ub,ub,ub,cb
ux,ux,ux,ux,ub,ub,ug,ug,ug,ux,ux,ux,ux,ug,ug,ug,ug,ug,ug,ug,ug,ub,ux
ux,ux,ux,ux,ub,cg,ug,ug,ug,ug,ux,ux,ux,ug,ug,ug,ug,ug,ug,ug,ug,ux,ux
ux,ub,ub,ub,ug,ug,ub,ux,ux,ug,ug,ug,ug,ug,cg,ub,ub,ux,ux,ux,ux,ux,ux
cr,ub,ub,ub,cb,ux,ub,ux,ux,ux,ux,ux,ux,ub,ub,ub,ub,ux,ux,ux,ux,ux,cr
cg,ub,ub,ub,ub,ux,ub,ux,ux,ux,ux,ux,ux,ub,ub,ux,ux,ux,ux,cb,cb,ux,cr
cr,cg,cg,cb,ub,ub,ub,ux,ux,ux,ux,ux,ux,ub,ub,cg,ux,ux,ux,cg,cg,ux,cr