ur,ur,ur,ub,ub,ub,cb,ur,ur,ur,ur,ur,ur,ur,ur,ur,ur,ur,ur,ur,ur,ur,ur
ur,ur,ur,ub,ur,ur,ur,ur,ur,ur,ur,ur,ur,ur,ur,ur,ur,ur,ur,ur,ur,ur,ur
ur,ur,ur,cr,ur,ur,ur,ur,ur,ur,ur,ur,ur,ur,ur,ur,ur,ur,ur,ur,ur,ur,ur
ux,ur,ur,ug,ug,ug,ur,ur,ur,ur,ur,ug,ug,ub,ug,ur,cb,ub,ub,cr,ur,ur,ur
ux,ur,ur,ug,ug,ug,ur,ur,ur,ur,ug,ug,ux,ub,ub,cr,ur,ux,ux,ub,ug,ug,ur
ur,ur,ur,ug,ur,ug,ug,ug,ug,ug,ug,ug,ug,ug,ug,ug,ub,ur,ur,ub,ug,ur,ur
ur,cr,ur,ug,ug,ug,ug,ug,ug,ug,ub,ub,ub,ug,ur,ug,ug,ur,ur,ug,ug,ur,ur
ur,ub,ur,ug,ux,ux,ug,ug,ur,ug,ug,ug,ug,ug,ur,ur,ug,ug,ug,ug,ur,ur,ur
cg,ub,cb,ug,ux,ux,ug,ug,ug,ug,ug,cg,ug,ug,ur,ur,ur,ur,ur,ur,ur,ur,ur
ub,ub,ub,cb,ub,ub,ug,ug,ug,ug,ub,ub,ub,ur,ur,ur,ur,ur,ur,ur,ur,ur,ur
ub,ub,ub,ub,ub,ub,ug,ug,ug,ub,ub,ub,cb,ub,ub,ur,ur,ur,ur,ur,ur,ur,ur
ux,ub,ub,ub,ub,ub,ug,ug,ug,ub,cb,ub,ub,ur,ur,ur,ur,ur,ug,ug,cr,ur,ux
ux,ub,ub,ub,ub,ux,ug,ug,ug,ub,ub,ub,ub,ub,ub,ug,ug,ug,ug,ug,ug,ux,ux
ux,ub,ub,ug,ux,ux,ug,ug,ug,ub,ub,ub,ug,ux,ux,ug,ug,ug,ug,ug,ux,ux,ux
cg,ux,ux,ug,ux,ux,ug,ug,ug,ub,ub,ux,ug,ux,ug,ug,ug,ux,ux,ug,ux,ux,ux
ux,ux,ux,ug,ux,ux,ug,ug,ug,ux,ux,ux,ug,ug,ug,ug,ug,ug,ug,ug,ux,ux,ux
ux,ux,ux,ug,ux,ux,ug,ug,ug,ux,ux,ux,ux,ux,ux,ux,ux,ux,ux,ux,ux,ux,ux
ux,ux,ux,ug,ux,ux,ug,ug,ug,ux,ux,ux,ux,ux,ux,ux,ux,ux,ux,ux,ux,ux,ux
ux,ux,ux,cg,ux,ux,ux,ux,cg,ux,ux,ux,ux,ux,ux,ux,ux,ux,ux,ux,ux,ux,ux
ux,ux,ux,ux,ux,ux,ux,ux,ur,ux,ux,ux,ux,ux,ux,ux,ux,ux,ux,ux,ux,ux,ux
cr,ux,ux,ux,ux,ux,ux,ux,ur,ux,ux,ux,ux,ux,ux,ux,ux,ux,ux,ux,ux,ux,ux
ur,ux,ux,ux,ux,ux,ux,ux,ur,ux,ux,ux,ux,ux,ux,ux,ux,ux,ux,ux,ux,ux,cb
ur,ur,ur,ur,ur,ur,ur,ur,ur,cg,ux,ux,ux,ux,ux,ux,ux,ux,ux,ux,ux,ux,ux