ub,ub,cb,ur,ub,ub,ub,cr,ur,ur,ur,ur,ur,ur,ug,ug,ug,ug,ur,cg,ur,ux,ux
ub,ub,ub,ub,ub,ug,ug,cr,ur,ur,ur,ur,cr,ur,ug,ux,cr,ur,ur,ux,ur,ug,ug
ub,ur,ur,ur,ur,ug,cg,ub,ur,ur,ur,ur,ur,ur,ug,ug,ug,ug,ug,ur,ur,ur,ug
ub,ux,ur,ur,ur,ug,ug,ub,ub,cb,ur,ur,ur,ur,ux,ux,ux,ux,cg,ux,cb,ug,ug
ub,ux,ur,ur,ur,ur,ur,ur,ur,ur,ur,ur,ur,ur,ug,ug,ux,ux,ub,ub,ub,ur,ur
ub,ur,ur,ur,ur,ur,ur,ub,ur,ur,ur,ur,ur,ur,ur,ug,ux,ur,ub,ub,ub,ub,ub
ub,ur,ur,ur,ur,ur,ur,cr,ur,ur,ur,ur,ux,ug,ug,ug,ug,ur,ub,ub,ur,ux,ub
ub,ur,ur,ub,ur,ur,ur,ur,ur,ur,ur,ug,ux,ug,ug,ug,ug,ug,ub,ub,ur,ux,ub
ub,ux,ur,ub,ub,ub,ub,ur,ur,ur,ug,ux,ux,ug,ug,ug,ug,ug,ub,ub,ub,ub,ub
ub,ux,ub,ux,ux,ub,ub,ub,ug,ug,ug,ux,ub,ub,ub,ub,ux,ug,ub,ub,ub,ux,ux
ub,ux,ub,ux,ux,ub,cb,ug,ug,ug,ug,cg,ub,ub,ub,ug,ug,ug,ub,ub,ub,ux,cb
ub,ux,cg,ux,ux,ub,ug,ug,ug,ux,ub,ub,ub,ub,ub,ub,ug,ug,ub,ub,ub,ug,ug
ub,ux,ug,ug,ug,ug,ug,ug,ug,ux,ug,ub,ub,ug,ub,ub,ug,ug,ub,ub,ub,ub,ub
ub,ux,ub,ug,ug,ug,ug,ug,ug,ub,ub,ub,ub,ug,ug,ug,ug,ug,ub,ub,ux,ux,ub
ub,ub,ub,ug,ug,ug,ug,ug,ub,ub,ub,ub,ug,ug,ug,ux,ux,ug,ub,ub,ux,ux,ub
cg,ux,ug,ug,ug,ug,ug,ug,cb,ux,ux,ux,ug,ux,ux,ux,ux,ug,ug,ur,ur,ur,ur
ux,ux,ub,ug,ug,ug,ug,ug,ug,ux,ux,ux,ug,ug,ug,ux,ux,ug,ug,ur,ux,ux,ur
ux,ux,ug,ug,ug,ug,ug,ug,ub,ub,ub,ux,ux,ux,ug,ux,ux,ug,ur,ur,ur,ur,ur
ux,ux,ug,ug,ug,ug,ug,ug,ug,ug,ug,ug,ug,ug,ug,ug,ug,ug,ug,ur,ub,ub,ur
ux,ug,ug,ug,ug,ug,ug,ug,ug,ug,ug,ug,ug,ug,ug,ux,ux,ux,ur,ur,ur,ur,ur
cr,ug,ug,ug,ug,ug,ug,ug,ug,ur,ur,ur,ur,ur,ur,ur,ur,cg,ug,ur,ub,ur,ur
cg,ug,ug,ug,ug,ug,ub,ub,ub,cr,ug,ug,ug,ug,ug,ug,ug,ug,ug,ur,ux,cb,cr
cr,ug,ug,ug,ug,ug,ub,ub,cb,ub,ub,ur,ur,ur,ur,ur,ur,ur,ur,ur,cb,ux,cr