cr,ur,ur,ur,ur,ur,ur,ur,ur,ur,ur,ur,ur,ur,ur,ur,ur,ur,ur,ur,ur,cr,ur
ub,ur,ur,ur,ur,ur,ur,ur,ur,ur,ur,ur,ur,ur,ur,ur,ur,ur,ur,ur,ur,ub,ur
ub,ub,ub,cb,ur,ur,ur,ur,ur,ur,ur,ur,ur,ur,ur,ur,ur,ur,ur,ur,cb,ub,ur
ux,ur,ur,ug,ug,ug,ur,ur,ur,ur,ur,ug,ug,ub,ug,ur,ug,ug,ux,cr,ur,ur,ur
ux,ur,ur,ug,ug,ug,ur,ur,ur,ur,ug,ug,ux,ub,ub,ub,ub,ux,ux,ub,ug,ug,ur
ur,ur,ur,ug,ur,ug,ug,ug,ug,ug,ug,ug,ug,ug,ug,ug,ub,ur,ur,ub,ug,ur,ur
ur,ur,ur,ug,ug,ug,ug,ug,ug,ug,ub,ub,ub,ug,ur,ug,ug,ur,ur,ug,ug,ur,ur
ur,cr,cb,ug,ux,ux,ug,ug,ur,ug,ug,ug,ug,ug,ur,ur,ug,ug,ug,ug,ur,ur,ur
cg,ux,ub,ug,ux,ux,cg,ug,ur,ug,ub,ub,ug,ug,ur,ur,ur,ur,ur,ur,ur,ur,ur
ub,ub,ub,ug,ub,ub,ug,ug,ug,ug,ub,ub,ub,ur,ur,ur,ur,ur,ur,ur,ur,cr,ux
ub,ub,ub,ug,ub,ub,ug,ug,ug,ub,ub,ub,ub,cb,ub,ur,ur,ur,ur,ur,ur,ux,ux
ux,ub,cb,ug,ub,ub,ug,ug,ug,ub,ub,ub,ub,ur,ur,ur,ur,ur,ug,ug,ug,ux,ux
ux,ub,ux,ug,ub,ux,ug,ug,ug,ub,ub,ub,ub,ub,ub,ug,ug,ug,ug,ug,ug,ux,ux
ux,ub,ub,cg,ux,ux,ug,ug,cg,ux,ub,ub,ug,ux,ux,ug,ug,ug,ug,ug,ux,ux,ux
cg,ux,ux,ux,ux,ux,ug,ug,ur,ux,cb,ux,ug,ux,ug,ug,ug,ux,ux,ug,ux,ux,ux
ux,ux,ux,ux,ux,ux,ug,ug,ur,ux,ux,ux,ug,ug,ug,ug,ug,ug,ug,ug,ux,ux,ux
ux,ux,ux,ux,ux,ux,ug,ug,ur,ux,ux,ux,ux,ux,ux,ux,ux,ux,ux,ux,ux,ux,ux
ux,ux,ux,ux,ux,ux,ug,ug,ur,ux,ux,ux,ux,ux,ux,ux,ux,ux,ux,ux,ux,ux,ux
ux,ux,ux,ux,ux,ux,ux,ux,ur,ux,ux,ux,ux,ux,ux,ux,ux,ux,ux,ux,ux,ux,ux
ux,ux,ux,ux,ux,ux,ux,ux,ur,ux,ux,ux,ux,ux,ux,ux,ux,ux,ux,ux,ux,ux,ux
ux,ux,ux,ux,ux,ux,ux,ux,ur,ux,ux,ux,ux,ux,ux,ux,ux,ux,ux,ux,ux,ux,ux
ux,ux,ux,ux,ux,ux,ux,ux,ur,ux,ux,ux,ux,ux,ux,ux,ux,ux,ux,ux,ux,ux,cb
ux,ux,ux,cr,ur,ur,ur,ur,ur,cg,ux,ux,ux,ux,ux,ux,ux,ux,ux,ux,ux,ux,ux