ur,ur,ur,ur,ur,ur,ur,ur,ur,ur,ur,ur,ur,ur,ur,ur,cr,ur,ur,ur,ur,cr,cr
ur,ur,ur,ur,ur,ur,ur,ur,ur,ur,ur,ur,ur,ur,ur,ur,ur,ur,ur,cr,ug,ur,ur
ur,ur,ur,ur,ur,ur,ur,ur,ur,ur,ur,ur,ur,ur,ur,ur,ur,ur,cr,ur,ur,ur,ur
ur,ur,ur,ur,ur,ur,ur,ur,ur,ur,ur,ur,ur,ur,ur,ur,ur,ur,ur,ur,ur,ur,ur
ur,ur,ur,ur,ur,ur,ur,ur,ur,ur,ur,ur,ur,ur,ur,ur,ur,ux,ug,ub,ux,ux,ur
ur,ur,ur,ur,ur,ur,ur,ur,ur,ur,ur,ur,ur,ur,ur,ux,ux,ux,ug,ub,ub,ub,ur
ur,ur,ur,ur,ur,cg,ug,ug,cr,ur,ur,ur,ux,ux,ux,ux,ux,ux,ub,ub,ub,ub,ur
ur,ur,ur,ur,ur,ug,ub,ub,ub,ub,ur,ur,ux,ux,ux,ug,ug,ug,ub,ub,ub,ux,ur
cg,ux,ur,ur,ux,ug,ub,ub,ub,ub,ub,ub,ug,ug,ug,ug,ug,ug,ub,ux,ub,ub,ur
ub,ub,ub,ub,ur,ug,ub,cb,ub,ug,ux,ub,ux,ux,ux,ux,ug,ug,ub,ux,ux,ux,cg
ub,ux,ux,ub,ux,ug,ub,ub,ub,ub,cb,ub,ub,ub,ux,ug,ug,ug,ug,ug,ug,ug,ug
ub,ux,ux,ub,ub,ug,ub,ug,ug,ug,ub,ub,ug,ug,ub,ug,ug,ug,ug,ug,ug,ug,ur
ub,ux,ux,ub,ub,ug,ub,ug,ug,cg,ub,ub,ub,ub,cb,ub,ug,ug,ub,ux,ux,ux,ur
ub,ux,ux,ub,ub,ug,ub,ux,ub,ub,ub,ub,ub,ub,ub,ub,ux,ux,ub,ux,ux,ux,ur
ub,ux,ux,ub,ux,ug,ug,ux,ux,ub,ub,ub,ub,ub,ub,ub,ub,ux,ub,ux,ux,ux,ur
ub,ux,ux,ub,ux,ug,ug,ug,ux,ub,ub,ug,ub,ub,ub,ub,ub,ux,ub,ux,ux,ux,ur
ub,ux,ux,ub,ux,ug,ub,ug,ug,ub,ub,ub,ub,ub,ub,ub,ub,ux,ub,ux,ux,ux,ur
ub,ux,ux,ub,ux,ug,ux,ux,ug,ug,ug,ub,ux,ug,ub,ub,ub,ux,ub,ux,ux,ux,ur
ub,ux,ux,ub,ux,ug,ug,ug,ug,ug,ug,ug,ug,ug,ub,cb,ux,ux,ub,ux,ux,ux,ur
ub,ux,ux,ub,ux,ux,ux,ux,ux,ux,ub,ux,ux,ub,ub,ub,ux,ux,ub,ub,ux,ux,ur
ub,ux,ux,ub,ux,ux,ux,ux,ux,ux,ub,ub,ub,ub,ub,ub,ux,ux,ux,ub,ub,ub,cb
ub,ux,ux,ub,ux,ux,ux,ux,ux,ux,ub,ub,ux,ux,ux,ux,ux,ux,ux,ux,ux,ux,ur
ub,ub,ub,ub,ub,ub,ub,ub,ub,ub,ub,ub,ub,ub,ub,ub,ub,ub,ub,ub,ub,cb,ur