ur,ur,ur,ur,ur,ur,ur,ur,ur,ur,cr,cr,ub,ub,cb,ur,ur,cb,ur,ur,ur,ur,ur
ub,cb,ur,ur,ur,ur,ur,ur,ur,ur,ur,ur,ub,ub,ub,ub,ur,cr,ur,ur,ur,ur,ur
ur,ur,ur,ur,ur,ur,ur,ur,ug,cg,ur,ur,ur,ur,ur,ub,ur,ur,ur,ur,ur,ur,ur
cr,ur,ur,ub,ub,ub,ur,ur,ug,ur,ur,ur,ur,ur,ur,ub,ur,ur,ur,cr,ux,ub,ub
cb,ux,ux,ur,ur,ur,ub,ub,ug,ug,ug,ur,ur,ug,ug,ug,ug,ur,ug,ur,ub,ub,ug
ux,ux,ux,ur,ur,ur,ur,ux,ur,ur,ur,ur,ug,cg,ug,ub,ug,ug,ug,ug,ub,ug,ur
ux,ux,ux,ug,ug,ug,ur,ux,ur,ur,ur,ur,ub,ur,ug,ux,ug,ug,ug,ug,ur,ug,ur
ur,ux,ux,ug,ug,ug,ug,ug,ug,ug,ug,ur,ub,ub,ug,ug,ug,ug,ug,ug,ur,ug,ur
ur,ur,ux,ug,ux,ug,ug,ug,ug,ur,ug,ub,ub,ub,ug,ug,ur,ug,ur,ur,ug,ug,ur
ur,ur,ur,ug,ug,ug,ug,ug,ug,ug,ug,ub,ub,ub,ug,ug,ur,ug,ur,ug,ug,ur,ur
ur,ur,ur,ug,ug,ug,ug,ug,ug,ug,ug,cg,ub,ub,ub,ub,ub,ub,ub,ug,ur,ur,ur
ux,ux,ux,ug,ug,ug,ug,ux,ub,ug,ub,ub,ub,ub,ub,ub,ub,ug,ug,ur,ur,ur,ur
ux,ux,ux,ug,ug,ug,ug,ux,ub,ug,ug,ug,ub,cb,ug,ug,ur,ug,ur,ur,ur,ur,cg
ux,ux,ux,ug,ug,ug,ug,ug,ub,ub,ub,ub,cr,ur,ur,ur,ur,ur,ur,ur,ur,ur,ur
ux,ux,ux,ug,ug,ug,ug,ug,ug,cb,ub,ub,ub,ub,ub,ub,ub,ub,ug,ur,ur,ur,ur
ux,ux,ux,ug,ub,ug,ug,ug,ub,ub,ub,ub,ug,ub,ub,ub,ub,ub,ug,ug,ur,ur,ur
ux,ux,ux,ux,ub,ug,ug,ug,ub,ub,ux,ux,ug,ux,ub,ub,ub,ub,ub,ug,ug,ur,ur
cg,ub,ux,ux,ux,ux,ub,ub,ux,ux,ux,ux,ug,ux,ub,ub,ub,ub,ub,ur,ug,ug,ur
ub,ug,ug,ug,ug,ug,ug,ug,ug,ug,ug,ug,ug,ux,ux,ub,ub,ux,ux,cg,ug,ug,ur
ub,ug,ux,ux,ux,ux,ux,ux,ux,ux,ux,ux,ub,ux,ux,ux,ux,ux,ux,ur,ur,ur,ur
ub,ug,ug,ur,ug,ug,ug,ug,ug,ug,ug,ug,ub,ug,ug,ug,ug,ug,ug,ur,ur,ur,ur
cr,ub,ug,ug,ug,ux,ux,ux,ux,ux,ux,ux,ub,ux,ux,ux,ux,ux,ux,ur,ur,cb,cr
cg,ub,ub,ub,ub,ub,ub,ub,ub,ub,ub,ub,ub,cb,ux,ux,ux,ux,ux,cg,cb,ux,cr