ur,ur,ur,ur,ur,ur,ub,ub,ub,ur,ur,ub,ub,ub,ux,ux,ux,ur,ur,ur,ug,ur,cb
ur,ur,ur,ur,ur,cr,cr,ub,ub,ur,ur,ub,ub,ub,ux,ux,ux,cr,ur,ur,ug,ug,ux
ur,ur,ur,ur,ur,ub,cb,ub,ub,ur,ur,ux,ux,ub,ub,ux,ur,ur,ub,ug,ug,ug,ux
ur,ur,ur,cr,ub,ub,ub,ub,ub,ur,ur,ux,ux,ux,ub,ub,ub,ub,ub,ug,ux,ug,ux
ur,ur,ur,ub,ur,ur,ug,ux,ub,ub,ub,ub,ub,ub,ub,ub,ub,ub,ub,ug,ug,ug,ux
ur,ur,ur,ub,ur,ur,ur,cr,ub,ub,ub,ug,ug,ug,ux,ub,ub,ux,ug,ug,ug,ug,ux
ur,ur,ur,cb,ug,ug,ug,cg,ub,ug,ug,ug,ug,ub,ub,ub,ub,ux,ug,ux,ug,ux,ux
ur,ur,ur,ur,ug,ug,ux,ux,ub,ug,ug,ur,ug,ub,ug,ub,ub,ux,ug,ug,ug,ux,ux
cg,ur,ur,ur,ug,ug,ug,ug,ub,ug,ub,ub,ug,ub,ub,ub,ub,ux,ux,ug,ug,ux,ux
ur,ur,ur,ur,ug,ug,ug,ug,ur,ug,ug,ub,cg,ub,ug,ug,ub,ub,ug,ug,ug,ux,ux
ur,ux,ur,ur,ug,ux,ug,ug,ur,ug,ug,ub,ub,ub,ub,ub,ug,ub,ug,ux,ug,ug,ug
ur,ur,ur,ur,ug,ur,ug,ug,ur,ug,ug,ur,ug,ur,ux,ub,ug,ub,ug,ug,ug,ur,ug
ur,ur,ur,ur,ug,ur,ub,ub,ug,ug,ub,ur,ug,ub,ub,ub,ug,ub,ux,ux,ug,ug,ug
ur,ur,ur,ur,ug,ub,ub,ub,ug,ub,ub,ur,cb,ub,ub,ub,ug,ux,ux,ux,ux,ug,ug
ur,ur,ur,ur,ug,ub,ub,ub,ug,ub,ub,ub,ug,ug,ub,ub,ug,ux,ux,ux,ux,ug,ug
ur,ur,ux,ux,ug,ub,ub,ub,ub,ub,ub,ug,ug,ub,ub,ux,ug,ux,ux,ux,ux,ug,ug
ur,ur,ur,ur,ug,ur,ur,ur,cb,ur,ur,ur,ur,ur,ur,ur,ur,ur,ur,ur,ur,ur,cr
ur,ux,ux,ux,ug,ux,ux,ux,ux,ux,ux,ug,ug,ug,ug,cg,ug,ug,ub,ug,ug,ug,ug
ur,ux,ux,ux,ug,ug,ug,ug,ug,ug,ug,ug,ug,ug,ug,ug,ux,ub,ux,ug,ub,ub,ub
ur,ux,ux,ux,ux,ux,ux,ux,ux,ux,ug,ug,ug,ur,ug,ug,ug,ug,ug,ug,ub,ub,cb
ur,ux,ux,ux,ux,ux,ux,ux,ux,ux,ux,ur,ux,ur,ug,ug,ug,ug,ug,ug,ub,ub,ub
ur,ux,ux,ux,ux,ux,ux,ux,ux,ux,ux,ur,ux,ur,ur,ur,ur,ur,ur,ug,ub,ub,ub
ur,ur,ur,ur,ur,ur,ur,ur,ur,ur,ur,ur,ux,ux,ux,ux,ux,ux,ux,ux,ux,ub,ub