ur,cb,cb,cr,cb,ur,ur,ur,ur,ur,ux,ur,ur,ux,ur,ur,ur,ur,ub,ub,ub,ux,cb
ur,ur,cb,ur,ur,ur,ur,cg,ug,ug,ux,ur,ur,ur,ur,ur,ur,ur,ub,ur,ub,ur,ux
ur,ur,ur,ur,ur,ur,ur,ur,ur,ug,ug,ur,ur,ur,ur,ur,ur,ur,ub,ub,ub,ur,ur
ur,ur,ur,ur,ur,ur,ur,ur,ur,ur,ug,ug,ug,ug,ug,ug,ug,ug,ub,ub,cb,ug,ug
ur,cb,ur,ur,ur,ur,ur,ur,ur,ur,ur,ur,ur,ur,ur,ur,ub,ub,ub,ub,ub,ub,ub
cr,ub,ur,ug,ug,cr,cr,ug,ug,ur,ur,ug,ug,ug,ur,ur,ur,ug,ub,ub,ub,ub,ub
ur,ur,ur,cg,ug,ug,ug,ur,ug,ur,ur,ug,ux,ur,ur,ur,ur,ug,ug,ur,ur,ug,ug
cb,ur,ur,ur,ur,ur,ug,ub,ug,ug,ug,ug,ur,ur,ur,ur,ur,ug,ug,ug,ug,ug,ur
ur,ur,ur,ur,cg,ug,ug,ug,ug,ug,ug,ug,ug,ug,ur,ur,ur,ug,ug,ug,ur,ur,ur
ur,ur,ur,ur,ur,ur,cr,ug,ug,ug,ug,ur,ur,ug,ug,ug,ug,ug,ug,ug,ug,ux,ug
ur,ur,ur,ur,ur,ux,ux,ux,ug,ur,ug,ur,ux,ux,ug,ux,ux,ux,ug,ug,ug,ux,cg
ur,ur,ur,ur,cr,ux,ux,ux,ug,ug,ug,ux,ux,ux,ug,ux,ux,ux,ux,ug,ug,ux,cb
cb,ub,ub,ug,ug,ug,ug,ug,ux,ux,ux,ux,ux,ux,ug,ug,ub,ux,ux,ug,ug,ux,cg
ur,ur,ur,ug,ug,ug,ug,ug,ug,ug,ug,ur,ur,ur,ur,ur,ur,ur,ur,ur,ur,ur,ur
ur,ug,ug,ug,ux,ug,ug,ug,ug,ux,ug,ux,ux,ux,ux,ux,ug,ug,ug,ug,ug,ug,ur
ub,cb,ub,ug,ug,ug,ug,ug,ug,ux,ug,ug,ux,ux,ux,ux,ux,ux,ux,ux,ux,ug,ur
ub,ub,ub,ub,ug,ug,ug,ux,ug,ux,ux,ug,ug,ux,ux,ux,ug,ug,ug,ug,ug,ug,ur
ub,ub,ub,ug,ug,ug,ug,ux,ug,ug,ux,ug,ug,ux,ux,ux,ug,ux,ux,ux,ux,ux,ur
ub,ug,ug,ug,ug,ug,ug,ug,ug,ug,ug,ug,ug,ur,ur,ur,ur,ur,ur,ur,ur,ur,ur
cr,ug,ug,cg,ur,ur,ur,ur,ur,ur,ur,ur,ur,ur,ur,ur,ur,ur,ur,ur,ur,ur,ur
cg,ug,ug,ug,ux,ux,ux,ux,ux,ug,ux,ux,ux,ug,ug,ug,ug,ur,ur,ur,ur,ur,cr
cr,ur,ur,ur,cr,ug,ug,ug,ux,ug,ux,ux,ux,ux,ux,ux,ux,ux,ux,cb,cb,ur,cr
cg,ur,cg,cb,ux,ux,ux,ug,ug,ug,ux,ux,ux,ux,ux,cg,ux,ux,ux,cg,cg,cb,cr