ur,ur,ur,ur,ur,ur,ur,ur,ur,ur,ur,ur,ur,ur,ur,ur,ur,ur,ur,ur,ur,ur,ur
ur,ur,ur,ur,ur,ur,ur,ur,ur,ur,ur,ub,ub,ur,ur,ur,ur,ur,ur,ur,ux,ur,ur
ur,ur,ur,ur,ur,ur,ur,ur,ur,cb,ur,cr,ub,ub,ur,ur,ur,ur,ur,ur,ux,cr,ur
cr,ur,ur,ur,ur,ur,ug,ug,ug,ub,ub,ub,ub,ub,ug,ur,cr,ur,ur,ur,ur,ur,ur
ur,ur,ur,ur,ug,ug,ug,ug,ug,ub,ub,ub,ub,ub,ur,ur,ur,ub,ur,ur,ur,ur,ur
ur,ur,ur,ur,cg,ur,ur,ur,ur,ur,ub,ub,ub,ug,ub,ub,ur,ur,ur,ur,ur,ur,ur
ur,ur,ur,ur,ur,ur,ur,ur,ur,cr,ur,ur,ur,ur,ur,ur,ur,ur,ur,ur,ur,ur,ur
ur,ur,ur,ur,ug,ug,ug,ug,ur,ur,cb,ub,ub,ub,ub,ub,ug,ub,ux,ux,ur,ux,ur
cg,ux,ux,ux,ub,ux,ux,ug,ug,ub,ub,ub,ub,ub,ub,ug,ux,ub,ux,ur,ur,ur,ur
ub,ub,ub,ub,ub,ux,ux,ux,ux,ub,cb,ub,ub,ub,ub,ug,cr,ub,ur,ur,ur,ur,ur
ub,ub,ub,ub,ub,ub,ub,ub,ub,ub,ub,ug,ub,ub,ub,ub,ur,ub,ur,ur,ur,ur,ur
ub,ub,ug,cg,ub,ub,ub,ub,ub,ub,ub,ug,cg,ub,ub,ub,ur,ur,ur,ur,ur,ur,ur
cb,ub,ug,ub,ub,ub,ub,ux,ub,ub,ub,ub,ub,ub,ub,ub,ub,ub,ub,ub,ub,ub,ur
ub,ub,ug,ug,ux,ub,ub,ub,ub,ub,ub,ub,ux,ub,ub,cb,ub,ug,ug,ub,ug,ux,ur
cg,ux,ux,ug,ux,ux,ux,ux,ug,ug,ug,ur,ux,ub,ux,ub,ub,ub,ug,ub,ug,ub,ur
ub,ub,ub,ub,cb,ux,ux,ux,ug,ug,ug,ur,ux,ub,ub,ub,ug,ub,ur,ub,ug,ux,ur
ub,ub,ub,ug,ux,ux,ux,ux,ug,ug,ug,ur,ug,ug,ug,ug,ug,ub,ub,ub,ug,ux,ur
ub,ub,ub,ug,ux,ux,ux,ux,ub,ug,ug,ur,ug,ux,ux,ux,ux,ur,ur,ux,ug,ux,ur
ub,ub,ub,ug,ub,ux,ux,ux,ub,ub,ug,ug,ug,ug,ug,ug,ug,ug,ur,ux,ug,ux,ur
ub,ub,ub,ug,ug,ux,ux,ug,ug,ug,ug,ug,ub,ux,ux,ux,ux,ug,ur,ur,ug,ur,ur
ub,ub,ub,ux,ug,ug,ug,ug,ub,ub,ug,ug,ug,ug,ug,ug,ug,ug,ux,ux,ug,ux,ur
ub,ub,ub,ux,ux,ux,ux,ub,ub,ub,ug,ub,ub,ux,ux,ux,ux,ur,ux,ux,ug,ux,ur
ub,ub,ub,ub,ub,ub,ub,ub,ux,cg,ug,ug,ug,ug,ug,ug,ug,ur,ur,ur,ur,ur,ur