ur,ur,ur,ur,ur,ur,ur,ur,ur,ux,ux,ux,ux,ux,ux,ux,ux,ux,ux,ux,ux,ur,ur
ur,ur,ug,ug,cr,ur,ug,ug,ur,ur,ur,ur,ur,ur,ur,ur,ur,ur,ur,ur,ur,ur,ur
ur,ur,ug,ur,ur,ur,ur,ur,ur,ur,ur,ur,ur,ur,ur,ur,ur,ur,ur,ur,ur,ux,ur
ur,ur,ug,cr,ur,ug,ug,cg,ur,ur,ur,ur,ur,ur,ur,ur,ur,ur,ur,ur,ur,ux,ur
ur,ur,cg,ug,cb,ur,ur,ur,ur,ur,ur,ur,ur,ur,ur,ur,ur,ur,ur,ur,ur,ux,ur
ur,ur,ur,ur,ub,ug,ug,ug,ur,ur,ur,ur,ur,ur,ur,ur,ur,ur,ur,ur,ur,ur,ur
ur,ur,ur,ub,ub,ug,ur,ur,ur,ur,ur,ur,ur,ur,ur,ur,ur,cr,ur,ur,ux,ub,ur
ur,ur,ur,ub,ub,ug,ug,ug,ur,ur,ur,ur,ur,ur,ur,ur,ur,ur,ur,ur,ur,ub,ub
ur,ur,ur,ur,ur,ug,ug,ug,ur,ur,ur,cr,ub,ub,ug,ug,cr,ug,ux,ux,ur,ur,ub
ur,ug,ug,ug,ug,ux,ux,ug,ub,ub,cb,ub,ub,ub,ug,ug,ub,ug,ux,ux,ux,ur,ub
ur,ux,ux,ux,ug,ug,ux,ug,ub,ub,ub,ub,ux,ub,ug,ub,ub,ug,ux,ux,ux,ur,ub
ur,ux,ux,ux,ux,ug,ug,ug,ub,ub,ub,ub,ug,cb,ub,ub,ub,ub,ub,ub,ub,ur,ub
ur,ux,ux,ux,ur,ur,ub,ug,ug,ug,ub,ub,ub,ub,ub,ub,ux,ub,ub,ub,ur,ur,ub
ur,ur,ur,ur,ur,ug,ug,ug,ug,ug,ug,ug,ub,ub,cr,ub,ub,ub,ub,ur,ur,ur,ub
ur,cb,ub,ub,ub,ub,ub,ug,ug,ug,ug,ug,ug,cg,ur,ub,ub,ub,ub,ur,ur,ur,ub
ur,ur,ur,ur,ur,ug,ub,ub,ub,ub,ub,ub,ub,ug,ur,ub,ub,ub,ub,ur,ur,ur,ub
ur,ur,ur,ur,ur,ug,ug,ug,cg,ur,ur,ug,ug,ug,ur,ub,ub,ub,ub,ub,ub,ub,ub
ur,ux,ux,ux,ux,ux,ux,ug,ug,ug,ux,ux,ug,ug,ur,ug,ux,ub,ux,ux,ur,ur,ur
ur,ux,ux,ux,ux,ux,ub,ub,ug,ug,ub,ub,ug,ug,ur,ub,ub,ub,ug,ux,ur,ur,ur
ur,ux,ux,ux,ux,ux,ub,ub,ug,ug,ub,ub,ug,ub,ur,ub,ub,ub,ug,ux,ur,ur,ur
ur,ux,ux,ub,ub,ux,ux,ub,ug,ug,ux,ux,ux,ux,ur,ub,ub,ux,ug,ux,ur,ur,ur
ur,ux,ub,ub,ub,ub,ux,ub,ux,ux,ux,ux,ux,ux,ur,ur,ub,ub,ub,ur,ur,ur,ur
ur,ur,ur,ur,ur,ur,ur,ur,ur,ur,ur,ur,ur,ur,ur,ur,ub,ub,ub,cb,ur,cb,ur