ur,ur,ur,ur,ur,ur,ur,ur,ur,ur,ur,ur,ur,ur,ur,ur,ur,ur,ub,cr,cr,cr,ur
ur,ur,ur,ur,ur,ur,ur,ur,ur,ur,ur,ur,ur,ur,ur,ur,ur,ur,cb,ur,ur,ur,ur
ur,ug,ug,ug,ug,ur,ur,ur,ur,ur,ur,ur,ur,ur,ur,ur,ur,ur,ur,ur,ur,ur,ur
ur,ug,ug,ug,ug,ur,ur,ur,ur,ur,ur,ur,ur,ur,ur,ur,ur,ur,ur,ur,ur,ur,cb
ur,ug,ug,ug,ug,cg,cr,ur,ur,ur,ur,ur,ur,ur,ur,ur,ur,ur,ur,ur,ur,ur,ur
ur,ur,ur,ur,ug,ug,ub,ub,ur,ub,ub,ub,ub,cb,ur,ur,ur,ur,ur,ur,ur,ur,ur
ur,ur,ur,ur,ur,ur,ub,ub,ur,ur,ur,ur,ur,ur,ur,ur,ur,ur,ur,ur,ur,ur,ur
ur,ur,ur,ur,cr,ub,ub,cb,ub,ub,ub,ub,ub,ub,ub,ux,ux,ug,ux,ux,ug,ux,ur
cg,ur,ur,ur,ur,ur,ur,ur,ub,ub,ub,ub,ub,ug,ug,ux,ux,ug,ug,ug,ug,ux,ur
ur,ur,ur,ur,ur,ur,ur,ub,ub,ub,ub,ur,ub,ug,ug,ug,ug,ug,ug,ug,ug,ux,ur
ur,ur,ur,ur,ur,ur,ur,ug,ub,ub,ub,ub,ub,ug,ub,ux,ux,cb,ub,ux,ug,ux,ur
ur,ur,ug,ug,ug,ug,ux,ub,ub,ub,cb,ug,ug,ug,ub,ux,ug,ug,ub,ux,ug,ux,ur
ur,ur,ug,ug,ux,ux,ux,ub,ub,ub,ub,ub,ug,ug,ug,ug,ug,ux,ub,ux,ug,ux,ur
ux,ux,ux,ux,ux,ux,ux,ub,ub,ub,ub,ub,ug,ug,ug,ug,ug,ug,ub,ub,ub,ub,ub
cg,ux,ux,ux,ux,ux,ux,ux,cr,ub,ub,ug,ug,ug,ug,cg,ux,ux,ux,ux,ug,ub,ub
ux,ux,ux,ux,ux,ux,ux,ux,ur,ub,ub,ub,ug,ug,ug,ug,ug,ub,ub,ub,ug,ub,ub
ux,ux,ux,ux,ux,ux,ux,ux,ur,ub,ub,ub,ug,ug,ug,ug,ug,ub,ub,ub,ug,ub,ub
cg,ux,ux,ux,ux,ux,ux,ux,ur,ub,ub,ub,ug,ug,ug,ug,ug,ux,ub,ub,ug,ub,ub
ug,ux,ux,ux,ux,ux,ux,ux,ur,ux,ux,ux,ub,ux,ug,ug,ug,ub,ub,ub,ub,ub,ub
ug,ux,ux,ux,ux,ux,ux,ux,ur,ux,ux,ux,ub,ux,ux,ux,ux,ux,ux,ub,ub,ub,ub
ug,ug,ug,ug,ug,ug,ug,ug,ur,ug,ug,ug,ug,ug,ug,ur,ur,ur,ur,ub,ub,ub,ub
ur,ux,ux,ux,ux,ux,ux,ux,ur,ux,ux,ux,ux,ux,ug,ug,ux,ux,ux,ub,ub,ub,cb
ur,ur,ur,ur,ur,ur,ur,ur,ur,cg,ux,ux,ux,ux,ux,ug,ug,ug,ug,ub,ub,ux,ux