ur,cb,cb,cr,ur,ur,ur,ur,ur,cg,ur,ur,ur,ur,ur,ur,ub,ub,ub,ub,ur,ur,cb
ur,ur,cb,ur,ur,ur,ur,ur,cr,ug,ur,cr,ur,ub,cr,ub,ub,ub,ub,ub,ub,ur,ur
ur,ur,ur,ur,ur,ur,ur,ur,ug,ug,ur,cb,cb,ub,ug,ur,ur,ur,ub,ur,ub,ur,ur
ur,ur,ur,ur,ur,ur,ur,ur,ur,ur,ur,ur,ur,ub,cg,ur,ur,ur,ub,ub,ub,ub,ub
ur,ur,ur,ug,ur,ur,ur,ur,ug,ur,ur,ur,ur,ub,ub,ub,ub,ur,ub,ub,ub,ub,ub
ur,ug,ug,ug,ur,ur,ur,ug,ug,ug,ur,ur,ur,ur,ur,ur,ub,ub,ub,ub,ub,ub,ub
ur,ur,ur,ur,ur,ur,ur,cr,ug,ug,ur,ur,ur,ur,ur,ur,ur,ub,ub,ub,ur,ur,ub
cb,ug,ug,ur,ug,ug,ug,ur,ug,ug,cb,ub,ub,ub,ub,ub,ub,ub,ub,ub,ub,ur,ur
ug,ug,ug,ur,ug,ug,ug,ur,ug,ug,ur,ur,ur,ur,ub,ub,ub,ub,ub,ub,ur,ur,ur
ug,ug,ur,ug,ug,ug,ug,ur,ug,ug,cr,ur,ur,ux,ub,ub,cg,ub,ub,ub,ur,ur,ur
ug,ug,ur,ur,ur,ug,ug,ug,ug,ug,ug,ug,ug,ug,cb,ug,ug,ub,ub,ub,ur,ur,ur
ur,ur,ur,ur,ur,ug,ub,ub,ux,ub,ub,ug,ug,ug,ug,ug,ub,ub,cg,ug,ur,ur,ur
cb,ux,ux,ux,ux,ug,ug,ub,cb,ub,ug,ug,ug,ug,ug,ug,ug,ug,ug,ux,ur,ur,ur
ux,ux,ux,ux,ux,ux,ub,ub,ub,ub,ug,ug,ug,ug,ug,ub,ub,ub,ug,ux,ur,ur,cr
ux,ug,ug,ug,ux,ux,ux,ub,ub,ub,ub,ub,ub,ub,ub,cg,ug,ug,ug,ug,ur,ur,ux
ux,ug,ug,ug,ug,ug,ug,ug,cg,ub,ux,ux,ub,ub,ub,ub,ug,ug,ug,ug,ur,ur,ux
ux,ug,ug,ug,ug,ug,ug,ug,ug,ub,ux,ux,ux,ux,ux,ux,ub,ux,ux,ux,ur,ur,ux
ux,ug,ug,ug,ub,ug,ug,ug,ug,ux,ux,ux,ux,ux,ux,ux,ub,ux,ux,ux,ur,ur,ux
ux,ug,ug,ug,ug,ug,ug,ug,ux,ux,ux,ux,ux,ux,ux,ux,ub,ux,ux,ux,ur,ur,ux
cr,ug,ug,ug,ug,ug,ug,ux,ux,ux,ux,ug,ug,ux,ux,ux,ub,ub,ux,ux,ur,ur,ux
cg,ug,ug,ug,ug,ug,ug,ug,ug,ug,ug,ug,ug,ug,ux,ub,ub,ub,ub,ub,ur,ur,cr
cr,ug,ug,ug,ug,ug,ug,ug,ug,ug,ug,ug,ug,ug,ub,ub,ub,ub,ub,cb,cb,ur,cr
cg,ux,cg,cb,ux,ux,ux,ux,ux,ux,ux,ux,ux,ux,ux,cg,ub,ub,ub,cg,cg,cb,cr