cb,cb,cb,cr,ur,ur,ur,ur,ur,ur,ur,ur,ur,ur,ur,ur,ur,ur,ur,ur,ur,ur,cb
ur,ur,ur,cr,ur,ur,ur,ur,ur,ur,ur,ur,ur,ur,ur,ub,ub,ub,ub,ub,ub,cr,ub
ur,ur,ur,ub,ur,ur,ur,ur,ur,ur,ug,cr,ur,ub,cr,ur,cb,ub,ub,ub,ub,ub,ub
ur,ur,cr,ur,ur,ug,ug,ur,ur,ug,ug,ug,ug,ug,ub,ug,ug,ub,ub,ub,ub,ub,ub
ur,ur,ur,ur,ug,ug,ug,ug,ug,ug,ux,ug,ug,ug,ub,ug,ux,ub,ub,ub,ub,ub,ub
ur,ur,ub,ub,ug,ug,ug,ur,ur,ug,ug,ug,ug,ug,ub,ug,ux,ug,ug,ub,ub,ub,ub
ur,ur,ub,ub,ug,cg,ur,ur,ur,ug,ug,ug,ug,ub,ub,ug,ux,ug,ug,ub,ub,ub,ub
cb,ub,ub,ug,ug,ur,ub,ub,ur,ug,ug,ux,ux,ub,ux,ug,ux,ub,ug,ub,ub,ub,ub
ux,ub,ur,ug,ur,ur,ub,ub,ub,ub,ug,ug,ug,ub,ux,ug,ug,ub,ug,ub,ug,ug,ug
ub,ub,ub,ug,ux,ux,ux,ub,ub,cb,ub,ug,ux,ub,ug,ug,ug,ub,ug,ub,ub,ub,ub
ub,cb,ub,ug,ug,ug,ug,cg,ub,ub,ub,ub,ux,ub,ug,ug,ug,ub,ug,ub,ub,ub,ub
ub,ub,ub,ub,ub,ub,ub,ub,cb,ub,ub,ug,ug,cg,ub,ug,ug,ug,ug,ug,ug,ug,ug
cb,ub,ub,ux,ux,ux,ub,ub,ub,ub,ub,cb,ux,ug,ub,ub,ub,ub,ub,ub,ub,ub,ub
cg,ux,ub,ug,ug,ub,ub,ub,ub,ug,ug,ug,ux,ux,ux,ug,ug,cb,ub,ub,ub,ub,ub
ug,ug,ug,ug,ug,ux,ub,ub,ub,ub,ug,ug,ux,ug,ug,ug,ug,ux,ug,ug,ug,ux,ug
ug,ug,ug,ug,ug,ug,ug,ug,ux,ux,ug,ug,ux,ug,ux,ux,ux,ug,ug,ux,ur,ux,ug
ug,ug,ug,ug,ug,ug,ub,ug,ux,ux,ux,ug,ug,ug,ux,ux,ux,ug,ug,ug,ur,ur,ug
cr,ur,ug,ug,ug,ug,ug,ug,ub,ur,ur,ug,ug,ug,ug,ug,ug,ug,ug,ug,ur,ur,ur
cg,ur,ug,ug,ug,ug,ug,ug,ub,ub,ub,ug,ug,ug,cg,ux,ux,ux,ux,ux,ux,ur,ur
cb,ur,ug,ug,cr,ur,ur,ur,ur,ur,ur,ur,ur,ur,ur,ur,ur,ur,ur,ur,ur,ur,ur
ux,ur,ug,ug,ug,ug,ug,ug,ug,ur,ur,ur,ur,ur,ur,ur,ur,ur,ur,ur,ur,ur,cr
cr,ur,ux,ug,ug,ug,ux,ux,ux,ux,ux,ug,ug,ug,ug,ug,ux,cb,cg,ux,cb,ur,cr
cg,ur,cg,cb,ug,ug,ux,ux,ux,ux,ux,ux,ux,ux,ux,cg,ux,ux,ux,cg,cg,ur,cr