ur,cb,cb,cr,ur,ur,ur,ur,ur,ur,ur,ur,ur,ur,ur,ur,ur,cr,ug,ur,ur,ux,cb
ur,cb,cb,ur,ur,ur,ur,ur,ur,ur,ur,ur,ur,ur,ur,ur,ur,ur,ug,ug,ur,ur,ur
ub,ub,cr,ur,ur,ur,ur,ur,ur,ur,ur,ur,ur,ur,ur,ur,ur,ur,ug,ug,ur,ur,ur
ub,ub,ub,ur,ub,ur,ur,ur,ur,ur,ur,ur,ur,ur,ur,ur,ur,ur,ug,ug,ur,ur,ur
ug,ug,ug,ur,ub,ub,ur,ur,ur,ur,ur,ur,ur,ur,ur,ur,ur,ur,ug,ug,ug,ug,ur
ug,ub,ug,cr,ur,ub,cb,ug,ug,ug,ur,ur,ur,ur,ur,ur,ur,ur,ug,ug,ug,ug,ug
ug,ug,ug,ur,ur,ug,ug,ur,ur,ug,ur,ur,ur,ur,ur,ur,ux,ub,ub,ug,ug,ug,ug
cb,ug,ur,ur,ug,ug,ux,cg,ug,ug,ur,ur,ur,ur,ub,ur,ur,ub,ub,ub,ub,ub,ug
ur,ug,ur,ur,ur,ur,ur,ur,ur,ur,ur,ur,ur,ur,cr,ub,ub,ub,ub,ub,ug,ub,ug
ur,ug,ur,ur,ur,ur,ur,ur,ur,ur,ur,ur,ub,ux,ub,ub,ub,ug,ug,ug,ug,ub,ug
ur,ug,ur,ur,ur,ub,ur,ur,ur,ur,ur,ub,ub,ub,ub,ub,ub,ug,ur,ux,ug,ub,ug
ur,ug,ug,ug,ug,ug,cg,ur,ur,ur,ur,ub,cb,ub,ub,ub,ub,ub,ug,ug,ub,ub,ug
cb,ux,ux,ux,ux,ub,ux,ux,ub,cr,ur,ub,ub,ub,ub,ub,ub,ug,ug,ug,ug,ub,ug
ux,ux,ux,ux,ux,ub,ux,ux,ub,ug,ug,ub,ub,ub,ug,ug,ub,ug,ug,ug,ug,ub,ug
ug,ux,cb,ub,ub,ub,ug,ug,ub,ux,ub,ug,ug,ug,ug,ug,ux,ug,ug,ug,ub,ub,ug
ug,ux,ux,ux,ug,ug,ug,ug,cb,ux,ux,ug,ux,ub,ub,ub,ug,ug,ug,ug,ug,ub,cg
ug,ux,ux,ux,ug,ug,cg,ug,ux,ux,ux,ug,ug,ug,ux,ux,ux,ug,ux,ug,ug,ux,cb
ug,ux,cr,ur,ur,ur,ur,ur,ur,ur,ur,cg,ug,ur,ur,ur,ur,ur,ur,ur,cg,ug,ur
ug,ug,ug,ug,ug,ug,ug,ug,ug,ug,ug,ug,ug,ug,ug,ug,ug,ug,ur,ur,ug,ug,ur
ug,ug,ug,ug,ug,ug,ug,ug,ug,ur,ug,ug,ug,ug,ug,ug,ug,ug,ug,ug,ug,ug,ur
cr,ug,ux,ug,ug,ug,ug,ug,ug,ug,ug,ug,ux,ux,ux,ux,ug,ug,ug,ux,ux,ux,cr
cg,ug,ug,ug,ug,ug,ug,ug,ug,ug,ug,ug,ug,ug,ug,ug,ug,ux,ux,cb,cb,ux,cr
cr,cg,cg,cb,ug,ug,ug,ug,ug,ug,ug,ux,ux,ux,ux,cg,ux,ux,ux,cg,cg,ux,cr