cr,ur,ur,ur,ur,ur,ur,ur,ur,ur,ur,ur,ur,ur,ur,ur,ur,ur,ur,ur,ur,ur,cr
cb,ur,ur,ur,ur,ur,ur,ur,ur,ur,ur,ur,ur,ur,ur,ur,ur,ur,ur,ur,ur,ur,ub
ub,ur,ur,ur,ur,ur,ur,ur,ur,ur,ur,ur,ur,ur,ur,ur,ur,ur,ur,ur,ur,ur,cb
ub,ub,ub,ur,ur,ur,ur,cb,ur,ur,ur,ur,ur,ur,ur,ur,ur,ur,ur,ur,ur,ur,ur
ux,ub,ub,ur,ur,ur,ur,ub,ux,ur,ur,ur,ur,ur,ur,ur,ur,ur,ur,ur,ur,ur,ur
ux,ux,ux,ur,ur,ur,ur,ub,ur,ur,ur,ur,ur,ur,ug,ur,ur,ur,ur,ur,ur,cg,ur
ux,ux,ux,ur,ur,ur,ur,ub,ug,ur,cg,ur,ur,ur,cr,ur,ur,ur,ur,ur,cr,ug,ur
ux,ux,ux,ur,ur,ur,ub,ub,ub,ur,ug,ub,ub,ub,ug,ur,ur,ur,ur,ur,ur,ur,ur
cg,ux,ux,ur,ur,ub,ub,ub,ub,ub,ug,ug,ug,ug,ug,ur,ur,ur,ur,ur,ur,ur,ur
ur,ur,ur,ur,ur,ub,ub,ub,ur,ur,ug,ug,ub,ug,ur,ur,ug,ug,cr,ub,ux,cr,ur
ur,ux,ux,ur,ur,ub,ub,cb,ur,ur,ub,ug,ub,ug,ur,ur,ur,ug,ur,ur,ur,ur,ur
ur,ux,ux,ur,ug,ub,ub,ub,ub,ub,ub,ub,ug,ug,ug,ug,ug,ug,ub,ub,ub,ux,ur
ur,ur,ux,ug,ug,ur,ub,ug,ug,ug,ug,ub,ub,ub,ub,ub,ub,ub,ub,ux,ub,ub,ur
ur,ur,ux,ug,ur,ur,ug,ug,ub,ub,ub,ub,ub,ub,ub,ub,ub,ux,ux,ux,ub,ub,ur
cg,ux,ux,ug,ux,ux,ub,ub,ub,ux,ub,ub,ub,ux,ub,ub,ub,ux,ux,ux,ub,ux,ur
ux,ux,ux,ug,ug,ux,ux,ub,ub,ub,ub,ub,ub,ux,cb,ub,ub,ub,ux,ub,ub,ux,ur
ux,ux,ux,ux,ug,ug,ug,ug,ux,ux,ux,ux,ub,ub,ug,cg,ub,ub,ub,ub,ux,ux,ur
ux,ux,ux,ux,ux,ux,ux,ux,ux,ux,ux,ux,ux,ux,ub,ux,ub,ub,ux,ux,ux,ux,ur
ux,ux,ux,ux,ub,ub,ub,ub,ub,ub,ub,ub,ub,ub,ub,ux,ux,ub,ub,ux,ux,ux,ur
ux,ux,ux,ub,ub,ux,ux,ux,ux,ux,ux,ux,ux,ux,ur,ux,ux,ux,ub,ub,ux,ub,ur
ux,ux,ub,ub,ux,ux,ux,ux,ux,ux,ux,ux,ux,ux,ur,ux,ux,ux,ux,ub,ub,ub,ur
ux,ux,cb,ux,ux,ux,ux,ux,ux,ux,ux,ux,ux,ux,ur,ux,ux,ux,ux,ux,ub,ub,ur
ux,ux,ux,ux,ux,ux,ux,ux,ux,cg,ux,ux,ux,ux,ur,ur,ur,ur,ur,ur,ur,ur,ur