ux,cb,cb,cr,ur,ur,ur,cb,ub,ur,ur,ur,ur,ur,ur,ur,ur,ur,ur,ur,ux,ux,cb
ux,ux,cb,ur,ur,cr,cr,ur,ub,ub,ur,ur,ur,ur,ur,ur,ur,ur,ur,ur,ur,ux,ux
ux,ux,ur,ur,ur,ur,ur,ur,cr,cr,ur,ub,ub,ur,ur,ux,ur,ur,ur,ur,ur,ur,ur
ur,ur,ur,ur,ur,ur,ur,ub,ub,ur,ub,ub,ub,ub,ub,ug,ug,ug,ub,ub,ub,ur,ur
ur,ur,ur,ur,ur,ur,ur,ug,cg,ur,ug,ur,ur,ur,ub,ub,ug,ug,ug,ub,ub,ur,ur
ur,ur,ur,ur,ug,ug,ug,ug,ur,ur,ur,ur,ur,ur,ur,ur,ug,ug,ur,ub,ub,ux,ux
ur,ur,ur,ug,ug,ur,ur,ub,ur,cb,ur,ur,ur,ur,cr,ug,ug,ug,ug,ug,ug,ux,ux
cb,ur,ug,ug,ur,ur,ur,ub,ur,ub,cg,ur,ur,ur,ur,ub,ug,ug,ug,ur,ur,ur,ur
ur,ur,ug,ur,ug,ug,ur,ub,ub,ub,ug,ub,ug,ug,ug,ug,ug,ug,ux,ux,ur,ux,ur
ur,ur,ug,ug,ug,ug,ur,ug,cg,ug,ug,ug,ug,ug,ug,ug,ug,ug,ux,ux,ur,ux,ur
ur,ur,ur,ur,ur,ug,ug,ug,ug,ug,ug,ug,ug,ug,ug,ug,ug,ux,ug,ug,ur,ux,ur
ur,ur,ur,ur,ur,ug,ub,ug,ub,ug,ug,ug,ug,ug,ug,ug,ug,ug,cg,ux,ur,ux,ur
cb,ux,ux,ug,ug,ug,ug,ug,ug,ub,ub,ub,ub,ug,ug,ug,ur,ug,ug,ug,ur,ug,cg
ux,ux,ux,ug,cb,ub,ub,cb,ub,ub,ub,ub,ub,ux,ux,ug,ur,ug,ug,ux,ur,ux,ur
ux,ux,ux,ug,ug,ug,ub,ub,ub,ub,ub,ub,ub,ug,ug,ug,ur,ug,ug,ug,ur,ux,ur
ux,ux,ug,ug,ux,ug,ug,ub,ub,ub,ub,ub,ug,ug,ux,ux,ur,ug,ug,ug,ur,ux,ur
ux,ux,ug,ug,ux,ug,ug,ub,ub,ub,ub,ub,ub,ug,ux,ux,ur,ux,ux,ux,ur,ux,ur
ux,ug,ug,ug,ug,ug,ux,ug,ug,ub,ug,ug,ux,ug,ux,ux,ur,ux,ux,ux,ur,cr,ur
ux,ug,ug,ug,ug,ug,ux,ug,ug,ug,ug,ug,ug,ug,ux,ux,ur,ux,ux,ux,ur,ur,ur
cr,ug,ug,ug,ug,ug,ub,ug,ug,ug,ug,ub,ub,ub,ub,ub,ub,ub,ur,ur,ur,ur,ur
cg,ug,ug,ug,ug,ug,ug,ug,ug,ug,ub,ub,ub,ux,ux,ux,ur,ub,ux,ux,ux,ux,cr
cr,ug,ug,ug,ug,ug,ug,ug,ug,ug,ub,ub,ub,ur,ur,ur,ur,cb,ur,cb,cb,ux,cr
cg,ur,cg,cb,ux,ug,cg,ub,ux,ub,ub,ub,ub,ux,ux,cg,ur,ur,ur,cg,cg,cb,cr