ub,ub,ub,ub,ur,ur,ur,ur,ur,ux,ux,ux,ur,ur,cr,ub,cb,ur,ur,cg,ur,ug,ug
ub,ub,ux,ux,ur,ur,ur,ur,ur,ur,ur,ur,ur,ur,ur,ur,ur,cr,ub,ur,ub,ub,ub
ub,ub,cb,ub,ur,ur,ur,ur,ur,ur,ur,ur,ur,ur,ub,ur,ur,ur,cb,ug,ub,ug,ub
ub,ub,ur,ux,ur,ur,ur,ur,ur,ur,ur,ur,ur,ur,ub,ub,ub,ub,ub,ub,ub,ub,ub
ub,ur,ur,ur,ur,ug,ug,ug,cg,ur,ur,ur,ur,ur,ub,ug,ug,ug,ug,ug,ug,ub,ub
ur,ur,ur,ur,ur,ug,ur,ur,ur,ur,cr,ur,ur,ur,ug,ug,ub,ub,ub,ug,ug,ub,ub
ur,ur,ur,ur,ur,ug,ug,ug,cr,ur,ub,ur,ur,ub,ug,ub,ub,ub,ug,ug,ug,ub,ug
ur,ur,ur,ux,ur,ur,ux,ur,ur,ub,ub,ur,ur,ub,ug,ug,ub,ug,ug,ug,ug,ux,ug
ur,ur,ur,ur,ur,ur,ur,ur,cb,ub,ur,ur,ur,cr,ub,ug,ug,ug,ug,ug,ug,ux,ug
ur,ur,ur,ur,ur,cg,ur,ur,ur,ub,ug,ub,ub,ub,ub,ub,cg,ug,ug,ug,ug,ux,ug
ur,ur,ur,ub,ur,ug,ug,ur,ur,ur,ur,ur,ur,ub,ug,ug,ux,ux,ux,ug,ug,ug,ug
ux,ux,ux,ux,ur,ux,ug,ug,ug,ub,ug,ug,ur,cb,ub,ug,ug,ug,ux,ug,ux,ux,ux
ux,ux,ux,ug,ur,ux,ug,ug,ug,ug,ub,ub,cg,ug,ug,ug,ug,ug,ug,ug,ux,ux,ux
ux,ux,ux,ug,ur,ux,ux,ug,ux,ug,ub,ug,ur,ug,ug,ug,ug,ug,ug,ug,ug,ug,cg
ux,ux,ux,ug,ur,ux,ux,ug,ux,ug,ux,ug,cr,ug,ug,ug,ug,ug,ub,ub,ux,ux,ux
ux,ux,ux,ug,ur,ux,ux,ug,ux,ug,ux,ux,ux,ux,ug,ug,ug,ug,ub,ub,ub,ub,ub
ux,ux,ux,ug,ur,ug,ug,ug,ux,ug,ux,ug,ug,ux,ug,ug,ug,ug,ub,ub,ub,ub,ub
cg,ux,ux,ug,ur,ux,ug,ug,ux,ug,ux,ug,ux,ux,ug,ub,ug,ug,ub,ub,ub,ub,ub
ux,ux,ur,ur,ur,ug,ug,ug,ug,ug,ur,ur,ug,ug,ug,ug,ug,ug,ug,ug,ur,ur,ur
ux,ux,cb,ub,ub,ub,ub,ub,ub,ug,ug,ug,ug,ub,ux,ub,ub,ub,ub,ug,ub,ub,ur
cr,ug,ur,ug,ub,ub,ub,ub,ub,ub,ub,ub,ub,ub,ub,ur,ur,ur,ur,ur,ur,ur,ur
cg,ug,ur,ug,ug,ug,ur,ur,ur,ub,ur,ub,ub,ub,ub,ug,ug,ug,ug,ur,ur,cb,cr
cr,ug,ug,ub,ub,ub,ub,ub,ub,cb,ub,ub,ug,ub,ub,ug,ux,ux,ux,ux,cb,ux,cr