ur,ur,ur,ur,ur,ur,ur,ur,ur,ur,ur,cr,ux,ux,ux,ux,ur,ur,ur,ur,ur,cb,ur
ur,ur,ur,ur,ur,ur,ur,ur,ur,ur,ur,ur,ur,ur,ur,ur,ur,ur,ur,ur,ub,ub,ur
ur,ur,ur,ur,ur,ur,ur,ur,ur,ur,ub,ub,ub,ub,ub,ub,ub,ub,ub,ub,ub,ur,ur
ux,ur,ur,ur,ur,ur,ur,ur,ur,ux,ur,ur,ux,ur,ur,ur,ux,ur,ur,ur,ur,ur,ur
ux,ur,ur,ur,ur,ur,ur,ur,ur,ur,ur,ur,ur,ur,ur,ur,ur,ur,ur,ur,cb,ur,ur
ux,ur,ur,ur,ur,ur,ur,ur,ur,ur,ur,ux,ux,ur,ur,ub,cr,ur,ur,ur,ub,ub,ur
ux,ur,ur,ur,ur,ur,ur,ur,ur,ur,ur,ur,ur,ur,ur,cb,ur,ub,ub,ub,ub,ub,ur
ux,ur,ur,ur,ur,ur,ur,ur,ur,ur,cg,ug,ug,cr,ur,ur,ub,ub,ub,ub,ub,ub,ub
cg,ub,ux,ur,ur,cg,ur,ur,ur,ur,ur,ur,ur,ur,ur,ur,ub,ur,ur,ur,ur,ur,ur
ux,ub,ux,ur,ur,ug,ur,ur,ur,ur,ur,ur,ur,ur,ur,ur,ux,ux,ux,ux,ur,ur,ur
ub,ub,ux,ur,ur,ug,ur,ur,ur,cr,ur,ur,ur,ur,ug,ub,ub,ux,ux,ux,ur,ub,ux
ub,ux,ux,ur,ur,cr,ug,ug,ub,ub,ug,ug,ub,ub,ug,ub,ub,ux,ux,ux,ur,ux,ux
ub,ur,ur,ub,ug,ug,ur,ur,ub,ub,ug,ug,ub,ub,ub,ub,ux,ux,ux,ux,ux,ux,ux
ub,ub,ur,ub,ug,ug,ur,ur,ub,ug,ug,ub,ub,ug,cb,ub,ub,ub,ub,ux,ux,ux,ux
cg,ub,ur,ub,ug,ug,ug,ug,ug,ug,ug,ub,ub,ug,ub,ug,ug,ug,ug,ug,ux,ux,ux
ux,ub,ux,ub,ug,ug,ub,ub,ug,ux,ub,ub,ub,ug,ub,ub,ub,ub,ub,ug,ux,ux,ux
ub,ub,ux,ub,ux,ub,ub,ux,ug,ux,ux,ux,ub,ub,ub,ub,ub,ub,ub,ux,ux,ux,ux
ub,ub,ur,ur,ur,ub,ub,ur,ug,ub,ub,ub,cb,ub,ug,ug,ug,ug,ur,ur,ur,ur,ur
ur,ub,ux,ub,ux,ub,ub,ux,ug,ur,ur,ur,ub,ur,ur,ur,ur,ur,ur,ur,ur,ur,ur
ur,ux,ux,cg,ug,ug,ug,ug,ug,ub,ub,ux,ub,ub,cr,ub,ux,ux,ux,ux,ux,ur,ur
ur,ux,ub,ub,ux,ux,ub,ub,ub,ux,ux,ux,ux,ur,ur,ux,ux,ux,ux,ux,ux,ur,ur
ur,ub,ub,ux,ux,ux,ub,ub,ub,ux,ux,ux,ux,ur,ur,ur,ur,ur,ur,ur,ur,ur,ur
ur,ur,ur,ur,ur,ur,ub,ub,cb,cg,ux,ux,ux,ur,ur,ur,ur,ur,ur,ur,ur,ur,ur