ur,ur,ur,ur,ur,ur,cr,ug,ug,ur,ur,ur,ur,ur,ur,ur,ur,cb,ur,ur,ur,ur,ur
ur,ur,cb,ur,ur,ur,ur,ur,ug,ur,ub,cg,ub,ub,ub,ur,ur,ur,ur,ur,ur,ur,ur
ur,ur,ub,ur,ur,ur,ur,ur,cg,ur,ur,cr,ug,ub,ub,cr,ub,ur,ur,ur,ur,ur,ur
ur,ux,ub,ub,ub,ub,ub,ub,ur,ur,ub,ub,ug,ub,ub,ub,ub,ur,ur,cr,ur,ux,ur
ur,ur,ur,ur,ur,ur,ug,ug,ur,ug,ur,ug,ug,ur,ur,ur,ur,ur,ub,ub,ur,ur,ur
ug,ur,ug,ux,ug,ug,ug,ug,ug,ug,ug,ug,ur,cr,ur,ur,ur,ur,ug,ug,ug,ux,ux
ug,ux,ug,ux,ug,ug,ug,ug,ug,ux,ux,ur,ur,ub,ub,ug,ug,ux,ux,ux,ug,ux,ux
ug,ux,ug,ux,ux,ug,ug,ug,ug,ux,ux,ux,ur,ur,ub,ub,ug,ug,ux,ux,ug,ux,ux
ug,ux,ug,ug,ug,ug,ug,ur,ub,ub,ux,ux,ub,ub,ub,ub,ug,ug,ub,ux,ug,ux,ux
ug,ug,ux,ux,ux,ux,ug,ug,ug,ub,ux,ub,ub,ub,ug,ug,ug,ug,ux,ux,ug,ug,ux
ux,ug,ux,ux,ux,ux,ub,ub,ug,ug,ub,ub,ub,ub,ub,cb,ub,ug,ux,ux,ux,ug,ux
ux,ug,ux,ux,ug,ug,ug,ug,ug,ug,ug,ub,ub,ub,ub,ub,ub,ub,ub,ub,ub,ug,ux
ux,ug,ux,ux,ug,ug,ug,ug,ur,ur,ug,ub,ub,ub,ub,ub,ub,ub,ur,cb,ub,ur,ur
ux,ug,ux,ux,ug,ug,ug,ug,ug,ug,ug,ux,ub,ub,ug,ug,ug,ub,ub,ub,ub,ub,ur
cg,ug,ux,ux,ug,ug,ug,ug,ub,ub,ub,ub,ub,ub,ug,ub,ub,cb,ux,ux,ux,ub,ur
ur,ur,ur,ur,ur,ur,ur,ur,ur,cr,ub,ub,ub,ub,ub,ub,ug,ux,ux,ux,ux,ub,ur
ur,ug,ux,ux,ug,ug,ug,ug,ug,ub,ub,ub,ub,ub,ub,cg,ug,ux,ux,ux,ux,ub,ur
ur,ug,ux,ux,ug,ub,ug,ug,ug,ux,ux,ux,ux,ux,ux,ux,ux,ux,ux,ux,ux,ub,ur
cb,ug,ux,ux,ug,ug,ug,ug,cg,ub,ub,ub,ub,ub,ux,ux,ux,ux,ux,ux,ux,ub,ur
ub,ug,ux,ux,ub,ux,ux,ur,ur,ux,ux,ux,ux,ub,ub,ub,ub,ub,ub,ub,ub,ub,ur
ub,ub,ub,ub,ub,ur,ur,ur,ur,ur,ur,ur,ur,ur,ur,ur,ur,ur,ur,ur,ur,ur,ur
cr,ub,ub,ub,ub,ux,ux,ur,ur,ux,ux,ux,ux,ux,ux,ux,ux,ux,ux,ux,ux,ux,cb
cg,ub,ub,ux,ub,ub,ub,ur,ur,cg,ub,ub,ub,ub,ub,ub,ub,ub,ub,ub,ub,ub,cb