ur,ur,ur,ur,ur,cr,ur,cr,ur,cb,ub,ub,ur,ur,ur,ur,ur,ur,ur,ur,ur,ur,ur
ur,ur,ur,ur,ur,ur,ub,ur,ur,ur,ux,ub,ur,cr,ux,ur,ur,ur,ur,ur,ur,ur,ur
ur,ur,ur,ur,ur,ur,ur,ur,ub,ub,ub,ub,ur,ux,ux,ur,ur,ur,ur,ur,ur,ur,ur
ur,ug,ur,ur,ur,ur,ug,ur,ug,ug,ug,ug,ur,ur,ur,ur,ug,ug,ug,ur,ur,ur,ur
ur,ug,cr,ur,ur,ur,ur,ur,ug,ug,ub,ub,ur,ur,ug,ug,ug,ux,cg,ux,ux,ux,ug
ur,ug,ur,ug,cg,ur,ug,ug,ug,ug,ug,ub,ug,ug,ug,ux,ux,ux,ub,ux,ux,ux,ug
ur,ug,ug,ug,ur,ur,ug,ug,ur,ur,ug,ux,ux,ux,ux,ux,ux,ux,ub,ux,ux,ux,ug
ur,ur,ug,cr,ur,ur,ur,ug,ug,ug,ug,ux,ub,ub,ub,ug,ug,ug,ub,ub,ub,ux,ug
cg,ur,ur,ur,ub,ur,ur,ug,ub,ug,ug,ug,ug,ug,ug,ug,ug,ug,ub,ub,ub,ub,ub
ur,ur,ur,ur,ur,ur,ux,ug,ub,ug,ug,ux,ux,ub,ub,ub,ug,ug,ub,ux,ux,ux,ub
ur,ux,ux,ur,ub,ub,ux,ug,ug,ug,ub,ub,ub,ub,ub,ug,ug,ux,ub,ub,ub,ub,ub
ur,ux,ux,ur,ux,ub,ub,ug,ug,ub,ub,cb,ub,ub,ub,ug,ux,ux,ux,ux,ux,ux,ub
ur,ux,ux,ur,ux,ux,ug,ug,ub,ub,ub,ub,ub,ub,ub,ub,ux,ux,ux,ux,ux,ux,ub
ur,ux,ux,cr,ub,ux,ug,ux,ug,ub,ub,ub,ub,ub,ub,ub,ux,ux,ux,ux,ux,ux,ub
ur,ux,ux,ux,ub,ub,ug,ub,ug,ub,ub,ub,ub,ub,ub,cb,ux,ux,ux,ux,ux,ux,ub
ur,ux,ux,ux,ux,ub,ug,ux,ug,ub,ub,cb,ub,cg,ug,ug,ux,ux,ux,ux,ux,ux,ub
ur,ux,ux,ux,ux,ux,ug,ug,ug,ux,ub,ub,ub,ug,ug,ub,ub,ux,ux,ux,ux,ux,ub
ur,ux,ux,ux,ux,ux,ub,ug,ub,ub,ux,ux,ux,ug,ug,ub,ub,ux,ux,ux,ux,ux,ub
ur,ux,ux,ux,ux,ux,ub,ug,ug,ub,ub,ub,ub,ub,ub,ub,ux,ux,ux,ux,ux,ux,ub
ur,ux,ux,ux,ux,ux,ub,ub,ub,ub,ub,ub,ub,ub,cb,ub,ux,ux,ux,ux,ux,ux,ub
ur,ux,ux,ux,ux,ub,ub,ub,ub,ub,ub,ub,ub,ub,ub,ub,ux,ux,ux,ux,ux,ux,ub
ur,ux,ux,ux,ux,ub,ux,ub,ub,ux,ub,ub,ux,ux,ux,ux,ux,ux,ux,ux,ux,ux,ub
ur,ur,ur,ur,ur,ur,cb,ub,ub,ub,ub,ub,ub,ub,ub,ub,ub,ub,ub,ub,ub,ub,ub