ur,ur,ur,ur,ur,ur,ur,ur,ur,cg,cr,ur,ur,ur,ur,ur,ur,cb,ur,ur,ur,ub,cb
ur,ur,ur,cr,ur,ur,ug,ur,ur,ur,ug,ur,ur,ur,ur,ur,ur,ur,ug,ug,ub,ub,cb
ur,ur,cr,ub,ur,ur,ur,ur,ur,ur,ug,ur,ur,ur,ur,ur,ur,ur,ug,ub,ub,ub,ub
ub,ub,ur,ur,ur,ur,ur,ur,ur,ub,cg,ub,ur,ur,ur,ug,ug,ug,ug,ub,ub,ub,ux
ur,ub,ub,ub,ur,ub,ur,ub,cg,ug,ur,ur,ur,ur,ur,ug,ur,ur,ux,ub,ub,ug,ux
ur,ur,ub,ur,ub,ub,cr,ub,ub,ug,ub,ub,ub,ub,ux,ug,ug,ug,ug,ub,ub,ug,ux
ur,ur,ub,ub,ub,ub,ub,ub,cb,ug,ub,ub,ub,ug,ug,ug,ug,ug,ug,ub,ub,ug,ux
ur,ur,ub,ub,ub,ux,ub,ub,ub,ub,ub,ug,ug,ub,ux,ug,ug,ug,ug,ub,ub,ug,ux
ur,ur,ux,ug,ug,ug,ug,ug,ub,ub,ub,ug,ug,ug,ug,ug,ub,ub,ub,ub,ub,ug,ux
ur,ur,ur,ug,ur,ur,ur,ux,ub,ub,ug,ug,ug,ug,ub,ug,ub,ub,ub,ub,ub,ug,ux
ur,ur,ur,ug,cr,ur,ux,ux,ub,ub,ub,ug,ug,ug,ub,ug,ux,ug,ug,ug,ux,ug,ux
ur,ur,ur,ur,ur,ub,ub,ub,ub,ub,ub,ug,ug,ug,ug,ug,ux,ub,ub,ub,ub,ug,ux
ur,ur,ur,ug,ur,ub,ub,ub,ub,ub,ub,ub,ub,ub,ug,ux,ub,cg,ug,cb,ub,ub,cg
ux,ux,ux,ug,ug,ug,ug,ub,ub,ur,ur,cg,ug,ug,ug,ug,ug,ug,ub,ub,ur,ug,ur
ux,ux,ub,ub,ub,ug,ug,ub,ub,ug,ux,ug,ug,ub,ug,ub,ug,ug,ug,ug,ug,ug,ux
ux,ub,ub,ub,ub,ub,cb,ub,ug,ug,ub,ub,ub,ux,ug,ub,ub,ub,ux,ux,ur,ur,ur
ux,ux,ux,ux,ux,ub,ub,ub,ug,ug,ux,ug,ug,ug,ug,ug,ub,ux,ux,ux,ur,ur,ur
cg,ur,ur,ur,ur,ur,ur,ur,ur,ur,ug,ug,ug,ug,ug,ur,ur,ur,ur,ur,ur,ux,ux
ub,ur,ug,ux,ux,ug,ug,ux,ug,ug,ug,ug,ux,ux,ux,ug,ug,ux,ux,ux,ur,ux,ux
ub,ur,ug,ub,ux,ur,ug,ug,ug,ug,ub,ub,ug,ug,ug,ug,ug,ux,ux,ux,ur,ux,ux
ub,ur,ub,ub,ub,ur,ux,ux,ub,ub,ub,ux,ux,ux,ux,ux,ug,ux,ux,ux,ur,ux,ux
cr,ur,ub,ub,ub,ur,ug,ub,ub,ub,ug,ug,ug,ug,ug,ug,ug,ux,ux,ux,ur,ux,cb
cg,ur,ur,cr,ub,ub,ub,cb,ub,ub,ur,ur,ur,ur,ur,ur,ur,ur,ur,ur,ur,ur,ur