ur,ur,ux,ux,ux,ur,ur,ur,ux,ux,ux,ux,ux,ux,ux,ux,ur,cb,ur,ur,ur,ur,ur
ur,ur,ux,ux,ux,ur,ur,ur,cr,ur,ux,ux,ux,ux,ux,ux,ur,ur,ur,ur,ur,ur,ur
ur,ur,ur,ur,ur,ur,ur,ur,ur,ur,ur,ux,ux,ux,ux,ux,ur,ur,ur,ur,ur,ur,ur
ur,ur,ux,ur,ur,cr,ur,ur,ur,ur,ur,ux,ur,ur,ur,ur,ur,ur,ur,ur,ur,ur,ur
ur,ur,ur,ur,ur,ub,cb,ur,ur,ur,ur,ur,ur,ur,ur,ur,ur,ur,ur,ur,ur,ur,ur
ur,ur,ur,ur,ug,ug,cr,ur,ur,ur,ur,ur,ur,ug,ug,ug,ug,ug,ug,ug,ur,ur,ur
ur,ur,ur,ub,cb,ug,cg,ur,ur,ur,ur,ur,ur,ug,ug,ug,ug,ug,ur,ug,ur,ux,ux
ur,ur,ur,ub,ur,ur,ur,ur,ur,ur,ur,ur,ur,ug,ug,ug,ug,ug,ug,ug,ur,ux,ux
ur,ub,ub,ub,ur,ur,ur,ur,ur,ub,ub,ug,ug,ug,ug,cg,ug,ug,ux,ux,ux,ux,ux
ur,ub,ur,ur,ur,cr,cr,ur,ur,ub,ub,ub,ub,ug,ug,ux,ug,ux,ux,ux,ux,ux,ux
ub,ub,ur,ur,cb,ub,ub,ub,ur,ub,ug,ug,ub,ux,ug,ux,ug,ux,ux,ux,ux,ux,ux
ur,ur,ur,ub,ub,cb,ub,ug,ur,ub,ug,ub,ub,ug,ug,ux,ug,ux,ux,ux,ux,ux,ux
ur,ur,ur,cr,ub,ub,ug,ug,ub,ub,ub,ub,ub,ug,ug,ug,ug,ux,ux,ux,ux,ux,ux
ur,ur,ur,ur,ub,ub,ug,ug,ug,ug,ub,cb,ub,ub,ux,ug,ug,ux,ux,ux,ux,ux,ux
cg,ug,ug,ug,ub,ub,ub,ub,cg,ub,ux,ux,ub,ub,ux,ug,ug,ux,ux,ux,ux,ux,ux
ux,ux,ux,ug,ub,ub,ub,ub,ur,ux,ug,ug,ug,ug,ug,ug,ug,ux,ux,ux,ux,ux,ux
ux,ux,ux,ug,ub,ub,ux,ux,ur,ux,cb,ux,ug,ug,ug,ug,ug,ux,ux,ux,ux,ux,ux
ux,ux,ux,ug,ux,ug,ux,ux,ub,ub,ub,ub,ub,ux,ug,ux,ur,ux,ub,ub,ux,ux,ux
ux,ux,ux,ug,ub,ug,ug,ub,ub,ub,ub,ub,ub,ub,ub,ug,ur,ub,ub,ux,ux,ux,ux
ux,ux,ux,ug,ub,ux,ux,ub,cg,ub,ub,ub,ub,ub,ub,ux,ur,ux,ux,ux,ux,ux,ux
ux,ux,ub,ug,ux,ux,ux,ub,ug,ub,ub,ux,ub,ub,ub,ub,ub,ub,ub,ub,ub,ux,ux
cr,ur,ur,ug,ur,ur,ur,ub,ug,ub,ub,ub,ub,ub,ub,ub,ub,ub,ub,ux,ub,ux,cb
cg,ur,ur,ug,ug,ug,ug,ug,ug,cg,ux,ub,ub,ux,ux,ub,ub,ur,ub,ub,ub,ux,ux