cb,cb,cb,cr,ur,ur,ur,ur,ur,ur,ur,ur,ur,ur,ur,ur,ur,ur,ur,cb,ur,cr,cb
ur,ur,ur,cg,ug,ur,ur,ur,ur,ur,ur,ur,ur,ur,ur,ur,ur,ur,ur,ub,cg,ug,ug
ur,ur,cr,ur,ug,ur,ur,ur,ur,ur,ur,cg,ug,ug,ug,ug,cr,ur,ur,ur,ug,ug,ug
ur,ug,ug,ur,ur,ur,ur,ur,ur,ur,ur,ur,ur,ur,ur,ur,ur,ur,ug,ur,ur,ub,ug
ur,ug,ug,ug,ur,ur,ur,cg,ug,ug,ug,ur,ur,ur,ur,ur,ug,ug,ug,ug,ug,ug,ug
ur,ur,ur,cr,ub,ug,ub,ub,ub,ur,ug,ur,ur,ur,ur,ur,ug,ug,ug,ug,ug,ug,ug
ur,ur,ur,ur,ub,ub,ub,cb,ub,ux,ug,cr,ur,ur,ur,ug,ug,ux,ug,ug,ug,ug,ug
cb,ur,ur,ur,ux,ux,ux,ub,ub,ub,ub,ug,ug,ug,ug,ug,ux,ux,ug,ug,ug,ug,ug
ur,ur,ur,ur,ub,ub,ub,ub,ub,ub,ub,cb,ub,ug,ug,ug,ux,ux,ug,ug,ug,ug,ug
ur,ur,ur,ub,ub,ux,ux,ub,ug,ub,ub,ub,ub,ug,ug,ux,ux,ux,ug,ug,ub,ub,ug
ug,ug,ug,ug,ux,ux,ux,ub,cb,ub,ug,ub,ug,ug,ug,ug,ug,ub,ub,ub,ub,ub,ug
ug,ug,ug,ug,ux,ux,ug,ug,ug,ug,ug,ug,ug,ug,ug,ux,ug,ub,ub,ub,ub,ub,ug
cb,ux,ux,ug,ux,ux,ug,ug,ug,ug,ug,ug,ub,ub,ub,ub,ug,ux,ux,ux,ux,ub,ug
ug,ug,ug,ug,ux,ux,ug,ug,ug,ug,ug,ug,ug,ux,ux,ub,ub,ub,ub,ub,ub,ub,ug
ug,ug,ux,ux,ux,ux,ux,ux,ux,ug,ug,ug,cg,ux,ux,ug,ug,ux,ux,ux,ux,ug,ug
ux,ug,ux,ux,ux,ux,ux,ub,ub,ub,ub,ub,ub,ug,ux,ux,ug,ux,ux,ux,ux,ux,ug
ux,ug,ug,ux,ux,ux,ub,ub,ux,ux,ux,ub,ub,ub,ub,ub,ub,ub,ur,ur,ur,ur,ug
cr,ux,ug,ux,ux,ux,ub,ux,ux,ux,ux,ub,ub,ub,ub,ub,ub,ub,ux,ux,ux,ux,ug
cg,ux,ug,ug,ux,ux,ub,ux,ux,ux,ux,ux,ux,ug,ug,ug,ug,ug,ug,ug,ug,ug,ug
cb,ur,ur,ur,ur,ur,ub,ub,ub,ub,ub,ub,ub,ub,ub,cb,ur,ur,ur,ur,ur,ur,ur
ux,ur,ux,ux,ux,ux,ux,ux,ux,ux,ux,ux,ux,ux,ux,ux,ux,ux,ux,ux,ux,ux,cr
cr,ur,ur,ur,ur,ur,ur,ur,ur,ur,ur,ur,ur,ur,ur,ur,ur,cb,cg,ux,cb,ux,cr
cg,cb,cg,cb,ux,ux,ux,ux,ux,ux,ux,ux,ux,ux,ux,cg,ur,cr,ur,cg,cg,ux,cr