ub,ub,cr,ux,ux,ux,ur,ur,ur,ur,ur,ub,cb,ur,ur,ur,ur,cb,ur,ur,ur,ur,cg
cb,ur,ur,ux,ux,ug,ug,ur,ur,ur,ur,ub,ur,ur,ur,ur,ur,ur,ur,ur,ur,ur,ug
ur,ur,ur,cr,ur,cg,ug,ur,ug,ug,cg,cr,ur,ur,ur,ub,ub,ur,ur,ur,ur,ug,ug
ur,ur,ur,ur,ur,ur,ug,ur,ug,ug,ug,ug,ur,ur,ur,ug,ub,ur,ur,ur,ux,ug,ug
ur,ur,ur,ur,ur,ur,cr,ug,ug,ug,ug,ub,ub,ug,ub,ug,ub,ur,ur,ur,ug,ub,ug
ur,ur,ur,ur,ur,ur,cb,ub,ub,ub,ub,ug,ug,ug,ub,ub,ub,ur,ur,ur,ug,ug,ug
ub,ub,ub,ug,ug,ug,ug,ub,ub,cb,ub,ur,ug,ub,ub,ug,ug,ur,cr,ur,ub,ug,ug
ub,ub,ur,ur,ug,ub,ub,ub,ub,ub,ug,ug,ug,ub,ub,ug,ug,ur,ug,ur,ub,ug,ug
ux,ub,ur,ur,ug,ub,ub,ug,ux,ux,ux,ux,ug,ub,ug,ug,ug,ur,ug,cr,ub,ug,ug
ux,ub,ub,ur,ug,ub,ub,ug,ug,ug,ux,ux,ug,ub,ub,ug,ug,ur,ug,ux,ub,ug,ug
ux,ub,ub,ug,ug,ub,ux,ux,ug,ug,ub,ub,ub,ub,ub,ug,ux,ur,ug,ux,ub,ug,ug
ur,ub,ub,ug,ug,ub,ux,ux,ug,ub,ub,cb,ub,ub,ub,ug,ug,ur,ug,ug,ug,ug,ug
ub,ub,ub,ub,ug,ug,ug,ug,ug,ub,ub,ub,ub,ub,ub,ux,ux,ur,ux,ux,ux,ug,cg
ub,ub,ub,ub,ub,ub,ux,ux,ub,ub,ub,ub,ub,ub,cb,ub,ux,ur,cg,ug,ug,ug,ug
ux,ux,ux,ux,ux,ux,ux,ux,ux,ub,ub,ub,ub,ub,ug,ub,ux,ur,ux,ux,ug,ug,ug
ux,ux,ux,ux,ux,ux,ux,ux,ux,ub,ub,ub,ux,ux,ug,ug,ug,ug,ug,ug,ug,ug,ux
ux,ug,ug,ug,ug,ug,ug,ug,ug,ux,ux,ub,ux,ux,ux,ux,ug,ur,ux,ux,ux,ug,ux
cg,ux,ux,ux,ux,ux,ux,ux,ug,ug,ug,ug,ug,ug,ug,ug,ug,ur,ug,ux,ux,ug,ux
ur,ur,ur,ur,ur,ur,ur,ur,ur,ur,ur,ur,ur,ur,ur,ur,ur,ur,ug,ug,ug,ug,ux
ur,ux,ux,ux,ux,ux,ux,ux,ux,ux,ux,ux,ur,ur,ur,ur,ur,ur,ux,ur,ur,ur,ur
ur,ur,ur,ur,ur,ur,ur,ur,ur,ur,ur,ur,ur,ur,ur,ur,ur,ur,ux,ur,ur,ur,ur
cr,ux,ux,ux,ux,ux,ux,ux,ux,ux,ux,ux,ur,ur,ur,ur,ur,ur,ux,ur,ur,cb,cr
cg,ux,ux,ux,ux,ux,ux,ux,ux,ux,ux,ux,ux,ux,ux,ux,ux,ux,ux,cg,cb,ux,cr