ur,ur,ur,ur,ur,ur,ur,ur,ur,ur,ur,ur,ur,ur,ur,ur,ur,cb,ur,ur,ur,ur,ur
ur,ur,ur,ur,ur,ug,ug,ug,ug,ux,ur,ur,ur,ur,ur,ur,ur,ur,ur,ur,ur,ur,ur
ur,ur,cr,ur,ur,ug,ur,ur,ug,ur,ur,ur,ur,ur,ur,ur,ur,ur,cr,ug,ug,ug,ur
ur,ur,ug,ug,ug,ug,ug,ug,ug,ur,ur,ur,ur,ur,ur,ur,ur,ur,ug,ug,ug,ug,ur
ur,ur,ug,ur,ur,ur,ur,ur,ur,ur,ur,ur,ur,ur,ur,ur,ur,cb,ub,ug,ug,ug,ur
cr,ur,cg,ur,ur,ur,ur,ur,ur,ur,cg,ug,ug,ug,ur,ur,ur,ub,ub,ug,ug,ug,ur
ub,ub,ur,ur,ur,ur,ur,ur,ur,cr,ux,ug,ux,ug,cr,ur,ug,ug,ub,ug,ug,ug,ur
ur,ub,ur,ug,ux,ub,ug,ub,ub,ub,ux,ug,ux,ug,ug,ug,ug,ug,ub,ub,ug,ug,ur
cb,ub,ur,ug,ug,ub,ug,ux,ug,ug,ux,ug,ux,ug,ug,ug,ub,ub,ug,ub,ug,ug,ug
ur,ur,ur,ub,ug,ug,ug,ux,ug,ug,ub,ug,ub,ug,ug,ug,ub,ug,ux,ub,ux,ux,ug
ux,ux,ub,ub,ub,ub,ux,ux,ux,ux,ub,ub,ub,ug,ug,ub,ub,ub,ub,ub,ug,ux,ug
ux,ux,ub,ub,ub,ub,ux,ux,ux,ub,cb,ub,ub,ub,ub,ub,cb,ub,ub,ub,ug,ux,ug
ux,ux,ub,ub,ub,ub,ux,ub,ub,ub,ub,ub,ub,cg,ub,ub,ub,ub,ub,ub,ug,ug,ug
ux,ux,ub,ub,ub,cb,ux,ux,ub,ub,ub,ub,ux,ug,ub,ug,ub,ub,ub,ub,ux,ug,ug
cg,ux,ub,ub,ub,ug,ug,ub,ub,ux,ub,ub,ug,ug,ug,ug,ux,ub,ub,ub,ux,ug,ug
ur,ur,cb,ub,ub,ub,ub,ub,ur,ur,ub,ug,ug,ug,ug,ug,ub,ub,ub,ub,ux,ug,ug
ur,ux,ub,ub,ux,ux,ug,ux,ux,ux,ub,ub,ux,ug,ub,ub,ub,ub,ub,ub,ux,ug,ug
ur,ux,ub,ub,ux,ux,ug,ug,ug,ux,ub,ub,ub,ub,ub,ub,ub,ur,ub,ub,ux,ug,ug
ur,ux,ub,ub,ux,ux,ux,ux,ug,ug,ug,cg,ux,ux,ux,ub,ub,ur,ub,ux,ux,ug,ug
ur,ux,ub,ub,ux,ux,ux,ux,ux,ux,ub,ub,ub,ux,ux,ub,ub,ur,ub,ux,ux,ug,ug
ur,ur,ur,ub,ub,ub,ub,ub,ub,ub,ub,ub,ub,ub,ub,ub,ub,ur,ub,ug,cr,ug,ug
cr,ux,ub,ub,ux,ux,ux,ug,ux,ux,ub,ub,ub,ux,ux,ux,ux,ur,ub,ux,ur,ux,cb
cg,ux,ub,ub,ug,ug,ug,ug,ux,cg,ub,ux,ux,ux,ux,ux,ux,ur,ur,ur,ur,ur,ur