ur,ur,cb,cr,ux,ux,ux,ur,ur,ur,ur,ur,cr,ub,ub,ur,ur,ur,cr,cg,ur,ur,ur
ur,ur,ur,ur,ur,ur,ur,ur,ur,ur,ur,ur,ur,ur,ub,ur,ur,ur,ub,ub,ub,cb,ur
ur,ux,ux,ux,ur,ur,ur,ur,ur,ur,ur,ur,ur,ur,ub,ur,ur,ur,ur,ur,ur,ur,ur
ur,ur,ug,ug,ur,cb,ub,ub,ub,ub,ub,ur,ur,cg,ub,ur,ur,ug,ur,ur,ur,ug,cr
ur,ur,ug,ur,ur,ur,ur,ur,ur,ub,ub,ur,ug,ug,ub,ub,ub,ug,ur,ux,ux,ug,ur
ur,ur,ug,ur,ur,ur,ur,ur,ur,ub,ub,ur,ug,ug,ur,ur,ub,ug,ur,ur,ur,ug,ur
ur,ur,ug,ur,ur,ur,ur,ur,ur,ub,ub,cb,ug,ug,ub,ub,cb,ub,ub,cg,ug,ug,ub
ur,ur,cr,cr,ur,ur,ur,ur,ub,ub,ur,ur,ug,ug,ub,ug,ug,ug,ug,ux,ux,ux,ux
ur,ur,ur,ur,ur,ur,ur,ur,ur,ur,ur,ur,ur,ur,ub,ug,ux,ug,ux,ux,ux,ux,ux
ur,ur,ur,ub,ub,ur,ur,ug,ux,ux,ug,ux,ux,ub,ub,ub,ug,ux,ux,ux,ux,ux,ux
ur,ur,ur,ug,ug,ug,ug,ug,ux,ug,ug,ug,ux,ub,ub,ub,ub,ug,ug,ux,ux,ux,ux
ur,ur,ur,ug,ug,ug,ug,ux,ux,ug,ug,ug,ug,ug,ug,ug,ug,ug,ub,ub,ux,ux,ux
cg,ux,ux,ug,ug,ux,ub,ug,ug,ug,ug,ug,ug,ug,ug,ub,cg,ug,ub,ub,ux,ux,ux
ux,ux,ux,ug,ug,ux,ug,ug,ub,ug,ug,ug,ug,ug,ug,ug,ub,ub,ub,ub,ub,ub,ux
ux,ux,ux,ug,ug,ux,ug,ug,ug,ug,ug,ug,ug,ug,ug,ub,ub,ux,ux,ux,ux,ub,ub
ux,ux,ux,ug,ug,ug,ug,ug,ug,ug,ug,ug,ug,ug,ug,ub,ub,ux,ux,ux,ux,ub,ub
ux,ux,ux,ug,ug,ug,ug,ug,ug,ug,ug,ug,ug,ur,ux,ug,ux,ux,ux,ux,ux,ub,ub
cg,ux,ux,ug,ux,ug,ug,ug,ug,ug,ug,ux,ug,ur,ux,ug,ux,ug,ug,ub,ub,ub,ub
ux,ux,ux,ug,ub,ug,ug,ug,ux,ub,ug,ug,ug,ur,ux,ug,ux,ub,ub,ub,cb,ub,ub
ux,ux,ux,ug,ux,ux,ug,ug,ug,ug,ug,ug,ug,ur,ux,ug,ux,ug,ug,ux,ub,ub,ub
cr,ur,ur,ug,ug,ug,ug,ug,ug,ug,ug,ug,cg,ur,ur,ur,ur,ur,ur,ur,ur,ub,ub
cg,ur,ux,ux,ux,ux,ux,ux,ux,ux,ux,ux,ur,ub,ux,ux,ux,ux,ux,ux,ux,cb,cr
cr,ur,ur,ur,ur,ur,ur,ur,ur,ur,ur,ur,ur,cb,ux,ux,ux,ux,ux,ux,cb,ux,cr