ux,ux,ur,ur,ur,ur,ur,ur,ur,cr,ug,ug,ur,ur,ur,ur,ur,cb,ur,ur,ur,cb,ub
ux,ur,ur,ur,ur,ur,ur,ur,ur,ur,ur,ug,ur,ur,ur,cr,ur,ur,ug,ur,ur,ur,ub
ux,ur,ur,ur,ur,ur,ur,ur,cr,ug,ur,cg,ur,ur,ug,ug,ug,ur,cr,ur,ur,ub,ub
ux,ur,ux,ur,cg,ur,ug,ur,ur,ug,ur,ur,cr,ur,ug,ur,ug,ur,ur,ur,ur,ub,ub
ux,ur,ux,ur,ug,ug,ur,ur,ur,ur,ur,ug,ur,ub,ug,cb,ur,ur,ug,ug,ux,ub,ub
ux,ur,ux,ux,ux,ug,ur,ug,ug,ur,ur,ur,ur,ur,ug,ub,ub,ub,ug,ux,ux,ub,ub
ur,ur,ux,ux,ux,ug,ur,ur,ug,ug,ux,ux,ub,ub,ug,ub,ub,ub,ug,ux,ux,ub,ub
ur,ur,ur,ur,ur,ug,ug,ug,ug,ug,ug,ug,ug,cg,ug,ug,ug,ug,ug,ub,ux,ub,ub
ur,ur,ur,ux,ux,ug,ux,ux,ux,ux,ux,ux,ux,ub,ub,ub,ub,ub,ub,ub,ux,ub,ub
ur,ux,ur,ux,ux,ug,ux,ux,ux,ux,ux,ux,ux,ub,ug,ub,ub,cb,ub,ub,ux,ub,ub
ur,ur,ur,ux,ux,ug,ug,ux,ux,ux,ug,ug,ug,ug,ug,ug,ug,ub,ub,ub,ub,ub,ub
ux,ux,ux,ux,ux,ug,ug,ub,ub,ub,ub,ub,ub,ug,ug,ug,ug,ug,ux,ux,ub,ub,ub
ux,ux,ux,ux,ux,ug,ux,ub,ub,cb,ub,ub,ub,ub,ug,ub,ug,ug,ux,ux,ub,ub,ub
ux,ux,ux,ux,ux,ug,ux,ub,ub,ub,ub,ub,ub,ub,ug,ub,ux,ub,ub,ux,ub,ub,ub
cg,ux,ux,ux,ux,ug,ug,ub,ub,ub,ug,ug,ug,ug,ug,ug,ug,ux,ub,ux,ub,ug,ub
ub,ub,ub,ub,ux,ug,ub,ub,ub,ug,ug,ug,ug,ug,ug,ug,cg,ub,ub,ux,ub,ug,ub
ub,ux,ux,ub,ub,ug,ub,ub,ub,ub,ug,ug,ug,ug,ug,ug,ug,ug,ug,ur,ub,ur,ub
ub,ub,ub,ub,ub,ub,ub,ub,ub,ub,ub,ub,ub,ub,ub,ug,ug,ug,ug,ub,ub,ur,ub
ub,ux,ux,ux,ux,ug,ux,ux,ux,ux,ux,ux,ux,ux,ux,ux,ux,ux,ux,ur,ur,ur,ub
ub,ux,ux,ub,ub,ub,ux,ub,ub,ub,ub,ub,ub,ub,ub,ub,ub,ub,ub,ub,ub,ur,ub
ub,ub,ub,ub,cb,ur,ur,ub,ub,ub,ub,ub,ub,ub,ub,ub,ub,ub,ub,ur,ub,ub,ub
cr,ux,ux,ux,ux,ur,ux,ux,ub,ub,ub,ub,ub,ub,ub,ub,ub,ub,ur,ur,ub,ub,cb
cg,ux,ux,ux,ux,ur,cr,ub,ub,cg,cb,ub,ub,ub,ub,ub,ub,ub,ur,ur,ub,ub,ur