ur,ur,ub,cr,ur,cr,cr,ur,ur,cg,cr,ur,ur,ur,ur,ux,ux,cb,ux,ux,ux,ur,ur
ur,ur,ub,ub,ub,cb,ur,ur,ug,cg,ux,ux,ux,ux,ur,ux,ux,ux,ux,ux,ux,ur,ur
ur,ur,ur,ur,ur,ur,ur,ur,ug,ur,ur,ur,ub,ub,ur,ub,ub,ub,ub,ub,ub,ur,ur
ur,ur,ur,ur,cr,ug,ug,ug,ug,ur,ur,ur,cb,ub,ur,ux,ub,ux,ux,ux,ug,ur,ur
ur,ur,ub,ug,ub,ug,ur,ur,ur,ur,ur,ur,ug,ub,ub,ux,ub,ux,ux,ub,ug,ur,ur
ur,ur,ur,ug,ug,ug,ur,ug,ug,ur,ur,ur,ug,cg,ub,ub,ub,ux,ux,ub,ug,ur,ur
ub,ub,ub,ug,ug,ug,ug,ug,ug,ub,ub,ub,ux,ux,ux,ux,ub,ux,ux,ub,ub,ur,ur
ub,ux,ub,ub,ug,ug,ug,ug,ug,ug,ub,ub,ub,ub,ub,ub,ub,ux,ux,ub,ux,ur,ur
ub,ur,ub,ug,ug,ug,cb,ug,ug,cg,ub,ub,ub,ub,ub,ub,ub,ub,ub,ub,ux,ur,ur
ub,ux,ub,ub,ux,ug,ub,ug,ug,ub,ub,ux,ub,ub,ub,ux,ub,ub,ub,ug,ux,ur,cr
ub,ux,ur,ub,ub,ug,ub,cb,ux,ub,ub,ub,ub,ub,ub,ub,ub,ub,ub,ug,ug,ur,ug
ub,ux,ub,ub,ub,ug,ub,ub,ub,ub,ub,ub,ub,ub,ub,ug,ug,ub,ux,ug,ug,ur,ug
ub,ux,ub,ub,ub,ub,ub,ug,cb,ub,ub,ux,ub,ub,ug,ug,ub,ub,ub,ug,ux,ur,ux
ub,ux,ux,ug,ux,ug,ug,ug,ug,ug,ug,ub,ub,ug,ug,ug,cg,ub,ub,ug,ux,ur,ux
ub,ux,ux,ug,ug,ug,ug,ub,ug,ug,ug,ux,ub,ug,ug,ug,ug,ug,ub,ug,ux,ur,ux
ub,ux,ux,ug,ug,ug,ug,cg,ug,ug,ug,ub,ub,ub,ug,ug,ug,ug,ub,ug,ux,ur,ux
ub,ub,ub,ug,ug,ug,ug,ug,ug,ug,ug,ub,ub,ub,ug,ug,ub,ug,ux,ug,ux,ur,ux
ur,ur,ub,ug,ug,ug,ug,ug,ug,ug,ub,ub,ub,ub,ug,ug,ug,ug,ux,ug,ux,ur,ux
ur,ux,ub,ug,ug,ug,ug,ug,ub,ub,ub,ub,ub,ub,ug,ug,ub,ub,ux,ug,ux,ur,ux
ur,ux,ub,ub,ux,ub,cb,ux,ub,ux,ux,ub,ux,ub,ub,ub,ub,ub,ux,ug,ux,ur,ux
ur,ur,ub,ub,ub,ub,ug,ug,ub,ug,ug,ug,ug,ub,ub,ub,ub,ub,ux,ug,ub,ur,ux
cr,ux,ub,ub,ub,ub,ub,ub,ub,ux,ux,ux,ux,ux,ur,ub,ub,ub,ug,ug,ub,ur,cb
cg,ux,ub,ub,ub,ub,ub,ub,ub,ub,ub,ub,ub,ub,ur,ur,ur,ur,ur,ur,ur,ur,ur