ur,ur,ur,ur,ur,ur,ur,ur,ur,ur,ur,ur,ur,ur,ur,ur,ur,ur,ur,ux,ux,ub,ub
cr,ur,ur,ur,ur,ur,ur,ur,ur,ur,ur,ur,ur,ur,cr,ur,ur,ur,ur,ux,ub,ub,ub
ug,ur,ur,ux,ur,ur,ur,ur,ur,ur,ur,ur,ur,ur,ur,cr,ub,ub,ub,ub,ub,ur,cr
ug,ur,ur,ur,ur,ur,ur,ur,ur,ur,ur,ur,ur,ur,ur,ur,ur,ur,ur,ur,ux,ur,ur
ug,ug,ug,ur,ur,ur,cb,ub,ub,ub,ur,ur,ub,ur,ur,ur,ur,ur,ur,ur,ur,ur,ur
ug,ug,ur,ur,ur,ur,ur,ur,ux,ub,ub,ub,ub,ur,ur,ur,ur,ur,ur,ur,ur,ur,ur
ug,ug,ur,ur,ur,ur,ur,ur,ub,ur,ur,ub,ub,ub,ub,ug,ug,ug,cg,ur,ur,ur,ur
ug,ug,ur,ur,ur,ur,ur,ur,ur,ur,ur,ur,ur,ug,ug,ug,ur,ug,ur,ur,ur,ur,ur
ug,ug,ug,ug,ur,cb,ub,ub,ur,ur,ur,ub,ub,cr,ug,ug,ur,ug,ug,ur,ur,ur,ur
cg,ug,ug,ug,ub,ub,ub,ub,ub,ub,ub,ub,ur,ur,ug,ug,ur,ur,ug,ur,ur,ur,ux
ux,ug,ug,ug,ub,ub,ub,ug,ug,ux,ub,ub,ub,ur,cg,ug,ug,ug,ug,ur,ur,ur,ux
ux,ug,ug,ug,ux,ug,ux,ug,ug,ur,ub,ub,ub,ur,ur,ur,ur,ur,ur,ur,ur,ur,ux
ux,ug,ug,ug,ug,ug,ux,ug,ug,ub,ub,ub,ub,ur,ur,ur,ug,ux,ux,ux,ux,ur,ux
ux,ug,ug,ub,ug,ug,ug,ug,ub,ub,ub,ub,ub,ub,ur,ur,ug,ug,ug,ux,ux,ur,ux
ux,ug,ug,ug,ug,ug,ug,ug,ug,ug,ub,ub,ur,cb,ur,ur,ug,ug,ug,ux,ux,ur,ux
ub,ug,ug,ug,ub,ub,ug,ug,ug,ub,ub,ub,ur,ur,ur,ur,ug,ur,ur,ur,ur,ur,ux
ub,ux,ux,ux,ux,ux,ug,ug,ug,ub,ub,ub,ug,ur,ur,ur,ug,ug,ug,ur,ur,ur,ux
ub,ux,ux,ux,ux,ux,ux,ux,ux,ux,ux,ux,ur,ur,ur,ur,ur,ur,ug,ur,ur,ur,ux
ub,ub,ub,ub,ub,ub,ub,ub,ub,ub,ub,ux,ur,ur,ur,ur,ur,ur,ur,ur,ur,ur,ux
ub,ub,ub,ub,ub,ub,ub,ub,ub,ub,ub,ux,ur,ur,ur,ur,ur,ur,ur,ur,ur,ur,ux
ub,cb,ub,ux,ux,ub,ub,ub,ub,ub,ub,ub,ub,ub,ub,ur,ur,ur,ur,ur,ur,ur,cr
ub,ub,ub,ub,ub,ub,ub,ub,ub,ux,ux,ux,ux,ux,ux,ux,ux,ur,ux,ux,ur,ur,ur
cb,ux,ux,ux,ux,ux,ux,ux,ub,ub,ub,ub,ub,ub,ub,ub,ub,ur,ur,ur,ur,cb,ur