ur,ur,ur,ur,ur,ur,ur,ur,ur,ux,ux,ux,ux,ux,ux,ux,ur,ur,ur,ur,ur,ur,ur
ur,ur,ur,ur,ur,ur,ur,ur,ur,ux,ur,ur,ur,ur,ur,ur,ur,ur,ur,ur,ur,ur,ur
ur,ur,ur,ur,ur,ur,cr,ub,ub,ub,ub,ub,ub,ub,ub,ub,cb,ur,ur,ur,ur,ur,ur
ux,ur,ur,ur,ur,ur,ur,ur,ur,ux,ur,ur,ux,ur,ur,ur,ur,ur,ur,ur,ur,ur,ur
ux,ur,ur,ur,ur,ur,ur,ur,ur,ur,ur,ur,ur,ur,ur,ur,ur,ur,ur,ur,ur,ur,ur
ux,ur,ur,ur,ur,ur,ur,ur,ur,ur,ur,ur,ur,ur,ur,ur,ur,ur,ur,ur,ur,ur,ur
ux,ur,ur,ur,ur,ur,ur,ur,ur,ur,ur,ur,ur,ur,ur,cr,cb,cb,ur,ur,ur,ur,ur
ux,ur,ur,ur,ur,ur,ur,ur,ur,ur,ur,ur,ur,ur,ur,ub,ub,ub,ub,ub,ub,ub,ub
cg,ub,ux,ur,ur,ur,ur,ur,ur,ur,ur,ur,cr,ur,cr,cg,ub,ur,ur,ur,ur,ur,ur
ux,ub,ur,ur,ur,ur,ur,ur,ur,ur,ur,ur,ub,ub,ug,ug,ux,ux,ux,ux,ur,ur,ur
ub,ub,ur,ub,ug,ug,ug,cr,ur,ux,ug,ug,ux,ub,ug,ub,ub,ux,ux,ux,ur,ub,ub
ub,ur,ur,ub,ug,ug,ug,ug,ub,ub,ug,ug,ub,cb,ug,ub,ub,ux,ux,ux,ur,ux,ub
ub,ur,ur,ub,ug,ug,ur,ur,ub,ub,ug,ug,ug,ug,ug,ub,ux,ux,ux,ux,ur,ux,ub
ub,ub,ur,ub,ug,ug,ur,ur,ub,ug,ug,ub,ub,ug,ug,ub,ub,ub,ub,ux,ur,ux,ub
cg,ub,ur,ub,ug,ug,ug,ug,ug,ug,ug,ub,ub,ug,ub,ug,ug,ug,ug,ug,ur,ub,ub
ux,ub,ux,ub,ug,cg,ub,ub,ug,ux,ub,ub,ub,ug,ub,ub,ub,ub,ub,ug,ur,ux,ux
ub,ub,ux,ub,ux,ub,ub,ux,ug,ux,ux,ux,ub,ug,ug,ug,cb,ub,ub,ux,ur,ur,ur
ub,ub,ur,ur,ur,ub,ub,ur,cg,ub,ub,ub,ub,ub,ug,ug,ug,ug,ur,ur,ur,ur,ur
ur,ub,ux,ub,ux,ub,ub,ux,ub,ur,ur,ur,ur,ur,ur,ur,ur,ur,ur,ur,ur,ur,ur
ur,ux,ux,ub,ux,ux,ub,ub,ub,ub,ub,ux,ub,ub,ub,ub,ux,ux,ux,ux,ux,ur,ur
ur,ux,ub,ub,ux,ux,ub,ub,ub,ux,ux,ux,ux,ur,ux,ux,ux,ux,ux,ux,ux,ur,ur
ur,ub,ub,ux,ux,ux,ux,cb,ub,ux,ux,ux,ux,ur,ux,ux,ux,ux,ux,cr,ur,ur,ur
ur,ur,ur,ur,ur,ur,ur,ur,ur,cg,ux,ux,ux,ur,ur,ur,ur,ur,ur,ur,ur,ur,ur