ux,ux,cb,ur,ur,ur,ur,ur,ur,ur,ur,ur,ux,ux,ux,ux,ux,ux,ux,cg,ur,ur,ur
ux,ux,ur,ur,ur,ur,ur,ur,ur,cr,cr,ub,ub,cb,ur,ur,ur,ur,ux,ux,ur,ur,ur
ur,ur,ur,ur,ur,ur,ur,ur,ur,ur,ur,ur,ux,ux,ur,ur,ur,cb,ub,ub,cr,ur,ur
ur,ug,ug,ug,ug,ug,ug,ur,ur,ur,ur,ur,ur,ur,ur,ur,ur,ur,ur,ur,ur,ur,ur
ur,cg,ur,ur,ur,ur,ug,ur,ur,ur,ur,cg,ur,ur,ux,ug,ur,ug,ug,ur,ur,ur,ur
ur,ur,ur,ur,ur,ug,ug,ur,ur,ur,ur,ug,ug,ur,ug,ug,ug,ur,ug,ur,ur,ur,ur
ur,ur,ur,ur,ur,ur,ur,ur,ur,ur,ur,ur,ug,ur,ug,ur,ug,ur,ug,ug,ur,ur,ur
cr,cr,ur,ux,ur,ur,ur,ur,ur,ur,ub,ug,ug,ug,ug,ug,ug,ug,ug,ug,ug,ur,ur
ux,ux,ux,ur,ur,ur,ub,ug,ug,ug,ug,ur,ur,ur,ur,ug,ub,ug,ur,ur,ug,ux,ux
ux,ux,ux,ux,ur,ur,ub,ug,ub,ub,ug,ux,ub,ub,ux,ug,ug,ug,ug,ug,ug,ux,ux
ux,ux,ux,ux,ug,ug,ug,ug,ug,ug,ug,ug,ub,ug,ug,ug,ug,ug,ug,ur,ur,ur,ur
ux,ux,ux,ux,ub,ug,cg,ug,ux,ug,ug,ug,ub,ug,ux,ug,ug,ug,ug,ug,ub,ux,ur
cg,ux,ux,ux,ub,ux,ux,ug,ug,ug,ug,ug,ug,ug,ug,ug,ug,ux,ux,ug,ub,ub,ur
ux,ux,ux,ux,ub,ub,ux,ux,ug,ub,ub,ub,ug,ug,ux,ug,ub,ug,ug,ug,ub,ub,ur
ux,ux,ux,ux,ub,ub,ub,ub,ug,ub,cb,ub,ux,ug,ug,ug,ub,ug,ug,ub,ub,ub,ub
ux,ux,ux,ux,ux,ub,ub,ub,ub,ub,ug,ug,ux,ug,ug,ug,ub,ub,ug,ub,ub,cb,ub
ux,ux,ux,ux,ux,ub,ub,ub,ug,ub,ug,ug,ux,ug,ug,ug,ug,ug,ug,ub,ub,ub,ub
cg,ux,ux,ux,ux,ub,ub,ub,ux,ub,ub,ug,ux,ug,ug,ug,ug,ug,ug,ub,ub,ub,ub
ux,ux,ux,ux,ub,ub,ub,ug,ug,ub,ug,ug,ux,ug,ux,ug,ub,ub,ub,ub,cb,ub,ub
ux,ux,ux,ux,ux,ux,ub,ub,ub,ub,ux,cg,ug,ug,ux,ug,ub,ug,ug,ux,ub,ub,ub
cr,ur,ur,ur,ur,ur,ur,ur,ur,ur,ur,ur,ur,ur,ur,ur,ur,ur,ur,ur,ur,ub,ub
cg,ur,ux,ux,ux,ux,ux,ux,ux,ux,ux,ux,ux,ub,ux,ur,ub,ub,ub,ub,ub,cb,cr
cr,ur,ur,ur,ur,cr,ux,ux,ux,ux,ux,ux,ux,cb,ur,ur,ub,ub,ub,ub,cb,ux,cr