ux,ux,ur,ur,ur,ur,ur,ur,ur,ur,ur,ur,ur,ur,ur,ur,ur,ur,ur,cr,ur,ur,ur
ux,ux,ur,ur,ur,ur,ur,ur,ur,ur,ur,ur,ur,ur,ur,ur,ur,ur,ur,ub,cb,ur,ur
ur,ux,ur,ur,ur,ur,ur,ur,ur,ur,ur,ur,ux,ur,ur,ur,ux,ur,ur,ur,ur,ur,ur
ur,ur,ur,ur,ur,ur,ur,ur,cr,ug,ug,ur,ur,ur,ur,ur,ur,ur,ur,ur,ur,ur,ur
ur,ur,ur,ur,ur,ur,ur,ur,ur,ur,ug,ur,ur,ur,ur,ur,ur,ur,cb,ur,ur,ur,ur
ur,ur,ur,ur,ur,ur,ur,ur,ur,ug,ug,ug,cg,ur,ur,ur,ur,ub,ub,ur,ur,ur,ur
ur,ur,ur,ur,ur,ur,ur,ur,ur,ug,ug,ug,ug,ub,cr,ub,ub,ub,ub,ub,ub,ux,ux
ur,ur,ur,ur,ur,ur,ur,ur,ur,ug,ur,ug,ug,ub,ug,ub,ub,ub,ub,ub,ub,ux,ux
ur,ur,ur,ur,ux,ur,ur,ur,ug,ub,ur,cb,ub,ub,ub,ub,ub,ug,ub,ux,ux,ux,ux
ur,ur,ur,ur,ur,ur,ur,cr,ug,ub,ub,ub,ub,ug,ug,ug,ug,ug,ux,ux,ux,ux,ux
ub,cr,ur,ur,ur,ug,ug,ug,ub,ub,ub,ub,ub,ug,ug,ug,ug,ug,ux,ux,ux,ux,ux
cg,ub,ub,ur,ur,ug,ug,ug,ug,ug,ug,ub,ub,ub,ux,ux,ug,ub,ux,ux,ux,ux,ux
ug,ub,ub,ur,ur,ur,ug,ug,cg,ug,ug,ug,ug,ug,ug,ug,ug,ub,ub,ux,ux,ux,ux
ug,cb,ub,ug,ux,ug,ug,cg,ub,ub,ub,ub,ug,ug,ug,ub,ux,ux,ux,ux,ux,ux,ux
ub,ug,ub,ug,ux,ug,ug,ug,ug,ub,ub,ub,ug,ub,ub,ub,ub,ub,ub,ux,ux,ux,ux
ub,ug,ub,ug,ug,ug,ug,ug,ug,ub,ub,ux,ug,ub,ux,ub,ub,ub,ub,ux,ux,ux,ux
ux,ug,ug,ux,ug,ug,ug,ug,ux,ug,ub,ug,ug,ub,ub,ub,ub,ub,ub,ux,ux,ux,ux
ux,ug,ug,ux,ug,ug,ug,ug,ug,ug,ug,ug,ub,ub,ub,cb,ub,ub,ur,ur,ux,ux,ux
ur,ug,ur,ur,ur,ur,ur,ur,ur,ur,ug,ug,ur,ug,ug,ug,ug,ug,ur,ur,ux,ux,ux
ur,ug,ug,ug,ug,ug,ug,ug,ug,cr,ug,ug,ub,ug,ug,ug,ux,ug,ug,ur,ux,ux,ux
ur,ur,ug,ux,ux,ux,ug,ux,ux,ur,ur,ug,ub,ug,ug,ug,ux,ur,ug,ug,ur,ur,ur
ur,ur,ur,ur,ur,ur,ur,ur,ur,ur,ur,ug,ug,ug,ug,ug,ug,ug,ug,ug,ur,ur,ur
ur,ur,ur,ur,ur,ur,ur,ur,ur,ur,ur,ug,ug,ug,ug,ub,ur,ur,ur,ur,ur,cb,ur