ur,ur,ur,ur,ur,ur,ur,ur,ur,ur,ur,ur,cr,ub,ub,ur,ur,cb,ub,ub,ur,ub,cg
ur,ur,ur,ur,ur,ux,cr,ur,ur,ur,ur,cb,ur,ur,cb,ur,ur,ur,ub,ug,ug,ug,ug
ur,ur,ur,ur,ur,ur,cr,ur,ur,ur,ur,ub,ub,cr,ur,ub,ug,ug,ug,ug,ug,ug,ug
ur,ur,ur,ur,ux,ur,ur,cb,ub,ur,cg,ug,ug,ug,ur,ug,ug,ub,ub,ug,ux,ug,ug
ur,ur,ur,ur,ur,ur,ur,ur,ub,ub,ub,ub,ub,ug,ub,ug,cg,ux,ub,ug,ug,ub,ug
ux,ur,ur,ur,ur,cg,cr,ur,ur,ur,ug,ug,ug,ug,ub,ub,ux,ux,ub,ub,ug,ug,ug
ub,cb,ur,ur,ug,cb,ub,ug,ug,ur,ug,ur,ug,ub,ub,ug,ug,ug,ug,ux,ub,ug,ug
ub,ub,ur,ur,ur,ub,ub,ub,ub,ub,ug,ug,ug,ub,ux,ug,ug,ug,ug,ux,ub,ug,ug
ur,ub,ur,ur,ub,ub,ub,ux,ug,ux,ux,ub,ug,ug,ug,ug,ug,ug,ug,ux,ub,ug,ug
ur,ub,ub,ur,ub,ub,ub,ub,ub,ux,ux,ub,ug,ub,ug,ug,ug,ug,ug,ux,ub,ug,ug
ur,ub,ub,ug,ub,ub,ug,ub,ub,ub,ub,ub,ub,ub,ug,ug,ux,ug,ug,ux,ub,ug,ug
ur,ub,ub,ug,ub,ub,ux,ug,ub,ub,ug,ug,ub,ub,ub,ug,ug,ug,ug,ug,ug,ug,ug
ub,ub,ub,ub,ub,ub,ub,ub,ug,ub,ug,ub,ub,ub,ub,ux,ux,ux,ux,ux,ux,ug,cg
ub,ub,ub,ub,ub,ub,ub,ub,ub,ub,ub,ub,cb,ub,ub,ub,ux,ux,ux,ux,ux,ug,ug
ux,ux,ux,ux,ux,ug,ug,ug,ug,ub,ub,ub,ub,ub,ub,ub,ux,ux,ux,ux,ux,ug,ug
ub,ux,ux,ux,ux,ux,ux,ux,ub,ub,ub,ub,ux,ux,ub,ub,ux,ux,ux,ux,ux,ug,ub
ub,ug,ug,ug,ug,ug,ug,ug,ug,ub,ub,ub,ub,ux,ux,ux,ug,ug,ux,ux,ux,ug,ub
cg,ug,ux,ux,ux,ux,ux,ub,ug,ug,ug,ug,ug,ug,ug,ug,ug,ug,ug,ur,ur,ug,ur
ur,ur,ur,ur,ur,ur,ur,ur,ur,ur,ur,ur,ur,ur,ur,ur,ur,ur,ug,ug,ug,ug,ur
ur,ug,ux,ux,ux,ux,ux,ub,ub,ub,ub,ux,ur,cr,ux,ux,ux,ux,ur,ur,ur,ur,ur
ur,ur,ur,ur,ur,ur,ur,ur,ur,ur,ur,ur,ur,ur,ur,ur,ur,ur,ur,ur,ur,ur,ur
cr,ux,ux,ux,ux,ux,ux,ux,ux,ub,ur,ur,ur,ur,ur,ur,ur,ur,ur,ur,ur,cb,cr
cg,ux,ux,ux,ux,ux,ux,ux,ux,ux,ux,ur,ur,ur,ur,ur,ur,ur,ur,cg,cb,ux,cr