ur,cb,cb,cr,ur,ur,ux,ux,ur,cr,ur,ur,ur,ur,ur,ur,ur,ur,ur,ur,ur,ur,cb
ur,cb,cb,ur,ur,ux,ux,cg,ug,ug,ub,ur,ur,ur,ur,ur,ur,ur,ur,ur,ur,ur,ur
ur,ur,ur,ur,ux,ux,ur,ur,ur,ub,ub,cr,ur,ur,ur,ur,ur,ur,ur,ur,ur,ur,ur
ur,ur,ur,ux,ux,ux,ur,ur,ur,ub,ub,ub,ur,ur,ur,ur,ur,ur,ur,cr,ur,ur,ur
ur,ur,ur,ur,ur,ug,ug,ug,ug,ub,ub,ub,cb,ug,cg,ur,ur,cg,ug,cr,ur,ur,ur
ux,ux,ux,ux,ur,ug,ug,ug,ur,ug,ur,ur,ur,ur,ur,ur,ur,ur,ur,ur,ur,ur,ur
ux,ux,ux,ux,ur,ug,ug,ug,ug,cg,cr,ur,ur,ur,ur,ug,ug,ux,ur,ur,ur,ur,ur
cb,ux,ux,ur,ur,ug,ug,ur,ug,ug,ug,ug,ug,ug,ur,ur,ug,ur,ur,ur,ur,ur,ur
ux,ux,ux,ur,ur,ug,ug,ur,ur,ur,ur,ur,ur,ur,ur,ur,ug,ur,ur,ur,ur,ur,ur
ux,ux,ux,ur,ur,ur,ur,ur,ur,ur,ug,ug,ub,ug,ug,ub,ug,ug,ur,ur,ur,ug,ug
ur,ur,ur,ur,ur,ur,ur,ur,ub,ub,ub,ub,ub,ug,ug,ug,ub,ub,ub,ub,ub,ub,cb
ur,ur,ur,ur,ur,ub,ub,ub,ub,ub,ub,ub,ub,ug,ug,ug,ux,ux,ux,ux,ug,ug,ug
cb,ux,ux,ux,ux,ub,ug,ug,ub,ub,ug,ub,cb,ug,ug,ug,ux,ux,ux,ux,ug,ug,ug
ub,ub,ub,ub,ub,ub,ug,ug,ub,ub,ub,ub,ug,ug,ug,ug,ux,ux,ug,ug,ug,ug,ug
ub,ub,ub,ux,ub,ub,ug,ug,ub,ub,ub,ub,cg,ug,ub,ug,ub,ub,ub,ub,ub,ub,ux
ub,ub,ub,ub,ug,ug,ub,ub,ub,ub,ub,ub,ub,ug,ug,ug,ub,ub,ub,ub,ux,ub,ux
ub,ub,ug,ug,ug,ug,ug,ug,ug,ug,ug,ub,ux,ux,ux,ux,ux,ux,ux,ub,ux,ub,cb
ub,ug,ug,ug,ug,ug,ug,ug,ub,ug,ug,ux,ux,ux,ux,ux,ux,ux,ux,ub,ux,ub,ur
cg,ug,ug,ug,ub,ub,ux,ug,ux,ug,ug,ux,ux,ux,ux,ux,ux,ux,ux,ub,ux,ub,ur
ug,ug,ug,ug,ug,ub,ub,ub,ub,ur,ur,ur,ur,ur,ur,ur,ur,ur,ur,ur,ur,ur,ux
cr,ux,ug,ug,ug,ub,ub,ug,cb,ug,ug,ux,cr,ur,ur,ur,ur,ur,ur,ur,ur,ur,cr
cg,ux,ug,ug,ug,ub,ub,ux,ux,ux,ug,ux,ux,ux,ux,ux,ux,ux,ux,cb,cb,ur,cr
cr,cg,cg,cb,ug,ub,ub,ux,ux,ux,ux,ux,ux,ux,ux,cg,ux,ux,ux,cg,cg,ur,cr