ur,ur,ur,ur,ur,ur,ur,ur,ur,ur,ur,ur,ur,ur,ur,cr,ub,ur,ur,ur,ur,cr,ub
ur,ur,ur,ur,ur,ur,cr,ug,ug,cg,ub,ur,ur,ux,ux,ux,ub,ur,ur,ur,ur,cr,cb
ub,ub,ub,ub,ub,cb,ur,ur,ur,ur,ub,ur,ur,ur,ur,ur,ub,ur,ur,ur,ur,ur,ur
ub,ur,ur,ur,ur,ur,ug,ug,ug,ug,ug,ur,ur,ur,ur,ur,ub,ur,ur,ur,ur,ur,ur
cr,ur,ur,ux,ux,ug,ug,ux,ur,ur,ug,ug,ur,ur,ux,ur,ub,ub,cb,ur,ur,ur,ur
ur,ur,ur,ux,ux,ug,ug,ug,ur,ur,ub,ug,ur,ur,ur,ur,ur,ur,ur,ur,ur,ur,ur
ur,ur,ur,ur,ur,ur,ur,ug,ur,ur,ub,ug,ug,ug,cg,ub,ub,ur,ur,ur,ur,ur,ux
ur,ur,ur,ur,ur,ur,ur,ur,ur,ub,ub,ub,ur,ur,ug,ug,ux,ur,ur,ur,ub,ub,ux
ur,ur,ur,ur,ur,ur,ur,ur,ug,ub,ug,ub,ug,ug,ug,ug,ug,ur,ur,ur,ub,ur,ur
ur,ur,ur,ur,ur,ug,ug,ub,ub,ub,ub,ub,ug,ug,ux,ux,ug,ug,ux,ux,ug,ux,ur
cg,ug,ug,ug,ug,ug,ug,ug,ug,ug,ub,ub,ug,ug,ug,ug,ug,ug,ux,ux,ug,ux,ur
ub,ub,ub,ur,ur,ug,ub,ub,ug,ug,ub,cb,ub,ub,ub,ug,ug,ug,ux,ux,ug,ux,ur
ub,ub,ub,ur,ur,ug,ug,ug,ug,ub,ub,ub,ub,ub,ub,ug,ug,ug,ux,ux,ug,ux,ur
ug,ux,ub,ub,ug,ug,ur,ug,ub,ub,ub,ub,ub,ub,ug,ug,ug,ug,ux,ux,ug,ux,ur
ug,ux,ux,ux,ug,ug,ur,ux,ub,ub,ub,cb,ub,ub,ux,ux,ux,ux,ux,ux,ug,ux,ur
ug,ux,ux,ux,ug,ug,ug,ug,ub,ub,ug,ub,ub,ub,ux,ux,ux,ux,ux,ux,ug,ux,ur
ug,ux,ux,ux,ux,ux,ug,ux,ux,ux,ug,ub,ub,ub,ux,ux,ux,ux,ux,ux,ug,ux,ur
ur,ur,ur,ur,ur,ur,ur,ur,ur,ur,ur,ur,ur,ur,ur,ur,ur,ur,ur,ur,ur,ur,ur
ur,ux,ux,ux,ux,ux,ur,ux,ux,ux,ux,ux,ux,ug,ux,ux,ux,ux,ux,ux,ux,ux,ux
ur,ux,ux,ux,ux,ux,ur,ux,ux,ux,ux,ux,ux,ug,ux,ux,ux,ux,ux,ux,ux,ux,ux
ur,ux,ux,ux,ux,ux,ur,ux,ux,ux,ux,ux,ux,ug,ux,ux,ux,ux,ux,ux,ux,ux,ux
ur,ur,ur,ur,ur,ur,ur,ur,ur,cr,ug,ug,ug,ug,ux,ux,ux,ux,ux,ux,ux,ux,ux
ur,ur,ur,ur,ur,ur,ur,cg,ux,ux,ux,ux,ux,ux,ux,ux,ux,ux,ux,ux,ux,cb,ux