ur,ur,cb,ur,ur,ur,ur,ur,ur,cr,ur,ur,ur,ur,ur,ur,ux,ux,ux,cg,cr,ur,cg
ur,ur,ur,ur,ur,ur,ur,cr,ur,ur,ub,cr,ur,ur,ur,ur,ur,ux,ux,ux,ux,ur,ug
ur,ur,ur,ur,ur,ur,cb,ub,ur,ur,ub,ub,ub,cb,ur,ug,ug,ug,ub,ux,ux,ur,ug
ur,ur,ur,ur,ug,ur,ub,ur,ur,ur,ur,ur,ur,ur,ug,ug,ug,ug,ub,ux,ux,ur,ug
ur,ub,ub,ur,ur,cr,ux,ug,ur,ug,ur,ug,ur,cr,ur,ug,ub,ub,ub,ux,ux,ur,ug
ux,ub,ub,ub,ub,ub,ub,ug,ur,ur,ur,ux,ux,ux,ur,ug,ub,ub,ur,ur,ur,ur,ur
ug,ug,ug,ur,ur,ub,ug,ug,ug,ub,ub,ug,ux,ub,ub,ug,ug,ug,ug,ub,ur,ur,ur
ug,ub,ub,ub,ur,ub,ux,ux,ug,ub,ub,ug,ux,ub,ug,ug,ux,ub,ug,ux,ur,ur,ur
ug,ug,ug,ug,ug,ug,ug,ug,ug,ug,ub,ub,ub,ub,ug,ug,ug,cg,ug,ux,ur,ur,ur
ux,ux,ux,ux,ur,ur,ur,ux,ug,ug,ug,ug,ug,ug,ug,ux,ux,cg,ub,ub,ub,ur,ur
cb,ub,ub,ub,ub,ub,ub,ub,ug,ug,ug,ug,ub,ug,ug,ug,ug,ub,ub,ub,ub,ur,ur
ux,ux,ux,ux,ux,ux,ug,ug,ug,ux,ub,ub,ub,ub,ub,ug,ub,ub,ux,ux,ub,ur,ur
ux,ux,ux,ux,ux,ux,ug,ug,ug,ux,ux,ux,ub,ub,ub,ub,cb,ub,ux,ux,ub,ur,ur
ux,ux,ux,ux,ux,ux,ug,ug,ug,ug,ug,ug,ug,ug,ug,ug,ub,ub,ux,ux,ub,ur,ur
ux,ug,ug,ub,ug,ug,ug,ug,ux,ux,ux,ux,ux,ub,ub,ub,ug,ub,ub,ux,ub,ur,ur
cg,ug,ug,ux,ux,ug,ux,ug,ug,ux,ux,ux,ux,ug,ug,ub,ug,ug,ub,ux,ub,ur,ur
ux,ug,ug,ux,ux,ug,ux,ux,ug,ug,ux,ux,ux,ug,ug,ug,ug,ug,ub,ux,ub,ur,ur
ux,ug,ug,ug,ug,ug,ug,ug,ug,ug,ug,ug,ub,ug,ug,ug,ug,cg,ux,ux,cb,ur,ur
ux,ug,ug,ug,ug,ug,ug,ug,ug,ug,ug,ug,ub,ux,ux,ux,ux,ub,ub,ub,ur,ur,ur
ux,ug,ug,ug,ug,ug,ug,ug,ub,ug,ug,ug,ux,ux,ux,ux,cb,ub,ub,ub,ub,ur,ur
cr,ug,ug,ug,ug,ug,ug,ug,ug,ug,ug,ub,ux,ux,ux,ux,ub,ub,ub,ub,ub,ur,ur
cg,ug,ug,ug,ug,ug,ug,ug,ug,ug,ug,cg,ux,ux,ub,ub,ub,ub,ub,ub,ub,cb,cr
cr,ug,ug,ug,ug,ug,ug,ug,ug,ug,ug,ug,ub,ub,ub,ux,ux,ux,ur,ur,cb,ux,cr