ur,ur,ur,ur,ur,ur,ur,ur,ur,ur,ur,ux,ur,ur,ur,ur,ur,ur,ub,cg,ur,ur,ur
ur,ur,ur,ur,ur,ur,ur,ur,ur,ur,ur,ur,ur,ur,ur,ur,ur,ur,ur,ur,ur,ur,ur
ur,cr,ur,ur,ur,ur,ur,ur,ub,ub,ur,ub,ub,ug,ur,ur,ur,ur,ur,ur,ur,ur,ur
ug,ub,ug,ur,ur,ur,ur,ur,ub,ur,cr,ur,cr,ur,ur,ur,ur,ur,ur,cr,ur,ur,ur
ug,ur,ub,ur,ur,ub,ub,ub,ub,ur,ur,ub,ub,ur,ub,ur,ug,ug,ug,ug,ug,cg,ur
ug,ur,ub,cr,ug,ub,ub,ub,cb,ub,ur,cb,ub,ur,ur,ur,ur,ub,ub,ug,ub,cr,ug
ug,ub,ub,ur,ur,cb,ug,ug,ub,ub,ur,ur,ub,ug,ur,ub,ur,ur,ug,ug,ub,ur,ux
ug,ug,ub,ub,ug,ug,ur,ur,ug,ub,ur,ur,ub,ub,ug,ug,ub,ug,ug,ug,ub,ur,ux
ub,ug,ug,ub,ug,ug,ur,ur,ug,ug,ub,ub,ub,ub,ux,ug,ug,ug,ug,ug,ub,ur,ux
ur,cb,ug,ug,ub,ub,ub,ub,ub,ub,ub,ub,ux,ub,ub,ub,ub,ub,ub,ub,ub,ur,ux
ur,ub,ub,ug,ub,ug,ug,ur,ur,ur,ub,ur,ur,ub,ug,ub,ux,ux,ux,ux,ux,ur,ux
ux,ux,ub,ug,ub,ux,ug,ux,ux,ub,ub,ug,ug,ub,ub,cb,ug,ug,ux,ux,ux,ur,ux
ux,ux,cg,ug,ub,ux,ug,ug,ug,ub,ub,ub,ug,ug,ug,ug,ug,ug,ux,ux,ux,ur,ux
ux,ux,ux,ux,ug,ux,ux,ux,ux,ug,ug,ug,ug,ug,ug,ug,ug,ug,ug,ug,ug,ur,cg
ux,ux,ux,ux,ug,ux,ux,ug,ug,ug,ug,ug,ug,ug,ug,ug,ug,ux,ux,ux,ux,ur,ux
ux,ux,ux,ux,ug,ux,ux,ug,ux,ug,ug,ug,ug,ux,ux,ug,ug,ux,ux,cb,ub,ub,ub
ux,ux,ux,ux,ug,ux,ux,ug,ug,ug,ug,ug,ur,ux,ux,ug,ub,ub,ub,ub,ub,ub,ub
cg,ux,ux,ux,ug,ux,ux,ux,ux,ug,ug,ug,cg,ux,ux,ux,ub,ub,ub,ux,ux,ur,ux
ub,ub,ub,ub,ug,ug,cg,ub,ub,ub,ug,ug,ub,ub,ub,ub,ub,ub,ub,ug,ur,ur,ur
ub,ub,ub,ub,ub,ub,ub,ub,ub,ug,ug,ug,ur,ub,ux,ux,ub,ub,ub,ug,ur,ur,ur
cr,ux,ux,ug,ub,ub,ub,ub,ub,ub,ub,ub,ur,ub,ub,ur,ur,ur,ur,ur,ur,ur,ur
cg,ux,ux,ug,ug,ug,ux,ux,ux,ub,ux,ub,ur,ub,ub,ug,ug,ug,ug,ur,ur,cb,cr
cr,ux,ux,ub,ub,ub,ub,ub,ub,cb,ub,ub,ur,ur,ur,ur,ur,ur,ur,ur,cb,ux,cr