ur,ur,ur,ur,ur,ur,ur,ur,ur,ur,ur,ur,cr,ur,ur,ur,ur,cb,ur,ur,ur,ub,ub
ur,cr,ub,ur,ur,ur,ur,ur,ur,ur,ur,ur,cb,ub,ug,ug,ug,ur,ur,ur,ur,ub,ub
ur,ur,cb,ur,ur,ur,ur,ur,cg,ur,ur,ur,ur,cr,ur,ur,ug,ur,ur,ur,ur,ub,ub
ur,ur,ur,ur,ur,ur,ur,ur,ug,ur,ur,ur,ur,ur,ur,ur,ug,ur,ur,ur,ur,ur,ub
ur,ur,ur,ur,ur,ur,ur,ug,ug,ur,ur,ur,ur,ur,ug,ur,ug,ur,ur,ux,ux,ur,ub
ur,ur,ur,ur,ur,ur,ur,ug,ur,ur,ur,ur,ur,cr,ug,ug,ug,ug,ug,ux,ux,ur,ub
ur,ux,ur,ur,ur,ur,ur,ur,ur,ur,ur,ur,ur,cr,ug,ux,ux,ug,ug,cg,ub,ur,ub
ur,ur,ur,ur,ur,ub,ux,ur,ug,ug,ug,ub,ug,ux,ux,ux,ug,ug,ub,ub,ub,ur,ub
ur,ur,ur,ur,ug,ub,ub,ub,ub,ub,ug,ub,ug,ug,ub,ug,ug,ug,ux,ux,ub,ur,ub
ur,ur,ur,ug,ug,ur,ur,ub,ug,ug,ug,ub,ug,ub,ub,ub,ux,ug,ub,ub,ub,ur,ub
ub,ur,ur,ug,ug,ub,ub,ub,ug,ug,ug,ux,ug,ug,ug,cb,ug,ug,ug,ux,ux,ur,ub
ub,ub,ux,ug,ux,ub,ux,ug,ug,ug,ug,cb,ub,ub,ub,ub,ug,ug,ug,ux,ub,ur,ub
ux,ub,ub,ug,ub,ub,ux,ug,ux,ug,ux,ub,ub,ub,ub,ub,ub,ug,ug,ux,ub,ur,ub
ux,ux,ux,ug,ub,ub,ux,ug,ux,ug,ux,ug,ub,ub,ub,ub,ug,ug,ug,ux,ub,ur,ub
cg,ux,ux,ug,ub,ub,cb,ug,ug,ug,ux,ub,ub,ub,ub,ub,ux,ug,ub,ux,ub,ur,ub
ux,ux,ux,ug,ub,ub,ux,ux,ux,ux,ux,ug,ub,ub,ub,cg,ug,ug,ub,ug,ub,ur,ub
ux,ux,ux,ug,ux,ub,ub,ub,ub,ub,ub,ub,ub,ub,ub,ug,ug,ub,ub,ub,ub,ur,ub
ub,ub,ub,ug,ug,ug,ug,cg,ub,ub,ub,ub,ub,ub,ub,ub,ub,ub,ub,ub,ub,ur,ub
ub,ub,ub,ub,ux,ux,ux,ux,ux,ux,ux,ux,ux,ub,ub,ux,ux,ux,ux,ux,ub,ur,ub
ux,ux,ux,ub,ub,ub,ub,ub,ub,ub,ub,ub,ub,ub,ub,ub,ub,ub,ub,ub,ub,ur,ub
ux,ux,ux,ux,ux,ux,ux,ux,ux,ux,ux,ur,ur,cb,ub,ub,ub,ub,ub,ub,ub,ub,ub
cr,ux,ux,ux,ux,ux,ux,ux,ux,ux,ux,ur,cr,ux,ux,ux,ux,ux,ux,ux,ux,ur,cb
cg,ux,ux,ux,ux,ux,ux,ux,ux,cg,ux,ur,ur,ur,ur,ur,ur,ur,ur,ur,ur,ur,ur