ur,ur,ur,ur,ur,ur,ur,ur,ub,ub,cb,ur,ur,ur,ur,ur,ur,ur,ur,ur,ur,ur,ur
ur,ur,ur,ur,ur,ur,ur,ur,cr,ug,ug,ug,cr,ur,ur,ur,ur,ur,ur,ur,ur,ur,ur
cr,ur,ur,ur,ur,ur,ur,ur,ur,ur,ur,ur,ur,ur,ur,ur,ur,ub,cr,ur,ur,ur,ur
ur,ur,ur,ur,ur,ur,ur,ux,cr,ur,ur,ub,ub,ub,ur,ur,ur,cb,ur,ur,ur,ur,ur
ur,ur,ur,ur,ur,ur,ur,ur,ur,ur,ur,ur,ub,ug,ug,ur,ur,ub,ub,ub,ub,ur,ur
ur,ur,ur,ur,ur,ur,cg,ur,ur,ur,ur,ub,ug,ug,ug,ur,ub,ub,ub,ub,cb,ux,ux
ux,ur,ur,ur,ur,ur,ug,ug,ug,ug,ug,ug,ug,ub,ug,ub,ub,ub,ub,ux,ux,ux,ux
ux,ux,ux,ub,ug,ur,ur,cg,ug,ug,ug,ub,ub,ux,ug,ub,ub,ux,ux,ux,ux,ux,ux
cg,ux,ux,ub,ub,ur,ur,ur,ug,ug,ub,ub,ub,ub,ub,ub,ux,ux,ux,ux,ux,ux,ux
ux,ux,ux,ub,ub,ug,ug,ug,ug,ug,ub,ub,ub,ug,ub,ux,ux,ux,ux,ux,ux,ux,ux
ux,ux,ux,ub,ub,ug,ug,ug,ug,ug,ug,ug,ub,cb,ub,ub,ux,ux,ux,ux,ux,ux,ux
ur,ux,ux,ux,ur,ux,ug,ug,ug,ug,ub,ub,ug,ub,ub,ub,ux,ux,ux,ux,ux,ux,ux
ur,ur,ur,ur,ur,ux,ug,ug,ug,ug,ug,ug,ug,ug,ub,ub,ub,ux,ux,ux,ux,ux,ux
ux,ux,ux,ux,ux,ux,ux,ub,ug,ur,ug,ub,cb,ub,ub,ub,ub,ub,ux,ux,ux,ux,ux
cg,ux,ux,ux,ub,ub,ub,ub,ug,ug,ug,ub,ub,ub,ub,ub,ub,ub,ub,ux,ux,ux,ux
ug,ug,ug,ug,ug,ug,ug,ug,ug,cg,ub,ub,ub,ug,ub,ub,ug,ub,ub,ug,ug,ug,ug
ug,ux,ux,ux,ux,ub,ub,ub,ur,ur,ub,ub,ub,ub,ub,ub,ux,ux,ux,ux,ux,ux,ug
ug,ux,ux,ux,ux,ux,ux,ub,ur,ur,ux,ub,ub,ub,ux,ux,ux,ux,ux,ux,ux,ux,ug
ug,ux,ux,ux,ux,ux,ux,ub,ur,ur,ux,ub,ub,ux,ux,ux,ux,ux,ux,ux,ux,ux,ug
ug,ux,ux,ux,ux,ux,ux,ub,ur,ur,ux,ux,ux,ux,ux,ux,ux,ux,ux,ux,ux,ux,ug
ug,ug,ug,ug,ug,ug,ug,ub,ub,ub,ub,ub,ub,ub,ub,cb,ur,ur,cr,ug,ug,ug,ug
ur,ux,ux,ux,ux,ux,ux,ub,ub,ur,ux,ux,ux,ux,ux,ux,ux,ux,ux,ux,ux,ux,cb
ur,ux,ux,ux,ux,ux,ux,ub,ub,cg,ux,ux,ux,ux,ux,ux,ux,ux,ux,ux,ux,ux,ux