ur,ur,cb,cr,ub,ub,ur,ur,ur,ur,ur,ur,ur,cb,ub,ux,ux,cb,ux,ug,ug,ug,ug
ur,ur,ur,cr,ur,cb,ur,ur,ur,ur,ur,ur,ur,ur,ub,ub,ux,ug,ug,ug,ux,ux,ug
ur,ur,ur,ur,cr,ur,ur,ur,ur,cr,ux,ur,ur,ur,ur,ub,ux,ug,ux,ug,ux,ux,ug
ur,ur,ur,ur,ur,ur,ur,ur,ur,ur,ur,ur,ur,ug,ug,ug,ug,ug,ux,ug,ux,ux,ug
ur,ur,ur,ur,ug,ur,ur,ur,ur,ur,ur,ur,ur,ug,ub,ub,ub,ub,ug,ug,ug,ug,ug
ur,ur,ur,ur,ug,ur,cg,ur,ur,ug,ur,ur,ur,ug,ub,ug,ub,ub,ug,ug,ug,ug,ug
ur,ur,ur,ur,ug,ur,ug,ur,ur,ug,ug,ug,ug,ug,ub,ub,ub,ub,ub,ug,ug,ug,ug
ur,ur,ur,ur,ug,ug,ug,ur,ur,cg,ur,ur,ur,ur,ux,ux,ub,ub,ux,ug,ug,ug,ug
ur,ur,ur,ur,ur,ug,ug,ug,ug,ur,ur,ur,ur,ur,cr,ub,ub,ug,ug,ug,ug,ug,ug
ur,ur,ur,ur,ur,cg,ur,ur,ug,ug,ug,ug,ub,ub,ub,ub,ux,ug,ug,ug,ug,ug,ug
ur,ur,ur,ur,ur,ur,ur,ug,ug,ug,ub,ub,ux,ux,ub,ub,ub,ug,ug,ug,ux,ug,ug
ur,ur,ur,ur,ur,ur,ur,ug,ug,ug,ub,ub,ub,ub,ub,ub,ub,ug,ug,ug,ug,ug,ug
cg,ux,ux,ux,ux,ux,ux,ux,ux,ux,ux,ug,ux,ub,ub,cb,ub,ug,ug,ug,ug,ug,ug
ub,ub,ub,ub,ub,ub,ub,ub,ub,ub,ub,ub,ub,ub,ub,ug,ug,ug,ux,ug,ug,ug,ug
ub,ub,ur,ur,ur,ur,ur,ur,ur,ug,ug,ub,ug,ug,ug,ug,ug,ur,ur,ug,ug,ug,ug
ub,ub,ux,ux,ux,ux,ug,ux,ux,ug,ug,ub,ug,ug,ug,ug,ug,ug,ug,ug,ug,ug,ug
ub,ub,ub,ub,ub,ub,ub,ur,ur,ug,ug,ub,ug,ug,ug,ug,ug,ur,ur,ug,ur,ur,ur
cg,ux,ux,ux,ux,ux,ub,ub,ub,ub,ug,ub,ux,ug,ug,ug,ug,ug,ux,ug,ux,ug,ur
ur,cr,ux,ux,ux,ux,ub,ub,ub,ub,ug,ub,ux,ug,ug,ug,ug,ug,ug,ug,ug,ug,ur
ur,ux,ux,ub,ub,ub,ub,ub,ub,ub,ux,ub,ux,ux,cg,ug,ux,ux,ux,ug,ux,ug,ur
ur,ur,ur,ur,ur,ur,ur,ur,cb,ub,ub,ub,ur,ur,ur,ur,ur,ur,ur,ug,ur,ur,ur
cr,ux,ux,ub,ub,ub,ub,ub,ub,ub,ub,ub,ux,ux,ux,ux,ux,ux,ux,ug,ux,cb,cr
cg,ux,ux,ub,ub,ux,ub,ub,ub,ub,ub,ub,ux,cb,ux,ux,ux,ux,ux,cg,cb,ux,cr