cb,cb,cb,cr,ur,ur,ur,ur,ur,ur,ur,ur,ur,ur,ur,ux,ux,ux,ux,ux,ux,ux,cb
ub,cb,cb,ur,ur,ur,ur,ur,ur,ur,ur,ur,ur,ur,ur,ur,ur,ur,ur,ux,ux,ux,ux
ub,ur,ur,ur,ur,ur,ur,ur,ur,ur,ur,ur,ur,ur,ur,ux,ux,ux,ur,ur,ur,ur,ux
ub,ur,ur,ur,ur,cg,ug,cr,ur,ur,ug,ug,cg,ur,ur,ux,ux,ur,ur,ur,ur,ur,ux
ub,ur,ur,ur,ur,ur,ur,ur,ur,ur,ur,ur,ur,ur,ug,ur,ug,ug,ug,ur,ux,ux,ux
ur,ur,ur,ur,ur,ur,ur,ur,ur,ur,ug,cr,ux,ur,ug,ug,ug,ug,ug,ug,ug,ux,ux
ur,ur,ur,ur,ur,cr,ur,cg,ug,ur,ur,ug,ur,ur,ug,ug,ug,ug,ug,ug,ug,ux,ux
cb,ur,ur,ur,ur,ug,ug,ug,ur,ur,ug,ug,ur,ug,ug,ug,ug,ug,ug,ug,ug,ux,ux
ur,ur,ur,ur,ur,ur,ur,ur,ur,ur,cr,ux,ux,cg,ug,ug,ug,cg,ug,ug,ur,ur,ur
ur,ur,ur,ur,ur,ur,cr,cb,ug,ux,ug,ur,ur,ur,ug,ug,ug,ug,ug,ub,ub,ux,ur
ub,ub,ub,ub,ug,ug,ug,ub,ub,ur,ug,ug,ug,ug,ug,ug,ug,ug,ug,ub,ub,ub,ur
ux,ux,ux,ub,ug,ug,ux,ub,ub,ub,ug,ug,ug,ug,ug,ug,ug,ug,ug,ux,ux,cb,ub
cb,ux,ux,ub,ug,ug,ub,ub,ub,ub,ug,ug,ug,ug,ux,ug,ug,ub,ub,ub,ub,ub,ub
ux,ux,ug,ub,cb,ug,ug,ug,ub,ug,ug,ug,ug,ug,ug,ug,ur,ub,ug,ux,ux,ux,ur
ux,ux,ug,ug,ug,ug,ug,ug,ub,ug,ub,ug,ug,ug,ug,ug,ur,ub,ug,ug,ux,ux,ur
cg,ug,ug,ug,ug,ug,ug,ug,ug,ug,ug,ug,ug,ug,ug,ug,ur,ub,ur,ur,ur,ur,ur
ug,ug,ug,ug,ug,ux,ug,ub,ub,ux,ug,ug,ug,ug,ux,ux,ur,ub,ug,ug,ux,ux,cb
ug,ug,ug,ug,ug,ux,ug,ug,ug,ug,ug,ux,ug,ug,ug,ux,ur,ub,ub,ub,ub,ub,ub
ug,ug,ug,ux,ux,ug,ug,ug,ux,ug,ug,ug,ug,ub,ub,ub,ub,ur,ub,ub,ub,ub,ub
ug,ug,ug,ux,ux,ug,ug,ug,ug,ug,ug,ug,ub,ub,ug,ug,ur,ur,ux,ux,ux,ux,ux
cr,ur,ug,ug,ug,ug,ug,cr,ur,ur,ur,ur,ur,ur,ur,ur,ur,ur,ur,ur,ur,ur,cr
cg,ur,ur,ur,ur,ug,ug,ug,ug,ug,ub,ub,ub,ub,ur,ur,ur,ur,ur,cb,cb,ur,cr
cr,cg,cg,cb,ux,ub,ug,ug,ug,ug,ux,ub,ub,ux,ux,cg,ur,ur,ur,cg,cg,ur,cr