ur,cb,cb,cr,ur,ur,ur,ur,ur,ur,ur,ur,ur,ur,ur,ur,ur,ur,ur,ur,ur,ur,cb
ur,cb,cb,ur,ur,ur,ur,ur,ur,cg,ur,ur,ur,ur,ur,ur,ub,cr,ur,ur,ur,ug,ug
ur,ur,ur,ug,ug,ug,ug,ug,ug,ug,ur,ur,ur,ug,ug,ur,ur,ub,ub,ub,ub,ub,ug
ur,ur,ur,ug,ur,ur,ur,cr,ur,ur,ug,ug,ug,ug,ug,ug,ub,ub,ub,ub,ur,ub,ug
ur,ug,cr,ur,ur,ug,ug,ug,ur,ur,ug,cb,ur,ur,ub,cg,ug,ub,ub,ub,ub,ub,ug
ur,ur,ur,ug,ug,ug,ub,ug,cr,ur,ug,ub,ug,ub,ub,ub,ug,ub,ux,ub,ub,ux,ug
ug,ug,ug,ur,ur,ug,ug,ug,ux,ur,ug,cg,ug,cb,ub,ub,ug,ub,ux,ub,ub,ux,ug
cb,ur,ur,cr,ur,ub,ub,ub,ug,ug,ug,ux,ux,ug,ug,ub,ub,ub,ux,ub,ub,ux,ug
ur,ur,ur,ur,ur,ur,ub,ub,ug,ux,ub,ux,ux,ug,ug,ub,ub,ug,cg,ub,ub,ux,ug
ur,ug,ug,ug,ub,ub,ub,ub,cb,ux,ub,ub,ub,ub,ug,ub,ug,ug,ug,ub,ub,ux,ug
ur,ux,ux,ux,ug,ur,ux,ux,ux,ux,ub,ub,ug,ug,ug,ub,ux,ug,ug,ub,ub,ux,ug
ur,ur,ur,ur,ur,ur,ug,ur,ur,ur,ug,ug,ug,ug,ug,ub,ug,ug,ug,ub,ug,ug,ug
cb,ux,ux,ux,ux,ur,ug,ux,ux,ux,ug,ug,ug,ug,ug,ub,ub,ub,ug,ux,ux,ux,cg
ub,ub,ub,ub,ub,ur,ug,ub,ub,ub,ug,ug,ug,ug,ug,ug,ug,ug,ug,ug,ug,ug,ug
ux,ux,ux,ux,ux,ur,ug,ug,ug,ux,ug,ug,ug,ub,ux,ux,ux,ux,ux,ug,ux,ux,ug
ux,ux,ux,ux,ux,ur,ug,ug,ug,ug,ug,ug,ug,ug,ug,ug,ug,ug,ub,ug,ug,ug,ug
ux,ux,ux,ux,ug,ur,ub,ub,ug,ug,ug,ug,ug,ug,ub,ub,ub,ug,ug,ug,ug,ug,cb
ux,ux,ux,ux,ub,ur,ug,ug,ug,ux,ux,ux,ux,ug,ug,ug,ug,ug,ug,ug,ug,ug,ux
ux,ux,ux,ub,ub,ur,ug,ug,ug,ug,ux,ux,ux,ug,ug,ug,ug,ug,ug,ug,ug,ug,ux
ux,ub,ub,ub,ub,cb,ur,ug,ux,ug,ug,ug,ug,ug,ug,ug,ug,ug,ug,ug,ug,ug,ux
cr,ub,ub,ub,ub,ux,cr,cg,ux,ux,ux,ux,ux,ux,ux,ux,ux,ux,ux,ux,ux,ux,cr
cg,ub,ub,ub,ub,ux,ub,ux,ux,ux,ux,ux,ux,ux,ux,ux,ux,ux,ux,cb,cb,ux,cr
cr,cg,cg,cb,ub,ub,ub,ux,ux,ux,ux,ux,ux,ux,ux,cg,ux,ux,ux,cg,cg,ux,cr