ur,ur,ur,ur,ur,ur,ur,ur,ur,ur,ur,ur,ur,ur,ur,ur,ur,ur,ur,cb,ur,ub,ub
ur,ur,ur,ur,ur,ur,ur,ur,ur,ur,ur,ur,ur,ur,ur,ur,ur,ur,ur,ub,ub,ub,ur
ur,ur,ur,ur,ur,ur,ur,ur,cb,ub,cr,ur,cb,ub,ub,cr,ur,ur,ur,ur,ur,ub,ub
ur,ur,ur,ur,ur,ux,ux,ux,cr,ur,ur,ur,ur,ur,ur,ur,ur,ur,ur,ur,ur,ur,ub
ur,ur,ur,ur,ur,ur,ux,ux,ux,ux,ux,ur,ur,ur,ur,ur,ur,ux,ur,ur,ur,ur,ub
ur,cr,ur,ur,ur,ur,ug,ug,ug,ug,ug,ur,ur,ur,ur,ur,ur,ur,cg,ur,ur,ur,ub
ux,ug,ub,ug,ug,ug,ug,ug,ug,ug,ur,ur,ur,ur,ur,ur,ug,ug,ug,ur,ub,ub,ub
ux,ug,ug,ug,cg,ur,ug,ug,ug,ug,ur,ur,ur,ur,ug,ur,ug,ug,ug,ur,ub,ur,cb
cg,ub,ub,ub,ub,ur,ug,ug,ug,ug,ug,ug,cr,ug,ur,ur,ug,ux,ug,ur,ur,ur,ur
ub,ub,ux,ux,ug,ur,ux,ur,ur,ur,ug,ug,ug,ug,ug,ur,ug,ur,ug,ur,ur,ur,ur
ub,ux,ux,ux,ub,ur,ur,ur,ur,ug,ug,ug,ub,ub,ub,ur,ug,ug,ug,ur,ur,ur,ur
ub,ux,ux,ux,ub,ug,ub,ug,ur,ub,ug,ur,ub,ub,ug,ug,ug,ug,ug,ur,ur,ur,ub
ub,ux,ux,ug,ug,ug,ug,ug,ur,ub,ub,ub,ub,ub,ug,ug,ug,ug,ur,ur,ur,ur,ur
ub,ub,ub,ub,ub,ux,ub,ug,ub,ub,ug,ub,ub,ub,ub,ub,ur,ur,ur,ur,ur,ur,ur
cg,ux,ux,ux,ub,ub,ux,ug,ub,ub,ub,cb,ub,ub,ux,ux,ur,ur,ur,ur,ur,ur,ux
ur,ur,ur,ur,ur,ur,ur,ur,cr,ub,ub,ub,ux,ub,ux,ux,ux,ux,ux,ux,ux,ug,ux
ur,ux,ux,ux,ux,ub,ux,ug,ur,ux,ub,ub,ub,ub,ux,ux,ux,ux,ux,ux,ux,ug,ux
ur,ux,ux,ux,ux,ub,ux,ug,ur,ux,ub,ux,ux,ux,ux,ux,ux,ux,ux,ux,ux,ug,ux
cg,ux,ux,ux,ux,ub,ub,ug,ur,ub,ub,ub,ub,ub,ux,ux,ux,ux,ux,ux,ux,ug,ux
ug,ux,ux,ux,ux,ux,ux,ug,ur,ux,ug,ux,ub,cb,ub,ux,ux,ux,ux,ux,ux,ug,ux
ug,ux,ux,ux,ux,ux,ux,ug,ur,ux,ug,ux,ub,ux,ub,ux,ux,ux,ux,ux,ux,ug,ux
ug,ux,ux,ux,ux,ux,ux,ug,ur,ux,ug,ub,ub,ux,ux,ux,ux,ux,ux,ux,ux,ug,ux
ug,ug,ug,ug,ug,ug,ug,ug,ur,cg,ug,ug,ug,ug,ug,ug,ug,ug,ug,ug,ug,ug,ux