ur,ur,ur,ur,cg,ug,ug,ug,ug,ug,ug,ub,ub,ub,cr,ug,ug,ug,ug,ug,ug,ug,cb
ur,ur,ur,ur,ur,ur,ur,ur,ur,ur,ur,cb,ur,ur,ur,ux,ux,ux,ux,ur,cb,ub,ub
ur,ur,ur,ur,ur,ur,ur,ur,ur,ur,ur,ur,ur,ur,ur,ux,ux,ur,ur,ur,ur,ur,cr
ur,ur,ur,ur,ur,ur,ur,ur,ur,ur,ur,ur,ur,cr,ur,ur,ur,ur,ur,ur,ur,ur,ub
cr,cr,cr,ur,ur,ur,ur,ur,ur,ur,ur,ur,ur,ur,ur,ur,ur,ug,ug,ur,ur,ur,ub
ur,ur,ub,cb,ur,ur,ub,ur,ur,ur,ur,ur,ur,ur,ur,ur,ur,ug,ug,ur,ur,ur,ub
ur,ur,ub,ub,ub,ub,ub,ur,ur,ur,ur,ur,ur,ur,ur,ur,ur,ur,ur,ur,ur,ur,ub
ur,ur,ub,ub,ur,ur,ub,ur,cb,ug,ug,ug,ug,ug,cg,ur,ur,ur,ur,ur,ur,ur,ub
cg,ur,ub,ub,ur,ub,ub,ub,ub,ug,ur,ur,ur,ur,ur,ur,ug,ur,ur,ur,ur,ur,ub
ur,ur,ub,ub,ur,ub,ub,ub,ub,ub,ug,ug,ug,ug,ug,ug,ug,ur,ur,ur,ur,ur,ub
ur,ur,ux,ur,ur,ux,ux,ub,ub,cb,ub,ug,ug,ub,ug,ur,ur,ur,ur,ub,ub,ub,ub
ur,ur,ur,ur,ub,ub,ub,ub,ug,ub,ub,ub,ub,ur,ug,ur,ur,ur,ur,ub,ux,ux,ub
ur,ur,ur,ur,ur,ux,ux,ub,ug,ug,ub,ub,ub,ur,ug,ur,ur,ux,ux,ub,ux,ux,ub
ux,ux,ux,ug,ux,ux,ub,ub,ug,ub,ub,ub,ug,ug,ug,ug,ug,ux,ux,ub,ux,ux,ub
ux,ux,ux,ug,ux,ub,ub,ub,ug,ub,ug,ug,ug,ug,ug,ug,ug,ux,ux,ub,ux,ux,ub
ux,ux,ux,ug,ub,ub,ub,ug,ug,ub,ub,ug,ug,ug,ug,ug,ug,ux,ux,ub,ux,ux,ub
ub,ub,ub,ug,ub,ub,ub,ub,ug,ug,ug,ug,ug,ux,ug,cg,ux,ux,ux,ub,ux,ux,ub
ub,ux,ux,ug,ux,ux,ub,ub,ub,ub,ux,ux,ux,ux,ux,ux,ux,ux,ux,ub,ux,ux,ub
ub,ux,ux,ug,ux,ux,ub,ub,ub,ub,ux,ux,ux,ux,ux,ux,ux,ux,ux,ub,ux,ux,ub
ub,ux,ux,ug,ux,ux,ux,ub,ux,ux,ux,ux,ux,ux,ux,ux,ux,ux,ux,ub,ux,ux,ub
ub,ux,ux,ug,ux,ux,ux,ux,ux,ux,ux,ux,ux,ux,ux,ux,ux,ux,ux,ub,ux,ux,ub
ub,ux,ux,ug,ux,ux,ux,ux,ux,ux,ux,ux,ux,ux,ux,ux,ux,ux,ux,ub,ux,ux,ub
ub,ub,ub,ug,ug,ug,ug,ug,ug,ug,ug,ug,ug,ug,ug,ug,ug,ug,ug,ub,ub,ub,ub