ur,ur,cb,ur,ur,ur,ur,ug,ug,ur,ur,ur,ur,ur,ur,ux,ur,ur,ur,cg,ur,ur,ur
ur,ur,ur,ur,ur,ur,ur,ur,ug,ur,ur,ux,ur,ux,ur,ux,ur,ur,ur,ur,ur,ur,ur
ur,ur,ur,ur,ur,ur,ur,ur,ug,ur,ur,ur,ur,ur,ur,ur,ur,ur,ur,ur,ur,ur,ur
ur,ur,ur,ur,ur,ur,ur,ur,ug,ug,ur,ur,ur,ur,ur,ur,ur,ur,ur,ur,ur,ur,ur
ur,cg,ur,ur,ur,ur,ur,ur,ur,ug,ug,ur,ur,ur,ur,ug,cg,cb,cr,ur,cg,ur,ur
ur,ug,ur,ur,ur,ur,cr,ub,ur,ur,ug,ur,ur,ur,ur,cb,ur,ub,ur,ur,ug,ur,ur
ur,ug,ur,ur,ur,ur,ur,ub,ub,ur,ur,ur,ur,ur,ur,ub,ub,ub,ur,cr,ug,ur,cr
ur,cr,ur,ug,ub,ub,ub,ub,ub,ub,ub,ug,ub,ug,ub,ub,ub,ub,ug,ug,ux,ux,ux
ur,ur,ug,ug,cb,ur,ur,ur,ug,ub,ug,ug,ug,ug,ug,ux,ux,ub,ug,ur,ux,ux,ux
ur,ur,ub,ub,ub,ub,ub,ub,ub,ub,ug,ug,ug,ug,ug,ub,ux,ux,ug,ur,ux,ux,ux
ux,ux,ub,ug,ug,ug,ug,ux,ug,ug,ug,ug,ug,ug,ug,ub,ub,ux,ux,ur,ug,ux,ux
ur,ur,ub,ug,ug,ug,ug,ug,ug,ug,ug,ug,ug,ug,ug,ug,ug,ug,ug,ur,ug,ux,ux
cg,ux,ub,ug,ug,ux,ub,ug,ug,ug,ug,ug,ug,ug,ug,ug,ug,ug,ug,ur,ug,ux,ux
ux,ux,ub,ug,ug,ux,ux,ug,ux,ug,ug,ug,ug,ug,ug,ux,ub,ub,ug,ur,ug,ux,ux
ux,ux,ub,ug,ug,ux,ux,ug,ug,ug,ug,ug,ug,ug,ug,ub,ub,ub,ub,ur,ug,ux,ux
ux,ux,ub,ug,ug,ug,ug,ug,ug,ug,ug,ug,ug,ug,ug,ub,ub,ub,ug,ur,ug,ux,ux
ux,ux,cb,ug,ug,ug,ug,ug,ux,ug,ug,ug,ug,ur,ux,ux,ux,ub,ub,cr,ub,ux,ux
cg,ux,ux,ug,ux,ux,ug,ug,ug,ug,ug,cg,ug,ur,ux,ux,ux,ux,ub,ug,ub,cb,ux
ux,ux,ux,ug,ux,ux,ux,ux,ux,ux,ug,ug,ug,ur,ux,ux,ux,ux,ug,ug,ug,ub,ux
ux,ux,ux,ug,ux,ux,ux,ux,ux,ux,ux,ux,ux,ur,ux,ux,ux,ux,ug,ug,ug,ux,ux
cr,ux,ux,ug,ug,ug,ug,ug,ug,ug,ug,ug,ug,ug,ug,ug,ug,ug,ug,ux,ux,ux,ux
cg,ux,ux,ux,ux,ux,ux,ux,ux,ux,ux,ux,ux,ux,ux,ux,ux,ux,ux,ux,ux,cb,cr
cr,ux,ux,ux,ux,ux,ux,ux,ux,ux,ux,ux,ux,cb,ux,ux,ux,ux,ux,ux,cb,ux,cr