ur,cb,cb,cr,ur,ur,ur,ur,ur,ur,ur,ur,ur,ur,cr,ur,ub,ub,ub,ub,ub,ub,cb
ur,ur,cb,ur,ur,ur,ur,ur,ur,cr,ur,ur,ur,ur,ur,ur,ur,ur,ur,ur,ur,ur,ur
ur,ur,ur,ur,ur,ur,ur,ur,ur,cr,ug,ur,ub,ub,ub,ur,ur,ur,ur,ur,ur,ur,ur
ur,ug,ur,ur,ug,ur,ub,ug,ug,ug,ug,ug,ug,ug,ub,ur,ur,ur,ur,ur,ur,ur,cr
ur,ur,cr,ur,ug,ur,ug,ug,ug,ug,ug,ug,ug,ug,ug,ug,cg,ux,ux,ux,ub,ub,ur
ur,ur,ug,ur,cb,ub,ub,ub,ur,ug,ub,ug,ug,ux,ug,ug,ug,ug,ug,ug,ub,ub,ur
ur,ur,ur,ur,ug,ub,ur,ub,ur,ug,ub,ug,ug,ug,ug,ug,ug,ug,ug,ug,ub,ub,ur
cb,ug,ur,ur,cg,ub,ub,ub,ug,ug,ub,ug,ux,ux,cg,ug,ug,ug,ug,ug,ub,ub,ur
ux,ub,ux,ur,ur,ub,ub,ub,ug,ub,ux,ug,ux,ux,ub,ug,ug,ug,ug,ug,ug,ug,ur
ux,ub,ux,ur,ur,ur,ur,ux,ux,ub,ub,ug,ug,ug,ub,ub,ub,ub,ub,ub,ub,ub,ub
ub,ub,ub,cb,ug,ub,ub,ux,ub,ub,ug,ug,ug,ug,ur,ug,ug,ug,ug,ug,ug,cb,ub
ub,ub,ub,ug,ug,ub,ub,ux,ub,ub,ug,ug,ug,ug,ur,ug,ug,ug,ug,ug,ug,ux,ur
cb,ub,ub,ur,ux,ub,ub,ub,ub,ug,ug,ug,ug,ux,ur,ux,ux,ug,ug,ug,ug,ug,ur
ub,cg,ug,cb,ub,ub,ub,ub,ub,ug,ub,ub,ug,ug,ug,ug,ug,ug,ub,ub,ub,ub,ur
ub,ub,ub,ub,ub,ub,ux,ux,ux,ug,ux,ug,ug,ux,ur,ug,ux,ux,ux,ux,ux,ub,ur
ub,ub,ug,ug,cg,ur,ux,ux,ux,ug,ug,ug,ug,ug,ur,ug,cg,ug,ug,ux,ux,ub,ur
ub,ug,ug,ug,ug,ub,ux,ux,ug,ug,ug,ug,ug,ug,ug,ug,ug,ug,ug,ux,ux,ub,ur
ub,ug,ug,ug,ug,ug,ux,ug,ug,ug,ug,ug,ug,ug,ur,ug,ug,ug,ug,ux,ux,ux,ur
ub,ug,ug,ug,ug,ug,ug,ug,ug,ug,ug,ug,ug,ug,ur,ur,ur,ur,ur,ur,ur,ur,ur
cb,ug,ug,ug,ug,ug,ug,ug,ux,ux,ux,ux,ux,ux,ur,ur,ug,ug,ug,ux,ux,ux,cb
cr,ug,ug,ug,ug,ug,ug,ug,ug,ug,ug,ug,ug,ug,ug,ur,ux,ux,ux,ux,ux,ux,cr
cg,ug,ug,ug,ug,ug,ug,ug,ux,ux,ux,ux,ux,ux,ur,ur,cr,ux,ux,cb,cb,ux,cr
cr,cg,cg,cb,ux,ur,ur,ur,ur,ur,ur,ur,ur,ur,ur,cg,ux,ux,ux,cg,cg,ux,cr