cb,ub,ub,ub,ub,ub,cr,ur,ur,ur,ur,ur,ur,ur,ur,ur,ur,cb,ur,ur,ub,ub,ub
ur,ur,ur,ur,ur,ur,ur,ur,ur,ur,ub,ub,ux,ux,ux,ub,ur,ub,ur,ur,ur,ux,ub
ux,ur,ug,ug,ug,ur,ur,ur,ur,cr,ur,ub,ub,ub,ub,ub,ur,ur,ur,ux,ur,ur,ub
ur,ur,ug,ug,ug,ur,ur,ur,ur,ur,ur,ur,ux,ur,ur,ub,ub,ub,ub,ub,ub,ub,ub
ur,ur,ug,ug,cr,ur,ur,ur,ur,ur,ur,ug,ug,ug,ug,ug,ug,ug,ug,ug,ux,ub,ub
ur,ur,ur,ug,ug,cr,ur,ur,ur,ur,ur,ur,cr,ux,ux,ub,ub,ub,ux,ug,ub,ub,ub
ur,ur,ur,ug,ur,ur,ur,ur,ur,ur,ub,ug,ug,ug,ug,ub,ub,ub,ub,ug,ub,ux,ub
ur,ur,ur,ug,ur,ub,ub,ur,ug,ug,ug,ug,ug,ug,ub,ux,ux,ux,ug,ug,ub,ux,ub
ur,ur,ur,ug,ur,ub,ub,ur,ug,ug,ug,ug,ub,ug,ug,ux,ux,ux,ug,ug,ub,ub,ub
ur,ur,ur,cg,ur,cg,ug,ub,ug,ug,ub,ub,ub,ub,ug,ux,ux,ux,ug,ug,ux,ux,ug
ur,ur,ur,ur,ur,ub,ub,ub,ub,ub,ub,ug,ub,ub,ug,ug,cg,ug,ug,ug,ux,ux,ug
ur,ur,ur,ur,ur,ug,cb,ug,ub,cb,ub,ur,ug,ug,ug,ug,ug,ug,ug,ug,ux,ux,ug
ux,ux,ub,ub,ur,cb,ug,ug,ug,ub,ub,ug,ug,ub,ub,ug,ug,ug,ug,ux,ux,ux,ug
ux,ux,ub,ub,ur,ub,ub,ug,ug,ug,ub,ug,ub,ub,ub,ux,ux,ug,ug,ux,ux,ux,ug
cg,ux,ub,ub,ub,ub,ub,ub,ub,ug,ug,ug,ub,ub,ux,ux,ux,ux,ub,ub,ub,ux,ug
ux,ux,ub,ux,ub,ub,ub,ub,ub,ug,ug,ug,ug,ug,ub,ux,ux,ub,ub,ux,ub,ub,ub
ux,ub,ub,ux,ur,ub,ug,ug,ub,ub,ub,ub,ub,ug,ub,ux,ux,ub,ub,ux,ub,ub,ub
ux,ub,ub,ux,ur,ub,ug,ug,ux,ub,ub,ub,ub,ug,ug,ux,ux,ub,ub,ux,ub,ub,ur
ux,ub,ub,ux,ur,ub,ux,ux,ux,ub,ux,ug,ug,ug,ug,ux,ub,ub,ux,ux,ux,ub,ub
ux,ub,ub,ux,ur,ub,ux,ux,ux,ux,ux,ug,ub,ux,cg,ug,ug,ux,ux,ux,ux,ur,ub
ux,ub,ub,ub,ub,ub,cr,ur,ur,ur,ur,ur,ur,ur,ur,ur,ug,ur,ub,ub,ub,ub,ub
cr,ug,ug,ug,ug,ug,ug,ub,ub,ub,ub,ub,ug,ux,ux,ug,ug,ub,ub,ub,ub,ub,cb
cg,ug,ug,ug,ug,ug,ug,ug,ux,cg,ux,ur,ug,ug,ug,ug,ur,ub,ub,ub,ub,cb,cb