ur,ur,cb,ur,ur,ur,ur,ur,cr,ur,ur,ur,ur,ur,ur,ur,ur,cb,ur,cg,ur,ur,ux
ur,ur,ur,ur,ur,ux,ur,ur,ug,ur,ur,ur,ur,ur,ur,ur,ur,cg,ur,ur,ur,ur,ur
ur,ur,ur,ur,ur,ux,ur,ur,ug,ur,ur,ur,ur,ur,ur,ur,ur,ug,ur,ur,ur,ur,ur
ur,ur,ur,ur,ur,ur,ur,ur,ug,ug,ur,ur,cr,ug,cg,ur,ur,ug,ur,ur,ur,ur,ur
ur,ur,ur,ur,ur,ur,ur,ur,cb,ug,ug,ur,cr,ub,ur,ur,ur,ug,ur,ur,ur,ur,ur
ur,ur,ur,cg,ug,cr,ur,ur,ub,ur,ug,ur,ur,cb,ur,ub,ur,ug,ug,ur,ur,ur,ur
ur,ur,ur,ur,ur,ur,ur,ub,ub,ur,ur,ub,ub,ub,ur,ub,ug,ug,ug,ug,ur,ur,ur
ur,ur,ur,ur,cr,ur,ur,ub,ub,ub,ub,ub,ub,ub,ub,ub,ug,ur,ug,ur,ur,ur,ur
ur,ur,ur,ur,ur,ur,ur,ur,ub,ub,ug,ub,ub,ub,ug,ux,ug,ug,ug,ur,ux,ux,ux
ur,ur,ur,ur,ur,ub,ub,ub,ub,ub,ug,ug,ug,ug,ug,ub,ux,ux,ug,ur,ux,ux,ux
ux,ux,ub,ug,ug,ug,ug,ub,ub,ug,ug,ug,ug,ug,ug,ub,ub,ux,ub,ub,ub,ub,ub
ux,ux,ub,ug,ux,ug,ub,ug,ug,ug,ug,ug,ug,ug,ug,ug,ug,ug,ub,ur,ug,ux,ub
ug,ug,ug,cg,ux,ux,ub,ug,ug,ug,ug,ug,ug,ug,ug,ug,ug,ug,ub,ub,ug,ux,ub
ux,ux,ub,ug,ux,ux,ux,ug,ug,ug,ug,ug,ug,ug,ug,ux,ux,ux,ug,ub,ug,ux,cb
ux,ux,ub,ug,ux,ux,ux,ug,ug,ug,cg,ug,ug,ug,ug,ux,ub,ub,ub,ub,ug,ux,ux
ux,ux,ub,ug,ux,ux,ux,ux,ux,ux,ug,ug,ug,ug,cr,ux,ub,ub,ug,ub,ug,ux,ux
ux,ux,ub,ug,ux,ux,ux,ux,ux,ux,ux,ug,ug,ux,ur,ux,ux,ub,ub,ub,ub,ux,ux
cg,ux,ub,ug,ux,ux,ux,ux,ux,ux,ux,ug,ug,ux,ur,ux,ux,ux,ub,ur,ub,ub,ux
ux,ux,ub,ug,ux,ux,ux,ux,ux,ux,ux,ux,ug,ux,ur,ux,ux,ux,ug,ur,ug,ub,ux
ux,ux,ub,ug,ux,ux,ux,ux,ux,ux,ux,ux,ux,ux,ur,ux,ux,ux,ug,ur,ug,ux,ux
cr,ux,ub,ug,ug,ug,ug,ub,ub,ub,ub,ub,cb,ug,ur,ug,ug,ug,ug,ur,ux,ux,ux
cg,ux,ub,ub,ub,ub,ub,ub,ux,ux,ux,ux,ux,ux,ur,ux,ux,ux,ux,ur,ux,cb,cr
cr,ux,ub,ub,ux,ub,ub,ux,ux,ux,ux,ux,ux,cb,ur,ur,ur,ur,ur,ur,cb,ux,cr