ug,ug,cb,ur,cg,ur,ur,ur,ur,ur,ur,ur,cg,ug,ug,ug,ug,ug,cr,ur,ub,ur,ur
ug,ug,ur,ur,ug,ur,ur,ur,ur,ur,ur,ur,ur,ur,ur,ur,ur,ur,ur,ur,ub,ur,ug
ug,ug,ur,ur,ug,ur,ux,ur,ur,ur,ur,ur,ur,ur,ur,ur,ub,ug,ub,ur,ub,ur,ug
ug,ub,ur,ug,ug,ur,ur,ug,ug,ur,ux,ux,ur,cr,ug,ub,ug,ug,cr,ur,ub,ur,ug
ug,ug,ug,ug,ur,ur,cg,ug,ug,ur,ux,ur,ur,ug,ug,ug,ug,ug,ug,ug,ub,ur,ur
ub,ug,ub,ug,ur,ug,ug,ug,ug,ug,ug,ug,ug,ug,ug,cg,ug,ug,ug,ug,ub,cb,ug
ux,ux,ub,ug,ug,ug,ur,ug,ug,ug,ur,ux,ug,ug,ug,ug,ug,ug,ug,ug,ub,ub,ug
ux,ux,ub,ux,ux,ux,ux,ug,ug,ug,ug,ug,ug,ug,ug,ug,ug,ug,ug,ug,ur,ug,ug
ux,ux,ub,ux,ux,ux,ux,ux,ug,ug,ux,ux,ub,ub,ug,ug,ug,ug,ug,ur,ug,ug,ub
ux,ux,ub,ux,ux,ux,ux,ux,ug,ug,cb,ug,ub,ug,ub,ug,ug,ug,ug,ur,ug,ur,ur
ux,ux,ub,ux,ux,ux,ux,ux,ug,ug,ub,ub,ub,ub,ug,ug,ug,ug,ug,ur,ug,ur,cb
ux,ux,ub,ug,ug,ug,ux,ug,ug,ub,ub,ub,ub,ug,ug,ub,ub,ug,ug,ur,ug,ur,ur
ux,ux,ub,ug,ug,ug,ux,ug,ug,ub,ub,ug,ub,ub,ug,ug,ug,ug,ub,ub,ug,ur,ur
ux,ux,ub,ux,ux,ug,ux,ux,ug,ug,ug,ug,ug,ub,ub,ug,ug,ug,ub,ub,ug,ur,ur
ux,ux,ub,ux,ux,ug,ug,ug,ug,ug,ug,ug,ug,ub,ug,ug,ug,ug,ur,ub,ur,ur,ur
cg,ux,ub,ux,ux,ug,ug,ug,ug,ux,ug,ug,ug,ux,ug,ug,ug,ug,ug,ub,ur,ur,ur
ux,ux,ub,ux,ux,cg,cb,ug,ug,ug,ug,ug,ug,ug,ug,ug,ux,ux,ug,ub,ur,ur,ur
ux,ux,cb,ub,ub,ub,ub,ug,ug,ug,ug,ug,ug,ug,ug,ug,ux,ux,ug,ub,ur,ur,ur
ux,ux,ur,ux,ux,ux,ub,ug,ug,ux,ux,ux,ux,ux,ux,ux,ux,ux,ug,ub,ur,ur,ur
ux,ux,cr,ub,ub,ub,ub,cr,ur,ur,ur,ur,ur,ur,ur,ur,ur,ur,ur,ur,ur,ur,ur
cr,ug,ug,ub,ug,ug,ug,ug,ub,ub,ug,ug,ug,ug,ug,ug,ug,ug,ug,ur,ur,cr,ur
cg,ug,ux,ub,ub,ub,ub,ub,ub,ub,cb,ug,ug,ug,ug,ug,ug,ug,ug,ur,ur,cb,cr
cr,ug,ug,ub,ub,ug,ub,ub,ug,ub,ub,ur,ur,ur,ur,ur,ur,ur,ur,cg,cb,ux,cr