ur,cb,cb,cr,ur,ur,ur,ur,ur,ur,ur,ur,ur,ur,ur,ur,ur,ur,ux,ux,ux,ux,cb
ur,cb,cb,ur,ur,ur,ur,ur,ur,ur,ur,ur,ur,ur,ur,ur,ub,ur,ux,ux,ux,ux,ux
ur,ur,ur,ur,ur,ur,ur,ur,ur,ur,ur,ur,ur,ur,ur,ur,ur,ur,ux,ux,ux,ux,ux
ur,ur,ux,ug,ug,cr,ur,ug,ur,ur,ur,ur,ur,ur,cr,ux,ub,ux,ux,ux,ux,ux,ux
ur,ur,ur,ug,ur,ur,ur,ug,ur,ur,ur,ur,ur,ur,ur,ur,ur,ur,ur,ur,ur,ur,ur
ur,ux,ur,ug,ur,ur,cr,ur,ur,ur,ur,ur,cg,ug,ug,cb,ur,ur,cr,ux,ux,ub,cb
ur,ur,ur,ug,ur,ur,ug,ug,ug,ur,ur,ur,ug,ur,ug,ub,ub,ub,ub,ux,ux,ub,ub
cb,ur,ur,ug,ug,ug,ug,ur,ug,ug,ur,ur,ug,ug,ug,ug,ub,ub,ub,ux,ux,ub,ub
ub,ur,ur,ug,ug,ug,ug,ux,ux,ux,cr,ur,ur,ub,ug,ug,ub,ug,ug,ug,ux,ub,ub
ub,ux,ur,ug,ux,ug,ug,ub,ub,ub,ub,ub,cg,ug,ug,ux,ux,ug,ux,ug,ux,ub,ub
ub,ux,ux,cg,ux,ug,ux,ub,ub,ub,ub,ub,ub,ub,ug,ug,ug,ug,ug,ug,ub,ub,ub
ub,ub,ub,ub,ux,ug,ux,ub,ux,ub,ub,ub,ur,ug,ub,ug,ub,ub,ub,ub,ub,ub,ub
cb,ux,ux,ub,ux,ug,ux,ub,ug,ub,ub,ub,ur,ub,ub,ux,ub,ub,ub,ub,ub,ub,cg
ux,ux,ux,ub,ux,ug,ux,ub,ug,ug,ug,ub,ur,ug,ub,ux,ub,ub,ub,ub,ub,ub,ub
ux,ux,ux,ub,ux,ug,ux,ub,ux,ug,ub,ub,ur,ug,ub,ux,ub,ub,ub,ub,ub,ub,ub
ux,ub,ub,ub,ub,ug,ux,ub,ub,cb,ub,ur,ur,ug,ub,ux,ub,ub,ub,ub,ux,ux,ux
ug,ub,ub,ub,ub,ug,ug,ug,ub,ub,ug,ug,ur,ug,cr,ug,ub,ug,ug,ux,ux,ux,cb
ug,ub,ub,ub,ug,ub,ug,ux,ux,ux,ug,ug,ug,ug,ur,ug,ug,ug,cg,ux,ux,ux,ux
ug,ub,ub,cb,ug,ub,ug,ug,ug,ug,ug,ug,ur,ur,ur,ux,ux,ug,ug,ux,ux,ux,ux
ug,ub,ug,ug,ug,ug,ug,ug,ug,ug,ug,ug,ur,ug,ur,ug,ug,ug,ux,ux,ux,ux,ux
cr,ub,ub,cg,ug,ug,ug,ug,ug,ug,ug,ug,ur,ug,ur,ux,ux,ux,ux,ux,ux,ux,cr
cg,ub,ub,ub,ug,ux,ux,ux,ux,ux,ux,ur,ur,ug,ur,ux,ux,ux,ux,cb,cb,ux,cr
cr,cg,cg,cb,ug,ug,ug,ug,ug,ug,ug,ug,ur,ur,ur,cg,ux,ux,ux,cg,cg,ux,cr