ur,cb,cb,cr,ur,ur,ur,ur,ur,ur,ux,ux,ux,ux,ux,ur,ur,ur,ur,ur,ur,ur,cb
ur,cb,cb,ur,ur,ur,ur,ur,ur,ur,ur,ur,ur,ur,ur,ur,ur,ur,ur,ur,ur,ur,cr
ur,ur,ur,ur,ux,ur,ur,ur,ur,ur,ur,cb,ur,ur,ur,cr,ug,ur,ur,ur,ur,ur,ur
ur,ur,ur,ux,ux,ur,ur,ur,ur,ur,ur,ub,ur,ur,ur,ug,ug,ur,cg,cg,ur,ur,ur
ur,ur,ur,ur,ur,ur,ur,ur,ur,ur,cr,ub,ur,ug,ug,ug,ug,ug,ug,ug,ur,ur,ur
ux,ux,ux,ux,ur,ur,cg,ug,ur,ub,ub,ub,ur,ug,ug,ug,ug,ug,ug,ug,ur,ur,ur
ux,ux,ux,ux,ur,ur,ur,ug,cg,ug,ug,ug,ur,ur,ug,ug,ug,ur,ur,ug,ur,ur,ur
cb,ux,ux,ur,ur,ur,ur,ur,ug,ug,ug,ur,ur,ur,ug,ur,ug,ur,ug,ug,ur,ur,ur
ux,ux,ux,ur,ur,ur,ur,ur,cr,ug,ug,ur,ur,cg,ug,ur,ug,ur,cr,ur,ur,ur,ur
ux,ux,ux,ur,ur,ur,ur,ur,ur,ur,ug,ub,ub,ug,ug,ub,ug,ug,ur,ur,ur,ug,ug
ur,ur,ur,ur,ur,ur,ur,ur,ub,ub,ub,ub,ub,cb,ug,ux,ux,ux,ux,ux,ug,ug,ug
ur,ur,ur,ur,ur,ub,ub,ub,ub,ug,ug,ug,ug,ug,ug,ux,ux,ux,ux,ux,ug,ug,ug
cb,ux,ux,ux,ux,ub,ug,ug,ux,ug,ug,ug,ug,ug,ug,ux,ug,ug,ug,ux,ug,ug,ug
ub,ub,ub,ub,ub,ub,ug,ug,ub,ub,ub,ub,ug,ug,ug,ug,ug,ug,ug,ug,ug,ug,ug
ub,ub,ub,ux,ub,ub,ug,ug,ub,ub,ub,ub,ub,ub,ub,ub,ub,ub,ub,ub,ub,ub,ux
ub,ub,ub,ub,ub,ub,ub,ub,cb,ub,ub,ub,ub,ub,ub,ub,ub,ub,ub,ub,ux,ub,ux
ub,ub,ub,ub,ub,ub,ug,ug,ug,ug,ug,ub,ub,ug,ux,ux,ux,ux,ux,ub,ux,ub,cb
cb,ug,ug,ug,ug,ub,ug,ug,ub,ug,ug,ug,ux,ux,ux,ux,ux,ux,ux,ub,ux,ub,ur
ub,ub,ug,cg,ub,ub,ux,ug,ug,ug,ug,ug,ux,ux,ux,ux,ux,ux,ux,ub,ux,ub,ur
ur,ur,ug,ug,ug,ur,ur,ur,ur,ur,ur,ur,ur,ur,ur,ur,ur,ur,cr,ub,ub,ub,ur
cr,ux,ug,ug,ug,ug,ug,ug,ug,ug,ug,ux,ux,ux,ux,ux,ux,ux,ux,ux,ux,ux,cr
cg,ux,ug,ug,ug,ug,ux,ux,ux,ux,ug,ux,ux,ux,ux,ux,ux,ux,ux,cb,cb,ux,cr
cr,cg,cg,cb,ug,ug,ux,ux,ux,ux,ux,ux,ux,ux,ux,cg,ux,ux,ux,cg,cg,ux,cr