cb,cb,cb,cr,cr,ur,ur,ug,ub,cb,ub,ub,cr,ur,ur,ur,ur,ur,ur,ur,ur,ur,cb
ur,ur,ur,ur,ur,ur,ur,ug,ug,ug,ur,ub,ur,ur,ur,ur,ur,ur,ur,ur,ur,ur,ur
ub,ub,ub,cg,cr,ub,ug,ug,cr,ur,ur,ub,ub,ub,ur,ur,ur,ur,ur,ur,ur,ur,ur
cb,ug,ug,ur,ur,ug,ug,ug,ug,ug,ug,ub,ug,ug,ur,ur,ur,ur,ur,ur,ur,ur,ur
ux,ug,ug,ug,ur,ug,ur,ug,ug,ug,ug,cb,ug,ug,ug,ug,ug,ug,ug,ug,ug,ug,ug
ux,ur,ug,ug,ug,ug,ur,ug,ur,ur,ur,ur,ur,ub,ub,ub,cr,ur,ur,ur,ur,ur,cg
ux,ug,ug,ug,cg,ug,ur,ug,ug,ug,ug,ug,ug,ug,ug,ug,ur,ur,ur,ur,ur,ur,ur
cb,ur,ur,ur,ur,cg,ub,ub,ug,ub,ub,ug,ug,ub,ub,ux,ur,ur,ux,ux,ux,ux,ug
ur,ub,ub,ub,ub,ub,ub,ub,ug,ub,ub,ub,cb,ub,ub,ux,ub,ur,ux,ux,ux,ux,ug
ur,ub,ur,ub,ub,ux,ug,ug,ub,ub,ub,ub,ub,ub,ub,ub,ub,ur,ux,ux,ux,ux,ug
ux,ub,ub,ub,ub,ub,ub,ub,ub,ux,ub,ub,ub,ug,ux,ub,ub,ur,ux,ux,ux,ux,ug
ux,cb,ub,ux,ux,ux,ub,ug,ub,ug,ux,ub,ub,ug,ug,ux,ur,ur,ux,ux,ux,ux,ug
cb,ux,ub,ub,ub,ub,ub,ug,ug,ug,ug,ug,ub,ub,ub,ub,ur,ur,ux,ux,ux,ux,ug
ub,ub,ub,ub,ub,ub,ub,ug,ub,cg,ug,ug,ug,ux,ux,ub,ur,ur,ux,ux,ux,ux,ug
ub,ub,ub,ub,ub,ub,ub,ug,ug,ug,ug,ug,ug,ux,ux,ux,ur,ur,ux,ux,ux,ux,ug
ux,ux,ux,ux,ux,ux,ux,ub,ug,ug,ub,ug,ub,ub,ub,ub,ub,ur,ub,ub,ub,ub,ub
ux,ux,ux,ux,ux,ux,ub,ub,ug,ug,ug,ug,ug,ub,ub,ub,ur,ur,ux,ux,ux,ux,ub
cr,ux,ux,ux,ux,ux,ub,ux,ux,ux,ug,ub,ug,ub,ub,ub,ur,ur,ux,ux,ux,ux,ub
cg,ux,ux,ux,ux,ux,ub,ux,ux,ux,ug,ug,ug,ug,ug,ug,ur,ur,ug,ug,ug,ug,ub
cb,ux,ux,ux,ux,ux,ub,ub,ub,ub,ub,ub,ub,ub,ub,ub,ur,cr,ub,ub,ub,ub,ub
ux,ux,ux,ux,ux,ux,ux,ux,ux,ux,ux,ux,ux,ux,ux,ux,ur,ux,ux,ux,ux,ux,cr
cr,ux,ux,ux,ux,ux,ux,ux,ux,ux,ux,ux,ux,ux,ur,ur,ur,cb,cg,ux,cb,ux,cr
cg,cb,cg,cb,ux,ux,ux,ux,ux,ux,ux,ux,ux,ux,ux,cg,ur,ur,ur,cg,cg,ux,cr