cr,ub,cb,ux,ux,ux,ux,ur,ur,ur,ur,ur,ux,ur,ux,ux,ux,ux,ux,cg,ux,ur,ur
ur,cb,ux,ux,ux,ux,ux,ux,ur,ur,ur,ur,ur,ur,ur,ur,ur,ux,ux,ux,ux,ur,ur
ub,ux,ur,ur,ur,ux,ux,ux,ur,ur,ur,ur,ur,ur,ur,ur,ur,ur,ur,ur,ur,ur,ur
ub,ux,ur,ux,ur,ux,ux,ur,ux,ur,ur,ur,ur,ur,ur,ur,ur,ur,ur,ur,ux,ur,ur
ub,ub,ur,ur,ur,ur,ur,ur,ur,cr,ur,ur,ur,ur,ur,ur,ur,ur,ur,ur,ur,ur,ur
ub,ub,ur,ur,ur,ur,ur,ur,ur,ug,ug,ur,ur,ur,ur,ur,ur,ur,ur,ur,ur,ur,ur
ur,ur,ur,ur,ur,ur,ur,ur,ur,ur,cg,ur,ur,ur,ur,ur,ur,ur,ur,ur,ur,ur,ur
ur,ur,ur,ur,ur,ur,ur,ur,ur,ur,ur,ur,cg,ur,ur,ur,ur,ub,ur,ur,ur,ur,ur
ur,ur,ur,ur,ur,ur,ur,ur,ur,ur,ur,ur,ug,ur,ur,ur,ub,ur,ug,ug,ur,cr,ug
ur,ur,ur,ur,ur,ur,ur,ur,ur,ur,ur,cr,ug,ub,ub,ug,ug,ur,ug,ur,ur,ur,ug
ur,ur,ur,ur,ur,ur,ur,ur,ur,ur,ur,cb,ub,ub,ub,ur,ug,ug,ug,ur,ur,ub,ug
ur,ug,ur,ug,cr,cr,ur,ub,ub,ub,ub,ub,ub,ug,ug,ug,ug,ug,ug,ur,ur,ub,ug
cg,ug,ux,ug,ux,ub,ub,ub,ug,ug,ub,ub,ug,ug,ug,ub,ux,ux,ug,ur,ur,ub,ug
cb,ug,ux,ug,ug,ug,ug,ub,ug,ub,ux,ub,ug,ub,ub,ux,ux,ug,ug,ur,ur,ub,ug
ub,ub,ub,ub,ub,ux,ur,ub,ub,ub,ub,ub,ug,ug,ug,ug,ug,ug,ub,ub,ur,ub,ug
ux,ug,ux,ux,ub,cb,ub,ub,ub,ub,ub,ub,ub,ub,ub,ux,ug,ug,ux,ub,ur,ub,ug
ux,ug,ug,ug,ub,ub,ub,ub,ub,ub,ub,ub,ux,ux,ux,ux,ux,ub,ub,ug,ug,ug,ug
cg,ux,ug,ub,ub,ub,ub,ub,ub,ub,ub,ub,ux,ux,ux,ux,ux,ub,cg,ug,ur,ux,ur
ub,ux,cb,ug,ug,ux,ug,ux,ux,ux,ux,ux,ux,ux,ux,ux,ux,ub,ub,ub,ur,ub,ur
ub,ub,ub,ub,ug,ux,ug,ug,ug,ug,ux,ux,ux,ux,ux,ux,ux,ub,ub,ub,ur,ub,ur
cr,ub,ug,ub,ug,ux,ur,ux,ux,ug,ug,ux,ux,ux,ub,ub,ug,ub,ug,ur,ur,ur,ur
cg,ub,ug,ug,ug,ug,ur,ug,ug,ub,ub,ub,cg,ub,ub,ub,ub,ub,ux,ur,ur,cb,cr
cr,ub,ub,ug,ug,ug,ug,ug,ug,cb,ug,ug,ug,ub,ub,ur,ub,ub,ur,ur,cb,ux,cr