ub,ub,ub,cb,ur,ur,ur,ur,ur,ur,ur,ur,ur,ur,ur,ur,ur,ur,ur,ur,ur,ur,cb
ub,ur,ur,ur,ur,ur,ur,ur,ur,ur,ur,ur,ur,ur,cr,ug,ur,ur,ur,ur,ur,ur,ur
ub,ur,ur,ur,ur,ux,ug,ug,ug,ug,ug,ug,ug,ug,ug,ug,ur,ur,ur,ur,ur,ur,ur
ub,ur,ur,ur,ur,cr,ug,ug,ug,ug,ug,ug,ug,ug,ug,ur,ug,ug,cg,ur,ur,ur,ur
ub,ur,ur,ur,ur,ur,ux,ux,ux,ux,ux,ux,ux,ux,cr,ur,ug,ug,ug,ug,ur,ur,ur
ub,ub,ur,ux,ux,ug,ur,ur,ur,ur,ur,ug,ug,ug,ur,ur,ur,ur,ug,ug,ur,ur,ur
ub,cr,ur,cr,ux,ur,ur,ur,ur,ur,ur,ug,ub,ub,ub,ur,ux,ur,ug,ug,ur,ur,ur
ux,ub,ub,ur,ur,ur,ug,ur,ur,ug,ur,ur,ub,ub,ub,ug,ux,ur,ug,ug,ur,ur,ur
cg,ub,ux,ux,ux,ur,ur,ur,ur,ur,ur,ug,ur,ub,ub,ug,ug,ur,ug,ug,ur,ur,ur
ur,ub,ur,ux,ux,ur,ug,ug,ug,ur,ug,ub,ub,ub,ub,ug,ug,ur,ur,ur,ur,ur,ur
ur,ub,ur,ur,ur,ur,ux,ur,ub,ub,ub,ub,ub,ub,ub,ug,ug,ur,ur,ub,ub,ur,ur
ur,ub,ur,ur,ub,ub,ub,ur,ub,cb,ub,ub,ub,ub,ur,ux,ux,ux,ux,cb,ub,ub,ur
ub,ub,ub,ub,ub,ub,ug,ug,ug,ug,ug,ug,ub,ub,ub,ux,ux,ux,ux,ux,ux,ub,ur
ub,ux,ux,cb,ur,ur,ug,ug,ug,ug,ug,ub,ub,ub,ub,ux,ux,ux,ux,ux,ux,ub,ur
ub,ux,ux,ux,ux,ub,ub,ug,ug,ug,ug,ug,ug,ug,ug,ug,ug,ug,ug,ug,ug,ug,ur
ub,ux,ux,ux,ub,ub,cg,ug,cb,ub,ub,ub,ux,ux,ux,ux,ux,ux,ux,ux,ux,ug,ur
ub,ux,ux,ux,ux,ux,ur,ug,ug,ub,ub,ux,ux,ux,ux,ux,ux,ux,ux,ux,ux,ug,ur
ub,ux,ux,ux,ux,ux,ur,ub,ub,ux,ux,ux,ux,ux,ux,ux,ux,ux,ux,ux,ux,ug,cr
ub,ux,ux,ux,ux,ux,ur,ub,ub,ux,ux,ux,ux,ux,ux,ux,ux,ux,ux,ux,ux,ug,ug
ub,ux,ux,ux,ux,ux,ur,ub,ux,ux,ux,ux,ux,ug,ug,ug,ug,ug,ux,ux,ux,ug,ug
ub,ug,ug,ug,ug,ug,ur,ub,ug,ug,ug,ug,ug,ug,ux,ux,ux,ug,ux,ug,ug,ug,ug
ub,ux,ux,ux,ux,ux,ur,ub,ux,ux,ux,ux,ux,ux,ux,ux,ux,ug,ug,ug,ux,cg,ug
ub,ub,ub,ub,ub,ub,ur,ur,ur,ur,ur,ur,ur,ur,ur,ur,ur,ur,ur,ur,ur,ur,ug