cr,ub,cb,ur,ur,ur,ur,ur,ur,ur,ur,ur,ur,ur,ur,ur,ur,ur,ur,cg,ur,ur,ur
ur,cb,ur,ur,ur,ur,ur,ux,ur,ur,ur,ur,ur,ur,ur,ur,cr,ur,ur,ur,ur,ur,ur
ur,ur,ur,ur,ur,ux,ur,ur,ur,ux,ur,ur,ur,ur,ur,ur,ur,ur,cr,ub,cb,ur,ur
ur,ur,ur,ur,cr,ux,ux,ux,ux,ux,ur,ur,ur,ur,ur,ur,ur,ur,ur,ur,ur,ur,ur
cg,ur,ur,ug,ux,ux,ux,ux,ux,ux,ur,ur,ur,ur,ur,ug,ur,ur,ur,ur,ur,ur,ur
ug,ug,ur,ug,ug,cr,ur,ux,ux,ux,ur,ur,ur,ur,ur,ug,ur,ur,ur,ur,ur,ur,ur
ug,ug,ug,ux,ux,ur,ur,ur,ux,ux,ur,ur,ur,ur,ur,cb,ub,ub,ur,ur,ur,ur,ur
ug,ug,ug,ux,ux,ur,ur,ur,ur,ur,ur,ur,ur,ug,ug,ug,ur,ub,ur,ur,ur,ur,ur
ug,ug,ux,ux,ug,ug,ur,ug,ug,ug,ug,ug,ug,ug,ub,ug,ub,ub,ub,ur,ug,ug,ux
ug,ug,ux,ux,ug,ur,cg,ug,ug,ub,ur,ur,ug,ur,ur,ug,cg,ub,ub,ux,ug,ug,ux
ug,ug,ux,ux,ug,ug,ug,ug,ug,ug,ug,ur,ug,ur,ur,ur,ur,ur,ur,ur,ur,ur,ur
ux,ux,ux,ux,ux,ug,ug,ug,ug,ug,ug,ug,ug,ub,ux,ux,ux,ux,ux,ug,ug,ug,ur
cg,ux,ux,ux,ux,ub,ub,ub,ub,ub,ug,ux,ug,ub,ux,ug,ug,ux,ux,ug,ug,ug,ur
ux,ux,ug,ug,ug,ug,ug,ux,ub,ub,cb,ub,ug,ug,ug,ug,ug,ux,ux,ug,ug,ux,ur
ux,ug,ub,ub,ug,ug,ub,ub,ub,ub,ug,ug,ug,ug,ug,ug,ug,ux,ux,ug,ug,ux,ur
ux,ux,ub,ub,ub,ub,ub,ub,ug,ug,ug,ux,ug,ug,ub,ug,ug,ug,ug,ug,ug,ux,ur
ux,ux,ub,ub,ub,ub,cb,ub,ug,ug,ug,ub,ug,cb,ub,ub,ug,ug,ug,ux,ug,ux,ur
cg,ux,ub,ub,ub,ub,ub,ub,ug,ug,ug,ug,ug,ub,ub,ub,ug,ux,ux,ux,ug,cr,ur
ux,ux,ux,ub,ug,ug,ub,ub,ug,ug,ug,ub,ub,ub,ub,ug,ug,ux,ug,ug,ug,ur,ur
ux,ux,ux,ub,ug,ug,ug,ub,ub,ug,ug,ug,ug,ug,ug,ug,ug,ux,ug,ug,ug,ur,ur
cr,ux,ux,ux,ug,ug,ug,ug,ug,ug,ug,ug,ub,ug,ug,ug,ug,ug,ug,ux,ur,ur,ur
cg,ur,ur,ur,ur,ur,ur,ur,ug,ug,ur,ub,cg,ug,ug,ug,ur,ur,ur,ur,ur,cb,cr
cr,ur,ur,ur,ur,ur,ur,ur,ur,ur,ur,ub,ub,ub,ux,ux,ux,ux,ux,ux,cb,ux,cr