ur,cb,cb,cr,ux,ux,ux,ux,ur,ur,ur,ur,ur,ur,ur,ur,ur,ur,ur,ur,ur,ux,cb
ur,ur,cb,ux,ur,ur,ur,ur,ur,ur,ur,ur,ur,ur,ur,ur,ur,ur,ur,ur,ur,ur,ux
ur,ur,ur,ur,ur,ur,ur,ur,ur,ur,ur,ur,ur,ur,ur,ur,ur,ur,ur,ur,ux,cr,ux
ur,ur,cb,ur,ur,ur,ur,ur,ur,ur,ur,ur,ur,ur,ur,ur,ur,ur,ub,ub,ux,ux,ux
ub,ub,ub,ur,ug,cb,ur,ur,ur,ur,ur,ur,cr,ur,ur,ur,ur,cr,cr,ub,ux,ux,ux
ub,ub,ub,ur,ug,ub,ur,ur,ur,ur,ug,cr,ur,ub,ur,ub,ub,ug,ug,ub,ub,ub,ub
ub,ub,ub,ur,cg,ub,ub,ub,ub,ub,ub,ub,ur,ur,ub,ub,ub,ug,ug,ub,ub,ub,ub
cb,ub,ur,ur,ur,ur,ub,ub,ub,ub,ub,ub,ub,ub,ub,ux,ux,ug,ug,ub,ub,ub,ub
ur,ub,ub,ur,ur,ur,ub,ub,ux,ug,ug,ug,cb,ub,ub,ux,ux,cb,ub,ub,ub,ub,ub
ub,ub,ub,ur,ur,ux,ux,ux,ux,ug,ug,ug,ug,ug,ug,ug,ug,ug,ug,ub,ub,ub,ub
ug,ug,ub,ug,ur,ux,ux,ux,ux,ug,ug,ug,ub,ug,ug,ux,ux,ux,ux,ub,ub,ub,ub
ug,ug,ug,ug,ug,ug,ug,ur,ur,ug,ug,ug,cg,ug,ug,ug,ub,ub,ub,ub,ub,ub,ub
cb,ub,ug,ug,ug,ug,ug,ub,ub,ug,ug,ug,ub,ub,ub,ub,ub,ub,ub,ur,ub,ub,cg
ur,ur,ug,ur,ug,ug,ug,ub,ub,cg,ug,ur,ub,ub,ub,ub,ub,ub,ur,ub,cr,ub,ub
ug,ug,ug,ug,ug,ug,ub,ub,ug,ug,ug,ug,ux,ux,ug,ug,ug,ug,ux,ub,ur,ub,ub
ug,ub,ug,ug,ub,ub,ub,cb,ub,ug,ub,ux,ux,ux,ug,ub,ub,cg,ub,ub,ur,ub,ub
ug,ub,ug,ug,ug,ug,ub,cg,ub,ug,ub,ug,ug,ug,ug,ux,ux,ux,ux,ub,ur,ub,ub
ug,ug,ug,ug,ug,ug,ug,ug,ug,ug,ub,ug,ub,ub,ub,ub,ub,ub,ux,ub,ur,ug,ug
ug,ux,ux,ug,ug,ug,ug,ug,ug,ug,ug,ug,ug,ug,ug,ug,ug,ug,ug,ug,ur,ux,ux
ug,ug,ug,ug,ug,ug,ug,ug,ug,ug,ug,ur,ur,ur,ur,ur,ur,ur,ur,ur,ur,ur,cb
cr,ug,ug,ug,ug,ug,ug,ug,ug,ug,ug,ux,ux,ux,ux,ux,ux,ux,ux,ux,ux,ur,cr
cg,ug,ug,ug,ug,ug,ug,ug,ug,ug,ug,ux,ux,ux,ux,ux,ux,ux,ux,cb,cb,ur,cr
cr,cg,cg,cb,ug,ug,ug,ug,ug,ux,ux,ux,ux,ux,ux,cg,ux,ux,ux,cg,cg,ur,cr