ur,ur,ur,ur,ur,ur,ur,ug,ug,cg,ur,ur,ur,ur,cb,ub,ur,cb,ub,ub,ub,ub,ub
ur,ur,ur,cr,ur,ur,ur,ug,ug,ur,ur,ur,ur,ur,ur,ub,ur,ub,ub,ug,ub,ub,ub
ur,ur,ur,ug,ur,ug,ur,ur,cg,ur,ur,ur,ur,ur,ur,ub,ub,ub,ug,ub,ub,ub,ub
ur,ur,cg,ug,ub,cb,ur,ur,ur,ur,ur,ub,ur,ur,ur,ug,ug,ug,ug,ub,ub,ub,ub
ur,ur,ur,ur,ub,ub,ub,ub,ub,ub,ur,ur,ur,ur,ur,ux,ur,ur,ux,ub,ub,ub,ub
ur,ur,cr,ur,ur,ur,ur,ub,ub,ub,ub,ub,ub,ub,ux,ux,ug,ug,ug,ub,ub,ub,ux
ux,ur,ub,ub,ub,cr,ub,ub,ub,ub,ub,ub,ub,ug,ug,ug,ug,ug,ug,ub,ub,ub,ux
cr,ur,ub,cr,ub,ux,ub,ub,ub,ub,ub,ug,ug,ub,ux,ux,ux,ug,ug,ub,ub,ub,ux
ur,ur,ux,ur,ug,ug,ug,ug,ub,ub,ub,ug,ug,ug,ug,ug,ub,ub,ub,ub,ub,ub,ux
ur,ur,ux,ur,ur,ux,ux,ux,ub,ub,ug,ug,ug,ug,ub,ug,ub,ub,ub,ub,ub,ub,ux
ur,ur,ux,ug,ur,ur,ux,ux,ub,ub,ub,ug,ug,ux,ub,ug,ux,ug,ug,cb,ub,ub,ux
ur,ur,ur,ur,ur,ub,ub,ub,ub,ub,ub,ug,ug,ug,ug,ug,ug,ub,ub,ub,ub,ug,ux
ur,ur,ur,ug,ur,ub,ub,ub,ug,ug,ug,ug,ub,ub,ug,ux,ug,cb,ug,ub,ub,ub,cg
ux,ux,ux,ug,ug,ug,ug,ub,ug,ug,ug,ug,ug,ug,ug,ug,ug,ug,ug,ub,ux,ug,ux
ux,ux,ux,ux,ux,ug,ug,ub,cg,ug,ug,ug,ug,ub,ug,cg,ug,ug,ug,ug,ug,ug,ux
ux,ub,ub,ub,ub,ub,ub,cr,ub,ub,cb,ux,ux,ux,ug,ug,ug,ug,ug,ux,ur,ur,ur
ux,ux,ux,ux,ux,ub,ub,ur,ub,ub,ub,ug,ug,ug,ug,ug,ub,ux,ux,ux,ur,ur,ur
cg,ur,ur,ur,ur,ur,ur,ur,ur,ub,ub,ug,ug,ug,ug,ur,ur,ur,ur,ur,ur,ux,ux
ub,ur,ux,ux,ux,ug,ur,ux,ug,ub,ug,ug,ux,ux,ux,ug,ug,ux,ux,ux,ur,ux,ux
ub,ur,ux,ub,ux,ur,ur,ux,ux,ux,ub,ub,ug,ug,ug,ug,ug,ux,ux,ux,ur,ux,ux
ub,ur,ub,ub,ub,ur,ur,ux,ub,ub,ub,ux,ux,ux,ux,ux,ug,ux,ux,ux,ur,ux,ux
cr,ur,ub,ub,ub,ur,ur,ub,ub,ub,ug,ug,ug,ug,ug,ug,ug,ux,ux,ux,ur,ux,cb
cg,ur,ur,ur,cb,ub,ub,ub,ub,ub,ur,ur,ur,ur,ur,ur,ur,ur,ur,ur,ur,ur,ur