ur,ur,ur,ur,ur,ur,ub,ub,ub,ub,cb,ur,ur,cr,ux,ux,ux,ux,ux,ux,ux,ur,ur
ur,ur,ur,ur,ur,ur,ub,ub,ur,ur,ur,ur,ur,ur,ur,ur,ur,ur,ur,ur,ur,ur,ur
ur,ur,ur,ur,ur,ur,ux,ub,ur,ux,ux,ux,ux,ur,ur,ur,ur,ur,ur,ur,ur,ux,ur
ur,ur,ur,ur,ur,ur,ur,ub,ur,ur,ur,ur,ur,ur,ur,ur,ur,ur,ur,ur,ur,ux,ur
ur,ur,ur,ub,ub,ur,ur,ub,ur,ur,ur,ur,ur,ur,ur,ur,ur,ur,ur,ur,ur,ux,ur
ur,ur,ur,ur,ub,cg,ub,ub,ur,ur,ur,ur,ur,ur,ur,ur,ur,ur,ur,ur,ur,ur,ur
ur,ur,ur,ur,ur,ug,ug,ug,ug,ug,ug,ug,cr,ur,ur,ur,ur,ur,ur,ur,ur,ur,ur
ur,ur,cr,ug,ub,ur,ur,ur,ux,ur,ur,ur,ur,ur,cg,ur,ur,ur,ur,cg,ur,ur,ur
ub,ub,ub,ub,ub,ub,ub,cb,ux,ur,ur,ur,ur,ur,ug,ur,ur,ug,ug,ug,ur,ur,ur
ub,ub,ug,ug,ug,ux,ux,ur,ur,ur,ur,ur,ur,ug,ug,ur,ur,ug,ur,ur,ur,ur,ur
ub,ub,ux,ux,ug,ug,ux,cr,ur,ur,ur,ur,ur,ug,ug,ur,ur,ug,ur,ur,ur,ur,ur
ub,ub,ub,ub,ux,ug,ug,ug,ub,ub,ub,ub,ub,ub,ug,cr,ug,ug,ub,ur,ur,ur,ur
ub,ug,ux,ub,ux,ux,ub,ug,ug,ub,ub,ub,ug,ug,ug,ur,ur,ur,ur,ur,ur,ur,ur
ub,ug,ub,ub,ux,ug,ug,ug,ug,ub,ub,ub,ug,ug,ub,ur,ur,ur,ur,ur,ur,ur,ur
ub,ug,ug,ub,ub,ub,ub,ug,ug,ub,ub,cb,ug,ub,ub,ug,ub,ub,ux,ux,ux,ux,ur
ur,ur,ug,ur,ur,ug,ub,ub,ub,ub,ub,ug,ug,cb,ub,ub,ub,ub,ux,ux,ux,ux,ur
ur,ur,ug,ur,ur,ug,ug,ug,ug,ug,ub,ug,ug,ug,ub,ub,ub,ub,ub,ub,ub,ub,ur
ur,ux,ug,ux,ux,ux,ux,ug,ug,ug,ug,ug,ug,ug,ub,ug,ux,ub,ux,ux,ur,ux,ur
ur,ux,ug,ug,ug,ug,ux,ux,ug,ug,ug,ug,ug,ug,ub,ub,ub,ub,ub,ub,ur,ux,ur
ur,ux,ux,ux,ux,ug,ug,ux,ug,ug,ug,ug,ug,ux,ub,ux,ub,ub,ub,ub,ub,ub,ur
ur,ux,ux,ux,ux,ux,ug,ux,ug,ug,ux,ux,ux,ux,ur,ux,ub,ux,ub,ub,cb,ub,ur
ur,ux,ux,ux,ux,cg,ug,ux,ux,ux,ux,ux,ux,ux,ur,ur,cr,ur,ur,ur,ub,ub,ub
ur,ur,ur,ur,ur,ur,ur,ur,ur,ur,ur,ur,ur,ur,ur,ur,ub,ub,ub,ub,ub,cb,ub