ur,ur,ur,ur,ur,ur,ur,ur,ur,ur,ur,ur,ur,ur,ur,ur,ur,cb,ur,ur,ur,ur,ur
ur,ur,ur,ur,ur,ur,ur,ur,ur,ur,ur,ur,ur,ur,ur,ur,ur,ur,ur,ur,ur,ur,ur
ur,ur,ur,cr,ur,ur,ur,ur,ur,ur,ur,ur,ur,ug,ur,ur,ur,ur,ur,ur,ur,ur,ur
ur,cb,ub,ub,ur,ur,ur,ur,ur,ur,ur,cg,ug,ug,ug,ug,cb,cr,ur,ur,ur,ur,ur
ur,ur,ur,ur,ur,ur,ur,ur,ur,ur,ur,ur,ur,ub,ux,ug,ub,ub,ub,ub,ub,ub,ux
ur,ur,ur,ur,cr,cr,ur,ur,ur,ur,ur,ug,ug,ug,ug,ub,ub,ux,ub,ur,ug,ub,ux
ur,ub,cr,ur,ug,ug,cg,ug,ur,ur,ur,ug,ur,ug,ug,ub,ub,ux,ub,ur,ug,ub,ux
ub,ub,ug,ug,ur,ur,ur,ur,ur,ur,ur,ug,ur,ug,ug,ub,ux,ux,ub,ub,ub,ub,ux
ub,ub,ur,ug,ub,ux,ux,ux,ux,ux,ug,cg,ux,ug,ug,ub,ux,ux,ug,ur,ug,ug,ux
ug,ug,ug,ug,ub,ux,ux,ux,ux,ub,ug,ug,ub,cb,ub,ub,ub,ux,ug,ur,ug,ug,ux
ub,ub,ub,ub,ub,ux,ux,ux,ub,ub,ub,ub,ub,ub,ub,ub,ub,ux,ug,ur,ug,ug,ux
ub,ub,ub,ub,ub,ux,ux,ux,ux,ub,ub,ub,ub,ub,ub,ur,ub,ux,ug,ur,ug,ug,ux
ub,ug,ug,ug,ug,ug,ug,ug,ug,ub,ub,ub,cb,ub,ub,ug,ug,ug,ug,ur,ug,ug,cg
ub,ub,ub,ub,ub,ux,ux,ux,ux,ub,ug,ug,ub,ub,ug,ug,ub,ub,ub,ur,ug,ug,ux
ub,ug,ug,ug,ug,ug,ug,ug,ug,ub,ub,ub,ug,ug,ub,ub,ux,ux,ux,ur,ug,ug,ux
ub,ub,ub,ub,ub,ux,ux,ux,ug,ug,ug,ug,ug,ug,ub,ur,ux,ux,ug,ur,ug,ug,ux
ub,ub,ub,ub,ub,ug,ug,ug,ug,ug,ug,ug,ug,ug,ux,ur,ux,ux,ug,ur,ug,ug,ux
cg,ux,ub,ub,ug,ug,ug,ug,ug,ug,ub,ur,ur,ur,ur,ur,ur,ur,ug,ur,ug,ug,ux
ub,ub,ub,ub,ug,ug,ug,ub,ub,ub,ub,ub,ub,ub,ub,ub,ub,ub,ub,ub,ub,ub,cb
ub,ux,ub,cb,ug,ug,ug,ug,ug,ug,cg,ub,ub,ub,ub,ub,ub,ub,ub,ur,ur,cr,ub
ub,ub,ub,ug,ug,ug,ug,ug,ug,ug,ug,ug,ug,ug,ug,ug,ug,ug,ug,ur,ur,ug,ub
cr,ux,ux,ux,ux,ux,ux,ux,ux,ux,ux,ux,ux,ux,ux,ur,ux,ur,ux,ur,ur,ub,cb
cg,cg,ug,ug,ug,ug,ug,ug,ug,ug,ug,ug,ug,ug,ug,ug,ug,ug,ug,ur,ur,ur,ur