ur,ur,ur,ur,ur,ur,ur,ur,ur,ur,ur,ur,ur,ur,ur,ur,ur,ur,ur,ur,ur,ux,ux
ur,ur,ur,ur,ur,ur,ur,ur,ur,ur,ur,ur,ur,ux,ux,ux,ux,cr,ur,ur,ur,ux,ux
ur,ur,ur,ur,ur,ur,ur,ur,ur,ur,ur,ur,ux,ux,ux,ux,ur,ur,ur,ur,ur,ur,ux
ur,ur,ur,ur,ur,ur,cr,ur,ur,ur,ug,ug,ug,ug,ug,ug,cg,ur,ur,cr,ub,ub,ub
ur,ur,ur,ur,cr,ur,ur,ur,ug,ug,ug,ug,ug,ur,ur,ub,ur,ur,ur,ub,ub,ub,ub
ur,ur,ur,ur,ur,ug,ux,ux,ux,ux,ur,ub,ug,ug,ub,ub,ur,ur,ur,ub,ub,ub,ub
ur,ur,ur,ug,ug,ux,ux,ux,ux,ux,ux,ur,ub,ug,ub,ub,ub,ub,ur,cr,ug,ur,cb
ux,ux,ux,ux,ug,ug,ug,ug,ug,ug,ug,cb,ub,ug,ub,ug,ug,ug,ur,ur,ug,ur,ur
cg,ux,ux,ux,ub,ux,ux,ug,ug,ug,ug,ub,ub,ub,ub,ug,ur,ug,ur,ur,ug,ur,ur
ub,ub,ub,ub,ub,ux,ux,ux,ur,ub,ub,ub,ub,ub,ub,ug,ub,ug,ug,ug,ug,ur,ur
ub,ub,ub,ub,ub,ub,ub,ub,ub,ub,ub,ub,ub,ub,ub,ub,ur,ug,ug,ug,ug,ur,ur
ub,ub,ub,ub,ub,ub,ub,ub,ub,ub,ub,ub,cb,ub,ug,ub,ux,ug,ur,ur,ug,ur,ur
ub,ub,ub,ub,ub,ub,ub,ux,ub,ub,ub,ub,ub,ug,ug,ub,ub,ug,cg,ur,ug,ur,ur
cb,ub,ub,ub,ux,ub,ub,ub,ub,ub,ub,ub,ub,ug,ug,ub,ub,ug,ug,ux,ug,ux,ug
cg,ub,ub,ub,ub,ux,ux,ux,ug,ug,ug,ur,ug,ug,ug,cb,ug,ug,ug,ub,ug,ub,ub
ux,ux,ux,ux,ub,ux,ux,ux,ug,ug,ug,ur,ug,ug,ug,ug,ug,ur,ur,ub,ug,ux,ub
ux,ux,ux,ux,ub,ux,ux,ux,ug,ug,ug,ur,ug,ug,ug,ug,ug,ur,ub,ub,ug,ux,ub
ux,ux,ux,ub,ub,ux,ux,ux,ub,ug,ug,ur,ug,ux,ux,ux,ux,ur,ur,ux,ug,ux,ub
ux,ux,ub,ub,ux,ux,ux,ux,ub,ub,ub,ur,ub,ux,ux,ux,ux,ur,ur,ux,ug,ux,ub
ux,ux,ub,ub,ub,ub,ub,ub,ub,ub,cg,ub,ub,ub,ub,ub,ub,cr,ur,ur,ug,ur,ub
ux,ux,ux,ub,ub,ux,ux,ub,cb,ub,ug,ub,ug,ub,ub,ub,ub,ub,ux,ux,ug,ux,ub
ux,ux,ux,ub,ub,ux,ux,ub,ux,ub,ug,ub,ub,ub,ub,ub,ub,ub,ub,ub,ug,ub,ub
ux,ux,ux,ux,ux,ux,ux,ux,ux,cg,ug,ug,ug,ug,ug,ug,ug,ug,ug,ug,ug,ub,ub