ur,ur,ur,ur,ur,ur,ur,ur,ur,ur,ur,ur,cb,ub,cr,ur,ur,ur,ur,ur,ur,ur,ur
ur,ur,ur,ur,cb,ub,cr,ur,ur,ur,ur,ur,ux,ux,ur,ur,cr,ur,ur,ur,ux,ux,ur
ur,ur,ur,ur,ur,ur,ur,ur,ur,ur,ur,ur,ur,ur,ur,ur,ur,ur,ur,ur,ux,ux,ur
ur,ur,ur,ur,ur,ur,ur,ur,ur,ur,ur,ur,ur,ur,ur,ur,ur,ur,ur,ur,ux,ur,ur
cb,ur,ur,ur,ur,ur,ur,ur,ur,ur,ur,cr,ur,ur,ur,ur,ur,ur,ur,ur,ux,ur,ur
ur,ur,ur,ur,ur,ur,ur,ur,ug,ur,ur,ug,ur,ur,ur,ur,ur,ur,ur,ur,ur,ur,ur
ur,ur,ur,ur,ur,ur,ur,ur,ug,ug,ug,ug,ur,ur,ur,ur,ur,ur,ur,ur,ur,ur,ur
ur,ur,ur,cr,ub,ur,ur,ur,ur,ub,ub,cg,ur,ur,ur,ug,ug,ug,ur,ur,ur,ur,ur
cg,ux,ux,ub,ub,ub,ur,ur,ub,ub,ug,ub,ub,ub,ur,ur,ug,ug,ur,ur,ur,ur,ur
ux,ux,ug,ug,ug,ub,ug,ug,cb,ug,ug,ur,ub,ur,ug,ug,ug,ur,ur,ur,ur,ur,ur
ub,ub,ug,ub,ug,ub,ux,ux,ub,ub,ub,ur,ub,ub,ug,ug,ug,ub,ub,ub,ub,ub,ub
ub,ux,ug,ub,ug,ub,ux,ux,ub,ub,ub,ub,ub,ub,cg,ug,ug,ux,ux,ux,ux,ub,ub
ub,ux,ug,ub,ug,ug,ux,ux,ux,ub,ub,ub,ub,ub,ub,ug,ug,ux,ux,ux,ux,ub,ub
ub,ub,ug,ub,ub,ug,ub,ux,ux,ub,ub,ub,ub,ub,cb,ub,ub,ux,ux,ux,ux,ub,ub
cg,ub,ug,ub,ub,ug,ub,ux,ux,ux,ux,ub,ub,ub,ug,ug,ug,ux,ux,ux,ux,ub,cb
ub,ub,ug,ub,ub,ug,ub,ub,ub,ux,ux,ub,ub,ub,ug,ug,ux,ux,ux,ux,ux,ub,ur
ub,ux,ug,ub,ub,ug,ux,ux,ub,ux,ux,ub,ub,ub,ub,ux,ux,ux,ux,ux,ux,ub,cr
ub,ug,ug,ux,ub,ug,ux,ux,ub,ux,ux,ub,ux,ux,ux,ux,ux,ux,ux,ux,ux,ub,ub
ub,ug,ux,ux,ub,ug,ux,ux,ub,ux,ux,ub,ux,ux,ux,ux,ux,ux,ux,ux,ux,ub,ub
ub,ug,ux,ug,ug,ug,ug,ug,ug,ug,ug,ug,ug,ug,ug,ug,ug,ug,ug,ug,ug,ub,ub
ub,ug,ub,ug,ux,ug,ug,ug,ug,ub,ub,ub,ub,ub,ub,ub,ub,ub,ub,ub,ub,ub,ub
cg,ug,ub,ug,ug,ug,ug,ug,ug,ub,ub,ub,ub,ub,ub,ub,ub,ub,ub,ub,ub,ub,cb
ub,ub,ux,ux,ux,ux,ux,ux,ux,cg,ub,ub,ur,ur,ur,ur,ur,ur,ur,ur,ur,ur,ux