ur,ur,ur,ur,ur,ur,ur,ur,ur,ur,cb,ub,ur,ur,ur,ur,ur,cb,ur,ur,ub,ub,ub
ur,ub,ur,ur,ur,ur,ur,ur,ur,ub,ur,ub,ur,ur,ur,ur,ur,ub,ur,ur,ur,ux,ub
ur,ub,ub,ub,cr,ub,ur,ur,cr,cr,ur,ub,ur,ux,ux,ux,cr,ur,ur,ux,ur,ur,ub
ur,ur,ur,ur,ur,ur,ur,ur,ub,ub,ub,ub,ur,ur,ux,ux,ux,ux,ux,ux,ux,ux,ux
ur,ur,ur,ur,ur,cr,ug,ur,ug,ug,ur,ub,ur,ug,ug,ug,ug,ug,ug,ug,ux,ux,ux
ur,ur,ur,ur,ur,ur,ur,ur,ub,ub,ur,cb,ur,ux,ug,ug,ug,ug,ux,ug,ux,ux,ux
ur,ux,ur,ur,ug,ur,ur,ub,ug,ub,ub,ub,ug,ug,ug,ux,ux,ug,ux,ug,ux,ux,ux
ur,ux,ur,ur,ug,ur,ub,ub,ux,ux,ux,ux,ux,ug,ug,ug,ug,ug,ux,ug,ux,ux,ux
ur,ur,ur,ur,ug,ur,ub,ub,ub,ux,ux,ux,ux,ux,ux,ug,ug,ug,ux,ug,ux,ux,ux
ur,ur,ur,ur,ug,cg,ub,ub,ub,ux,ug,ug,ug,ub,ux,ug,ug,ug,ux,ug,ux,ux,ux
ur,ur,ur,ur,ug,ug,ug,ug,ub,ub,ug,ug,ug,ub,ux,ug,ug,ug,ug,ug,ux,ux,ux
ur,ur,ur,ur,ub,ug,ub,ug,ug,ub,ub,ub,ug,ux,ug,ug,ug,ug,ug,ug,ux,ux,ux
ux,ux,ux,ux,ub,ug,ub,ub,ug,ug,ub,ub,ub,ug,ug,ux,ug,ux,ux,ux,ux,ux,ux
ux,ux,ux,ux,ub,ug,ub,ub,ub,ug,ub,cg,ub,ug,ug,ug,ug,ux,ux,cr,ux,ux,ux
cg,ux,ux,ux,ug,ug,ug,ug,ub,ug,ub,ug,ug,cg,ug,ug,ug,ux,ux,ur,ux,ux,ux
ur,ur,ur,ur,ug,ur,ub,ug,ug,ug,ub,ub,cb,ug,ux,ux,ux,ux,ux,ur,ux,ux,ux
ur,ux,ux,ug,ug,ug,ub,ub,ur,ug,ub,ub,ug,ub,ux,ux,ux,ux,ux,ur,ux,ub,ux
ur,ux,ux,ug,ub,ug,cg,ug,ug,ug,ub,ub,ug,ug,ug,ug,ug,ux,ux,ur,ux,ub,ur
ur,ux,ux,ug,ug,ug,ug,ub,ub,ub,ux,ub,ub,ub,ux,ux,ug,ux,ux,ur,ux,ub,ub
ur,ux,ux,ux,ub,ub,ug,ug,ub,ub,ub,ub,cb,ug,ug,ug,ug,ur,ur,ur,ur,ur,ub
ur,ur,ur,ur,ub,ub,ub,ub,ub,ub,ub,ub,ur,ug,ug,ur,ug,ur,ur,ur,ur,ub,ub
cr,ux,ux,ux,ub,ub,ub,ug,ub,ub,ub,ub,ub,ub,ug,ug,ub,ub,ur,ur,ur,ur,cb
cg,ux,ux,ux,ub,ub,ux,ux,ux,cg,cb,ub,ub,ub,ub,ub,ub,ur,ur,ur,ur,ur,cb