ub,cb,cb,cr,ur,ub,ub,ub,ur,ur,ur,ur,ur,ur,ur,ur,ur,ur,ur,ur,ur,ur,cb
ur,ur,cb,ur,ub,ub,ub,ub,ur,ur,ur,ur,ur,ur,ur,ur,ur,ur,ur,ur,ur,ur,ur
ub,ub,ub,ub,ub,ub,ub,ub,ux,ur,ur,ur,ur,ur,ur,ur,ur,ur,ur,cr,cr,ur,ur
ub,cg,ug,ug,ug,ub,ux,ub,cb,ux,ur,ur,ur,ur,ur,ur,ur,ur,ur,ur,ur,ur,ur
ur,ur,ur,ur,ug,ug,ur,ux,cr,ur,ur,ur,ur,ug,ug,ug,ug,ur,ur,ur,ur,ur,ur
ur,ur,ur,ur,ur,ug,ur,ug,ur,ur,ur,ur,ur,ug,ug,ug,ug,ur,ur,ur,ur,ur,ur
ur,ur,ur,ur,ug,ug,ug,ug,ur,ug,ug,ur,ur,cg,ur,ur,ur,ur,ur,ur,ur,ur,ur
cb,ub,cr,ug,ug,ug,ur,ur,ug,ug,ug,ur,ug,ug,cr,ur,ur,ur,ur,ur,ur,ur,ur
ub,ub,ur,ug,ur,ug,ug,ug,ug,ur,ur,ug,ug,ug,ux,ug,ug,ug,ug,ug,ug,ug,ub
ub,cb,ur,ug,ug,ub,ux,ug,ur,ur,ub,ux,ux,ug,ux,ug,ug,ux,ug,ug,ug,ug,ub
ub,ub,ub,ub,ug,ub,ub,ug,ub,ub,ub,ug,ug,ug,ug,ug,ug,ux,ug,ug,ug,ug,ub
ux,ub,ub,ub,ug,ug,ug,ug,ub,ug,ug,ug,ug,cb,ub,ug,ux,ux,ug,ug,ug,ug,ub
cb,ub,ux,ub,ub,ug,ug,ug,ug,ub,ug,ug,ub,ug,ub,ug,ux,ux,ug,ug,ug,ug,ux
ub,ub,cb,ug,ub,ug,ug,ug,ug,ug,ub,ub,ub,ub,ub,ub,ux,ux,ug,ug,ug,ug,ux
ux,ux,ug,ug,ug,ug,ug,ug,ug,ug,ug,ug,ub,cg,cg,ur,ux,ug,ug,ug,ug,ug,ub
ux,ux,ug,ug,ug,ug,ug,ux,ux,ux,ux,ub,ug,ug,ug,ug,ug,ug,ug,ug,ug,ug,ub
ux,ux,ug,ug,ub,ug,ug,ug,ug,ux,ub,ug,cg,ug,ug,ug,ux,ux,ux,ug,ug,ug,ux
cr,ug,ug,ug,ug,ug,ug,ug,ug,ug,ug,ug,ur,ug,ug,ur,ur,ur,ur,ur,ur,ur,ur
cg,ug,ug,ug,ug,ux,ux,ug,ub,ux,ux,ux,ux,ug,ug,ug,ug,ux,ux,ug,ug,ug,ur
cb,ux,ux,ub,cb,cg,ub,ug,ub,ug,ux,ux,ug,ug,ug,ug,ug,ug,cr,ur,ur,ur,ur
ux,ub,ub,ub,ug,ug,ub,ug,ub,ub,ub,ug,ug,ug,ug,ug,ug,ug,ug,ug,ug,ug,cr
cr,ub,ub,ub,ub,ub,ur,ug,ub,ub,ub,ur,ug,ur,ug,ug,ug,ub,ub,cb,cb,ug,cr
cg,ur,cg,cb,ux,ug,ug,ug,ux,ux,ug,ug,ug,ur,ur,cg,ux,ux,ux,cg,cg,ug,cr