ur,ur,ur,ur,ur,ur,ur,ur,ur,ur,ur,ur,ur,ur,ur,ur,ur,ur,ur,cb,ub,ur,ur
ur,ur,ur,ur,ur,ur,ur,ur,ur,ur,ur,ur,ur,ur,ur,ur,ur,ur,ur,ur,cr,ur,ur
ur,ur,ur,ur,ur,ur,ur,ur,ur,ur,ur,ur,ur,ur,ur,ur,ux,ur,ur,ur,ur,ur,ur
ur,ur,ur,ur,ur,ur,ur,ur,ur,ur,ur,ur,ur,ur,ur,ur,ur,ur,ur,cr,ur,ur,ur
ur,ur,ur,ur,ur,ur,ur,ur,ur,ur,ur,ur,ur,ur,ur,ur,ur,ur,ur,ux,ub,ub,ub
ur,ur,ur,ur,cr,ur,ur,ur,ur,ur,ur,ur,ur,ur,ug,ug,ub,ug,ub,ub,ub,ub,ub
ux,ur,ur,ur,cr,ur,ur,ur,ur,ug,ug,cg,ug,ug,ug,ug,ub,ug,ub,ub,ub,ub,ub
ux,ur,cr,ub,ub,ur,cg,ur,ur,ug,ur,ug,ug,cb,ug,ug,ug,ug,ub,ub,ub,ub,ub
ur,ur,ub,ur,ur,ur,ug,ug,ug,ub,ur,ug,ub,ub,ub,ug,ug,ug,ub,ux,ux,ux,ux
ur,ux,ub,ur,ur,ur,ug,ug,ug,ub,ub,ub,ub,ug,ug,ug,ug,ug,ux,ux,ux,ux,ux
ux,ux,ub,ur,ur,ug,ug,ur,ug,cb,ub,ub,ub,ug,ug,ug,cg,ug,ux,ux,ux,ux,ux
ux,ux,ub,ur,ur,ug,ug,ur,ug,ug,ug,ub,ub,ub,ux,ux,ux,ub,ux,ux,ux,ux,ux
ux,ux,ub,ur,ur,ur,ug,ug,ug,ur,ub,ub,ub,ub,ux,ub,ub,ub,ub,ux,ux,ux,ux
ux,ux,ub,ug,ux,ug,ug,ug,ub,ub,ub,ub,ub,ub,ug,ub,ux,ux,ux,ux,ux,ux,ux
ux,ux,ub,ug,ux,ug,ug,ug,ug,ub,ub,ub,ug,ub,ux,ub,ub,ub,ub,ux,ux,ux,ux
ux,ux,cb,ug,ug,ug,ug,ug,ug,ub,ub,ux,ug,cb,ux,ub,ub,ux,ub,ux,ux,ux,ux
ux,ux,ug,ux,ug,ug,ug,ug,ub,ug,ub,ug,ug,ub,ub,ub,ub,ub,ub,ur,ur,ux,ux
ux,ux,ug,ux,ug,ug,ug,ug,ug,ug,ug,ug,ub,ub,ub,ub,ub,ur,ur,ur,ur,ux,ux
ur,ur,ur,ur,ur,ur,ur,ur,ur,ur,ug,ug,ur,ug,ug,ug,ug,ug,ur,ur,ur,ux,ux
ur,ux,ug,cr,ur,ur,cg,ug,ug,ug,ug,ug,ub,ug,ug,ug,ur,ug,ug,ur,ux,ux,ux
ur,ux,ug,ux,ux,ux,ug,ux,ux,ux,ur,ug,ub,ug,ug,ug,ur,ur,ug,ug,ur,ur,ur
ur,ux,ug,ug,ug,ug,ug,ug,ug,ug,ur,ug,ug,ug,ug,ug,ug,ug,ug,ug,ur,ur,ur
ur,ur,ur,ur,ur,ur,ur,ur,ur,ur,ur,ug,ug,ug,ug,ub,ur,ur,ur,ur,ur,cb,ur