ur,ur,cb,ur,ur,ur,ur,ur,ur,ur,ug,ug,ug,ug,ug,ur,ur,ur,ur,cg,ux,ux,ux
ur,ur,ur,ur,ur,ur,ur,ur,ur,ur,ur,ur,ug,ur,ug,ur,ur,ur,ur,ux,ux,ux,cr
ur,ur,ur,ur,ur,ur,ur,ur,ur,ur,ur,ur,cr,ug,ug,ux,ur,ur,ur,ur,ur,ur,ur
ur,ur,ur,ur,ur,ur,ur,ur,ur,ur,ur,ur,ur,ur,ug,ux,ux,ux,ux,ux,ur,ug,ug
ur,ur,ur,ur,ur,ur,ur,ur,cr,ur,ur,ug,ur,ug,ug,ug,ug,ub,ub,ub,ub,ub,ub
ur,ur,ur,ur,ur,ur,cg,ur,ug,ur,ur,ug,ur,ug,ur,ug,ub,ub,ux,ux,cb,ub,ub
ur,ur,ur,ur,ur,ur,ug,ur,ur,ur,ur,cr,ub,ub,ub,ub,ub,ug,ux,ux,ur,ux,ug
ur,ux,cr,ur,ur,ur,ug,ug,ur,ur,ub,ub,ub,ub,ub,ug,ux,ug,ux,ux,ur,ux,ug
ur,ux,ux,ux,ux,ug,ug,ug,ug,ug,ug,ug,ug,ub,ub,ug,ub,ub,ub,ux,ur,ux,ug
ur,ux,ur,ur,ur,ug,ug,ug,ug,cg,ux,ub,ug,ub,ub,ub,ub,ug,cb,ux,ur,ux,ug
ur,ur,ur,ur,ur,ur,ur,ur,ug,ug,ug,ub,ug,ug,ub,ug,ug,ug,ub,ub,ur,ub,ub
ur,ur,ur,ur,ux,ux,ug,ug,ug,ux,ug,ug,ub,ug,ub,ub,ug,ug,ux,ux,ur,ug,ub
cg,ux,ux,ux,ux,ux,ug,ug,ug,ux,ug,ux,ub,ug,ub,ub,ug,ug,ub,ub,ur,ug,ub
ux,ux,ux,ux,ux,ux,ug,ux,ug,ug,cb,ub,ub,ub,ug,ug,ug,ug,ub,ux,ur,ug,ub
ux,ux,ux,ux,ux,ux,ug,ug,ug,ux,ub,ub,ug,ub,ug,ug,ug,ug,ub,ux,ur,ug,ub
ux,ux,ux,ux,ux,ux,ux,ux,ux,ux,ux,ub,ug,ub,ub,ug,ug,ug,ux,ux,ur,ug,ub
ux,ux,ug,ug,ug,ug,ug,ug,ug,ux,ux,ub,ug,ug,ub,ub,ub,ub,cb,ur,ur,ug,ub
cg,ux,ug,ux,ux,ux,ub,ub,ub,ux,ux,ub,ug,ug,cg,ub,ug,ug,ux,cr,ub,ub,ub
ux,ux,ug,ux,ux,ux,cg,ug,cb,ux,ux,ub,ub,ub,ub,ub,ub,ub,ux,ux,ub,ub,ub
ux,ux,ug,ux,ux,ux,ux,ub,ub,ub,ug,ux,ub,ub,ub,ub,ub,ub,ub,ub,ub,ub,ub
cr,ux,ug,ux,ux,ux,ux,ub,ub,ux,ug,ug,ub,ub,ub,ub,ub,ub,ub,ub,ub,ub,ub
cg,cb,ur,ug,ug,ug,ug,ub,ub,ub,ub,ug,ub,ub,ub,ub,ub,ub,ub,ub,ub,cb,cr
cr,ux,ur,ug,ug,ug,ug,ug,ub,ub,ub,ur,ub,ub,ub,ub,ub,ub,ub,ub,cb,ux,cr