ur,ur,cb,ur,ur,ur,ur,ur,ur,ur,ur,ur,ur,ur,ur,ur,ur,ur,ur,cg,ug,ug,ug
ur,ur,ur,ur,ur,ur,ur,ur,ur,ur,ur,ur,ur,ur,ur,ur,ur,ur,ur,ub,ug,ux,ug
ur,ur,ur,ur,ur,ur,ug,ur,ur,cr,ur,ur,ur,ur,ux,ur,ux,ur,ug,ug,ug,ux,ug
ur,ur,ur,ur,ur,ur,ur,ur,ur,ur,ug,ur,ur,ur,ur,ur,ur,ur,ux,ux,ux,ux,ug
ur,ur,ur,ur,ur,ur,ur,ur,ur,ur,ur,ur,ur,ur,cr,ux,ur,ug,ug,ug,ug,ux,ug
ur,ur,ur,ur,ur,ur,cr,ug,ug,ug,ug,ug,ux,ur,ux,ux,ux,ux,ux,ux,ug,ux,ug
ur,ur,ur,ur,ur,ur,ur,ur,ux,ur,ur,ug,ur,ux,ux,ux,ug,ug,cg,ux,ug,ug,ug
ur,ur,ur,ur,ur,ur,ur,ur,ur,ur,ur,ug,ur,ug,ug,ug,ug,ug,ug,ux,ux,ux,ux
ur,ur,ug,ug,cg,ur,cr,ug,ug,ug,ug,ug,ub,ug,ug,ug,ug,ug,ug,ur,ur,ur,ur
ur,ur,ub,ug,ub,ub,ub,ub,ub,ub,ug,ub,ub,ub,ub,ug,ug,ug,ug,ur,ur,ur,ur
ur,ub,cr,ur,ub,ur,ug,ug,ug,ug,ug,ux,ub,ub,ub,ug,ug,ug,ug,ug,ur,ur,ur
ur,ub,ur,ur,cb,ur,ug,ux,ub,ug,ub,ub,ub,ub,ug,ug,ug,ug,ug,ug,ur,ur,ur
cg,ur,ur,cb,ur,ur,ug,ux,ux,ug,ub,ug,cb,ub,ub,ub,cb,ug,ug,ug,ur,ur,ur
ur,ur,ur,ub,ub,ub,ub,ub,ux,ug,ug,ub,ub,ub,ug,ug,ug,ug,ug,ug,ur,ur,ur
ub,ub,ub,ub,ug,ug,ug,ub,ux,ub,ub,ub,ub,ub,ub,ug,ug,ug,ug,ug,ur,ur,cg
ub,ub,ub,ub,ub,ub,ub,ub,ux,ug,ub,ug,ug,ug,ub,ug,ux,ux,ux,ur,ur,ur,ug
ux,ux,ug,ug,ug,ug,ug,ux,ux,ug,ug,ub,ub,ug,ug,ug,ug,ug,ug,ug,ug,ur,ug
cg,ux,ug,ux,ug,ug,ug,ub,ug,ug,ug,ub,ug,ug,ug,ug,ug,ug,ux,ur,ug,ur,ug
ux,ux,ug,ug,ug,ub,ux,ug,ug,ub,ug,ub,ux,ux,ug,ug,ug,ug,ux,ur,ug,ur,ug
ux,ux,cr,ur,ur,ur,ur,ur,ur,ur,ur,ur,ur,ur,ur,ur,ur,ur,ur,ur,ug,ug,ug
cr,ux,ux,ug,ub,ug,ug,ug,ug,ug,ug,cg,ux,ux,ux,ux,ux,ux,ux,ur,ur,ur,ur
cg,cb,ux,ug,ub,ug,ug,ug,ub,ub,cb,ug,ux,ux,ux,ux,ux,ux,ux,ur,ur,cb,cr
cr,ug,ug,ug,ux,ub,ub,ub,ub,ub,ub,ur,ur,ur,ur,ur,ur,ur,ur,ur,cb,ux,cr