ux,cb,cb,cr,ur,cr,ub,ub,ur,ur,ur,ur,ur,ur,ur,ur,cg,ur,ur,ur,ur,ub,cb
ux,ur,cb,ux,ur,ur,ux,ub,ur,ur,ur,ug,ug,ur,ur,ur,ug,ur,cr,ur,ur,ub,ub
ux,ur,ux,ux,ur,ur,ur,ub,ur,ur,cr,ur,ur,ur,ur,ur,ug,ur,ub,ur,ub,ub,ux
ub,ub,ub,ub,ub,ur,cg,ub,ur,ur,ub,ur,cr,ub,ur,ug,cb,ub,ub,cb,ux,ux,ux
ub,ub,ub,ub,cr,ug,ug,ub,ur,ur,ur,ub,ub,ub,ur,ur,ur,ub,ub,ub,ub,ub,ub
ur,ur,ur,ur,ur,ur,ug,cb,ug,ux,ux,ub,ux,ub,ub,ub,ub,ub,ub,ub,ub,ub,ur
ur,ur,ur,ur,ur,ur,ug,ur,ug,ux,ux,ub,ub,ux,ux,ur,ux,ub,ub,ub,ub,ub,ur
cb,ur,ur,ur,ug,ur,ug,ux,ug,ub,ub,ux,ub,ug,ug,ug,ug,ub,ux,ux,ub,ub,ur
ur,ur,ur,ur,ur,ur,ug,ug,ug,ug,ug,ug,ug,ug,ug,ug,ug,cg,ux,ux,ur,ur,ur
ur,ur,ur,ur,ur,ur,ug,ub,ub,ug,ux,ux,ug,ug,ug,ug,ug,ux,ux,ux,ur,ur,ur
ug,ug,ug,ur,ur,ug,ug,ub,ub,ug,ux,ub,ug,ug,ug,ug,ug,ux,ux,ux,ur,ur,ur
ug,ug,ug,ur,ur,ug,ug,ub,ub,ug,ub,ub,ug,ug,ug,ug,ug,cr,ur,ur,ur,ur,ur
cb,cg,ug,ur,ur,ux,ux,ux,ux,ug,ux,ux,ug,ux,ux,ur,ux,ux,ux,ux,ur,ur,cg
ur,ur,ug,ug,ug,ug,ug,ug,ug,ug,ux,ug,ug,ux,ux,ur,ux,ux,ux,ux,ur,ur,ug
ur,ug,ug,ug,ug,ug,ug,ug,ug,ug,ux,ug,ug,ux,ug,ug,ug,ug,ug,ug,ur,ur,ux
cb,ug,ug,ug,ug,ug,ug,ug,ug,ug,ux,ug,ug,ux,ug,ur,ux,ug,ug,ug,ur,ur,ux
ux,ug,ug,ug,ug,ug,ug,ug,ux,ug,ug,ug,ug,ux,ug,ux,ux,ug,ux,ug,ur,ur,ux
ux,ug,ug,ug,ug,ub,ug,ug,ux,ug,ug,ug,ug,ux,ug,ux,ux,ug,ux,ug,ur,ur,ux
ux,ug,cg,ux,ug,cb,ug,ug,ug,ug,ug,ug,ug,ux,ug,ux,ux,ug,ux,ug,ur,ur,ux
ux,ux,ux,ux,ug,ub,ug,ug,ug,ug,ug,ub,ug,ug,ug,ug,ug,ug,ug,ug,ur,ur,cb
cr,ux,ux,ux,ug,ug,ug,ug,ug,ug,ug,ug,ux,ux,ug,ux,ux,ux,ux,ux,ur,ur,cr
cg,ux,ux,ux,ux,ug,ug,ug,ug,ug,ug,ug,ux,ux,ug,ux,ux,ux,ux,cb,cb,ur,cr
cr,cg,cg,cb,ub,ug,ub,ub,ux,ux,ux,ug,ug,ug,ug,cg,ux,ux,ux,cg,cg,ur,cr