ur,ur,cb,ur,ur,ur,ur,ur,cr,ux,ux,ux,ur,ur,ur,ur,ur,cb,cb,cr,ur,ur,ur
ur,ur,ur,ur,ur,ur,ur,ur,ur,ur,ur,ur,ur,ur,ur,ur,ur,ur,ur,ur,ur,ur,ur
ur,ur,ur,ur,ur,ur,ur,ur,ur,ur,ur,ur,ur,ur,ur,ur,ur,ug,cg,ur,ug,ux,ub
ur,ur,ur,ur,ur,ur,ur,ur,ur,ur,ur,ur,ur,ur,ur,ug,ur,ug,ub,ub,ug,ub,ub
ux,ur,ur,ur,ur,ur,ur,ur,ur,cr,cr,ur,ux,ug,ur,ub,ug,ug,ux,ug,ug,ub,ug
ux,ur,ur,ur,ur,ur,ur,ur,ur,ur,ug,ub,ux,ug,ur,ux,ug,ug,ug,ug,ux,ux,ug
ux,ur,ur,ur,cb,ub,ub,ub,ur,ur,cg,ub,ug,ug,ur,ub,ug,ub,ub,ug,ux,ux,ug
ux,ur,ur,ur,ur,ur,cr,ub,ur,ub,ub,ur,ur,ug,ur,ux,ug,ub,ux,ug,ux,ux,ug
ux,ux,ur,ur,ug,ug,ug,ug,ur,ub,ub,ur,ur,ug,ub,ub,ug,ux,ux,ug,ux,ux,ug
ux,ux,ux,ur,ug,cg,ur,ur,ur,ub,ub,ub,cb,ug,ub,ub,ug,ux,ux,ug,ug,ug,ug
ux,ux,ux,ur,ur,ub,ux,ug,ub,ub,ub,ub,ur,ug,ug,ug,ug,ug,ux,ug,ux,ux,ux
ux,ux,ux,ur,ur,ub,ub,ug,ug,ug,ug,ug,ug,ug,ug,ug,ug,ug,ug,cb,ub,ub,ub
cg,ur,ur,ur,ub,ub,ub,ux,ug,ug,ug,ug,ug,ug,ug,ug,ug,ug,ug,ub,ub,ub,ub
ur,ur,ub,ub,ub,ub,ug,ub,ug,ug,ug,ug,ug,ug,ug,ug,ug,ug,ux,ub,ub,ub,ub
ur,ub,ub,ub,ub,ub,ug,ub,ug,ug,ug,ug,ug,ug,ug,ug,ug,ux,ux,ug,ux,ux,ub
ub,ub,ub,ux,ux,ug,ug,ux,ux,ug,cg,ug,ug,ug,ug,ug,ug,ux,ux,ug,ux,ux,ub
ub,ub,ub,ub,ug,ug,ug,ux,ux,ug,ug,ug,ug,ug,ug,ug,ug,ur,ur,ug,ur,ur,ub
cg,ux,ux,ux,ug,ux,ug,ub,ub,ux,ux,ug,ug,ug,ug,ug,ug,ug,ux,ug,ux,ux,ub
ur,ur,ub,ub,ug,ug,ug,ub,ub,ub,ub,ub,ub,ub,ub,ub,ub,ub,ub,ub,ub,ub,ub
ur,ur,ur,ur,ur,ur,ur,ur,ur,ur,ur,ur,ur,ur,ur,ur,ur,ur,ur,ur,ur,ur,ur
ur,cr,ub,ub,ub,ub,ub,ub,ub,ub,ub,ub,ur,ur,ur,ur,ur,ur,ur,ug,ur,ur,ur
cr,ux,ux,ux,ux,ux,ux,ux,ux,ux,ub,ub,ux,ux,ux,ux,ux,ux,ux,ug,ux,cb,cr
cg,ux,ux,ux,ux,ux,ux,ux,ux,ux,ub,ub,ux,cb,ux,ux,ux,ux,ux,cg,cb,ux,cr