ur,cb,cb,cr,ur,ur,ur,ur,ur,ur,ur,ur,ur,ur,cr,ub,ub,ub,ub,ub,ux,ux,cb
ur,cb,cb,ur,ur,ur,ur,ur,ur,cr,ur,ur,ur,cr,ug,ub,ub,ub,ub,ub,ux,ux,ux
ur,ux,ux,ur,ur,ur,ur,ur,ur,ug,ur,ur,ur,ub,ug,ub,ur,ux,ux,ux,ub,ub,ub
ug,ug,ug,ug,ug,cg,ur,ur,cg,ug,ur,ur,ub,ug,ug,ur,ug,ug,ug,cg,ub,ub,ub
ug,ur,ur,ur,ur,ur,ur,ur,ur,ur,ub,ub,ur,ug,ub,ug,ug,ug,ug,ug,ub,ub,ub
cr,ur,ur,ur,ur,cb,ub,ub,ub,ub,ub,ug,ug,ug,ur,ug,ug,ug,ub,ug,ub,ub,ub
ur,ur,ug,ur,ur,ur,ur,ur,ur,ur,ur,ur,ur,ub,ur,ug,ug,ug,ub,ug,ub,ub,ub
cb,ur,ur,ur,cr,ur,ug,ur,ur,ur,ur,ur,ur,ug,ur,ug,ug,ug,ub,ug,ub,ub,ub
ug,ug,ug,ug,ug,ur,ur,ur,ur,ur,ub,ur,ug,ug,ur,ug,ug,ug,ug,ug,ux,ux,cr
ug,ug,ug,ug,ug,ur,ur,ug,ur,ug,ug,ug,ug,ug,ur,ur,ug,ug,ug,ug,ux,ux,ur
ux,ur,ur,ur,ug,ur,ur,ug,ug,ug,ug,ug,ug,ur,ur,ub,ub,ug,ug,ug,ux,ux,cb
ux,ux,ug,ug,ug,ug,ub,ug,ug,ug,ug,ug,ug,ur,ub,ub,ub,ub,ub,ub,ub,ub,ub
cb,ug,ug,ub,ub,ug,ub,ug,ug,ug,ux,ug,ug,ub,ub,ug,ug,ug,ug,ux,ux,ux,cg
cb,ug,ug,ug,ub,ug,ug,ug,ug,ug,ug,ub,ub,ub,ub,ub,ub,ub,ub,ux,ux,ux,ux
ux,ug,ug,ug,ub,ug,ux,ub,ug,ug,ug,ub,ub,ub,ub,ub,ub,ub,ub,ux,ub,ub,ux
ux,ux,ux,ux,ub,ug,ug,ug,ub,ub,ub,ub,ub,ub,ub,ub,ub,ub,ub,ux,ub,ub,ux
ux,ux,ux,ux,ug,ug,ub,ub,ub,ub,ub,ub,cg,ug,ub,ub,ub,ub,ub,ub,ub,ub,cb
ux,ux,ux,ux,ub,ub,ub,ub,ux,ux,ux,ux,ux,ug,ug,ug,ug,ug,ug,ug,ug,ub,ux
ux,ux,ux,ux,ub,ug,ub,ub,ux,ux,ux,ux,ux,ug,ug,ug,ug,ug,ug,ug,ug,ux,ux
ux,ux,ux,ux,ub,ug,ub,ux,ux,ux,ux,ux,ux,ub,ub,ub,ub,ux,ux,ux,ux,ux,ux
cr,ux,ug,ug,cg,ug,ub,ux,ux,ux,ux,ux,ux,ub,ub,ub,ub,ux,ux,ux,ux,ux,cr
cg,ux,ug,ug,ug,ug,ub,ux,ux,ux,ux,ux,ux,ub,ub,ux,ux,ux,ux,cb,cb,ux,cr
cr,cg,cg,cb,ug,cb,ub,ux,ux,ux,ux,ux,ux,ub,ub,cg,ux,ux,ux,cg,cg,ux,cr