ur,ur,ur,ur,ur,ur,ur,cb,ub,ub,ub,ub,ur,ur,ur,ur,ur,cb,ux,ux,ux,ux,ux
ur,ur,ur,ur,ur,ur,ur,cg,ug,ur,ur,ub,ub,ub,ub,ur,ur,ux,cr,ux,ux,ux,ux
ur,ux,ur,ur,ur,ur,ur,ug,ur,ur,ur,ur,ur,ur,ur,ur,ur,ur,ur,ur,ur,ux,ux
ur,ur,cr,ur,cr,ug,ug,ug,ub,ug,ug,ug,ur,ug,cr,ur,ur,ur,ug,ug,ug,ub,ub
ug,ur,ur,ur,ug,ug,ur,ur,ub,ux,ux,ux,ub,ub,ux,ux,ur,ur,ux,ur,ub,ub,ub
ug,ur,ur,ug,ug,ub,ub,ub,ub,ug,ug,ug,ug,ug,ug,ug,ug,ug,ug,ug,ug,ug,ug
ug,ug,ug,ug,ub,ub,ub,ub,ub,ub,ub,ub,ub,ux,ub,ub,ub,ub,ur,ux,ux,ub,cg
ub,ur,ur,ur,ur,ur,ug,ur,cg,ug,ug,ug,ug,ug,ug,ug,ug,ug,ub,ub,ub,ub,ub
ub,ur,cr,ug,ug,ux,ug,ux,ub,ug,cb,ub,ub,ug,ug,ug,ug,ug,ub,ub,ub,ub,ub
ub,ub,ur,ur,ux,ub,ug,ux,ub,ub,ub,ub,ub,ub,ub,ub,ug,ub,ub,ub,ub,ux,ub
ub,ub,ub,ug,ug,ug,ug,ux,ux,ug,ub,cb,ub,ux,ug,ub,ub,ug,ug,ub,ub,ux,ub
ub,ub,ub,ug,ug,ug,ug,ux,ux,ug,ux,ux,ux,ux,ug,ug,ug,ug,ug,ug,ub,ub,ub
ub,ub,ub,ux,ux,ub,ug,ux,ux,ug,ux,ux,ux,ug,ug,ug,ug,ug,ug,ug,ub,ux,ub
ub,ub,ub,ub,ub,ub,ug,ug,ug,ug,ur,ur,ug,ug,ug,ug,ug,ug,ug,ug,ub,ub,ub
cg,ub,ub,ux,ux,ux,ux,ux,ux,ux,ux,ux,ug,ug,ux,ug,ug,ug,ug,ug,ub,ub,cb
ub,ub,ub,ug,ug,ug,ug,ug,ug,ug,ug,ug,ug,ug,ug,ub,ug,ug,ug,ug,ub,ub,ur
ub,ub,ub,ug,ux,ux,ux,ux,ux,ux,ux,ug,ug,ug,ug,ug,ug,ug,ug,ux,ux,ub,ur
ub,ub,ub,ug,ux,ux,ux,ux,ux,ux,ux,ug,ug,ug,ux,ux,ux,ux,ux,ux,ux,ur,cr
ub,ub,cg,ug,ug,ug,ug,ug,ug,ug,ug,ug,ur,ux,ux,ux,ux,ux,ux,ux,ux,ur,ux
ub,ub,ug,ub,ug,ug,ug,ug,ug,ug,ug,ug,ur,ur,ur,ur,ur,ur,ur,ur,ur,ur,ux
ub,ub,cb,ub,ux,ub,ub,ux,ub,ub,ub,ux,ux,ux,ux,ux,ux,ux,ux,ux,ux,ux,ux
cr,ub,ub,ub,ub,ub,ub,ub,ub,ux,ux,ux,ux,ux,ux,ux,ux,ux,ux,ux,ux,ux,cb
cg,ub,ub,ub,ub,ux,ux,ux,ux,cg,ux,ux,ux,ux,ux,ux,ux,ux,ux,ux,ux,ux,cb