ub,ub,ub,ub,cr,ur,cg,ur,ur,ur,ub,ub,ur,ur,ur,ur,ur,cb,ur,ur,ur,ur,ur
ub,ub,ub,ub,ug,ug,ug,ur,ur,ur,ux,ub,ub,ub,ub,ur,ur,ux,ur,ur,ux,ux,ur
ur,ur,ur,ub,ub,ug,ur,cr,ur,ur,ur,ur,ur,ux,ux,ur,ur,ur,ur,ux,ux,ux,cr
ur,ur,ur,ur,ub,ub,ub,ub,cb,ur,ur,ur,ur,ur,ur,ur,ur,ur,ug,ug,ug,ub,ub
cr,ur,ur,ur,ug,ug,ur,ub,ub,ux,ux,ur,ur,ur,ux,ux,ur,ur,ux,ux,ub,ub,ub
ur,ur,ur,ug,ug,ub,ub,ub,ub,ug,ug,ug,ug,ug,ug,ug,ug,ug,ug,ug,ug,ug,ug
ug,ug,ug,ug,ub,ub,ub,ub,ub,ub,ub,ug,ug,ug,ug,ug,ug,ug,ug,ux,ux,ub,ug
ub,ur,ur,ur,ur,ur,ug,ub,ug,ug,ug,ug,ug,ug,ug,ug,ug,ug,cg,ub,ub,ub,ug
ub,ur,cr,ug,ug,ux,ub,ub,cb,ug,ug,ub,ub,ug,ug,ug,ug,ug,ub,ub,ub,ub,ug
ub,ub,ur,ur,ux,ub,ub,ub,ug,ug,ug,ub,ub,ub,ub,ub,ug,ub,ub,ub,ub,ux,ug
ub,ub,ub,ug,ug,ug,ug,ux,ux,ug,ub,cb,ub,ub,ug,ub,ub,ug,ug,ub,ub,ux,ug
ub,ub,ub,ug,ug,ug,ug,ux,ux,ug,ux,ub,ub,ub,ug,ux,ux,ug,ug,ug,ub,ub,ug
ub,ub,ub,ub,ub,ub,ug,ux,ux,ug,ux,ux,ux,ux,ug,ug,ux,ug,ug,ug,ux,ux,ug
ub,ub,ub,ub,ub,ub,ug,ug,ug,ug,ur,ur,ug,ug,ug,ug,ug,ug,ug,ug,ub,ub,ug
cg,ub,ub,ux,ux,ux,ux,ux,ux,ux,ux,ux,ug,ug,ux,ug,ug,ug,ug,ug,ux,ub,ug
ux,ub,ub,ug,ug,ug,ug,ug,ug,ug,ug,ug,ug,ug,ux,ux,ux,ug,ug,ug,ux,ub,ug
ux,ub,ub,ug,ux,ux,ux,ux,ux,ux,ux,ug,ug,ug,ux,ux,ux,ug,ug,ux,ux,ub,ug
ux,ub,ub,ug,ux,ux,ux,ux,ux,ux,ux,ug,ug,ug,ux,ux,ux,ux,ux,ux,ux,ur,ug
ux,ub,cb,ug,ug,ug,ug,ug,ug,ug,ug,ug,ux,ux,ux,ux,cb,ux,ux,ux,ux,ur,ug
ux,ub,ug,ub,ug,ug,ug,ug,ug,ug,ug,ug,ux,ux,ux,ux,ub,ux,ux,ur,ur,ur,ug
ux,ub,cg,ub,ux,ub,ub,cr,ur,ur,ur,ur,ur,ur,ur,ur,ub,ub,cg,ug,ug,ug,ug
cr,ub,ub,ub,ub,ub,ub,ub,ub,ux,ux,ux,ux,ux,ux,ux,ux,ux,ux,ub,ux,ub,cb
cg,ub,ub,ub,ub,ux,ux,ux,ux,cg,ux,ux,ux,ux,ux,ux,ux,ux,ux,ub,ub,ub,cb