ur,ur,ur,ur,ur,ur,ur,ur,ur,ur,cr,ur,ur,ur,ug,ug,ur,ur,ur,ur,ur,ub,ub
ur,ur,ur,ur,ur,ur,ur,ur,ur,ur,ur,ur,cr,ur,ur,cr,ug,ug,ug,ug,ug,ug,ug
ur,ur,ur,ur,ur,ur,ur,ur,ur,ur,ur,ur,ur,ur,ur,ur,ur,ur,ur,ur,ur,ub,ug
ur,ur,ur,ur,ur,ur,ur,ur,ur,ur,ur,ur,cr,ur,ur,ur,ug,ug,ug,ub,ub,ub,ug
ur,ur,ur,ur,ur,ur,ur,ur,ur,ur,ur,ur,ur,ur,ug,cr,ug,ux,ug,ub,ux,ux,ug
ur,ur,ur,ur,ur,ur,ur,ur,ur,ur,ur,ur,ug,ug,ug,ux,ux,ux,ug,ub,ub,ub,ug
ur,ur,ur,ur,ur,ux,ug,ug,ur,ur,ux,ux,ux,ux,ux,ux,ux,ux,ub,ub,ub,ub,ug
ur,ur,ur,ur,ur,cg,ux,ug,ux,ub,ub,ub,ux,ux,ux,ug,ug,ug,ub,ub,ub,ux,ug
cg,ux,ur,ur,ux,ug,ug,ug,ub,ub,ub,ub,ug,ug,ug,ug,ug,ug,ub,ux,ub,ub,ug
ub,ub,ub,ub,ur,ur,cb,ug,ub,ug,ux,ub,ux,ux,ux,ux,ug,ug,ub,ux,ux,ux,ug
ub,ux,ux,ub,ux,ux,ub,ug,ub,ub,ub,ub,ub,ub,ub,ug,ug,ux,ub,ux,ux,ux,ug
ub,ux,ux,ub,ub,ub,ub,ub,ub,ub,ub,ug,ug,ug,ub,ug,ux,ux,cb,ux,ux,cg,ug
ub,ux,ux,ub,ub,ub,ub,ub,ub,ub,ub,cb,ub,ub,ub,ug,ug,ug,ug,ux,ux,ux,cr
ub,ux,ux,ub,ub,ub,ub,ux,ub,ub,ub,ub,ub,ub,ug,ug,ux,ux,ux,ux,ux,ux,ur
ub,ux,ux,ub,ux,ug,ug,ux,ux,ub,ub,ub,ub,ub,ug,ug,ub,ux,ux,ux,ux,ux,ur
ub,ux,ux,ub,ux,ug,ug,ug,ux,ub,ub,ug,cb,ub,cb,ug,ub,ux,ux,ux,ux,ux,ur
ub,ux,ux,ub,ux,ux,ub,ug,ug,ub,ub,ub,ub,ug,ub,ug,ub,ux,ux,ux,ux,ux,ur
ub,ux,ux,ub,ux,ux,ux,ug,ug,ug,ug,ub,ux,ug,ub,ub,ub,ux,ux,ux,ux,ux,ur
ub,ux,ux,ub,ux,ux,cg,ug,ug,ug,ug,ug,ug,ug,ub,ug,ux,ux,ux,ux,ux,ux,ur
ub,ux,ux,ub,ux,ux,ux,ux,ub,ux,ub,ub,ub,ub,ub,ub,ux,ux,ux,ux,ux,ux,ur
ub,ux,ux,ub,ux,ux,ux,ux,ux,ux,ub,ub,ub,ub,ub,ub,ux,ux,ux,ux,ux,ux,ur
ub,ux,ux,ub,ux,ux,ux,ux,ux,ux,ub,ub,ux,ux,ux,ux,ux,ux,ux,ux,ux,ux,ur
ub,ub,ub,ub,ub,ub,ub,ub,cb,ur,ur,ur,ur,ur,ur,ur,ur,ur,ur,ur,ur,ur,ur