ur,ur,ur,ur,ur,ur,ur,ur,ur,ur,ur,ur,ur,ub,ur,ur,ur,cb,ur,ur,ur,ur,ug
ur,ur,ur,ur,cr,ur,ur,ur,cr,cr,cr,ur,ur,ub,ur,ur,ur,ur,ur,ur,ur,ur,ug
cb,ur,ur,ur,ug,ur,ur,ur,ug,ug,ug,ug,ur,ub,ub,ub,ub,ub,ub,ub,ur,ux,ug
ub,ur,ug,ur,ug,cg,ug,ug,ug,ub,ur,ug,ug,ug,ux,ug,ug,ug,ug,cb,ux,ug,ug
ub,ur,ug,ur,ug,ur,ur,ur,ub,ub,ub,ub,ug,ub,ux,ug,ug,ug,ug,ur,ux,ug,ux
ub,ur,ug,ur,cg,ur,ur,ur,cr,ub,ub,ub,ub,ux,cg,ug,ug,ug,ug,ur,ux,ug,ux
ub,ur,ur,ur,ur,ur,cb,ur,ur,ub,ug,ug,ux,ux,ub,ux,ug,ug,ug,ug,ug,ug,ux
ub,ur,ux,ur,ub,ub,ub,ug,ub,ux,ug,ub,ux,ub,ub,ux,ug,ug,ug,ug,ux,ux,ux
ub,ur,ux,ur,ub,ub,ug,ug,ux,ux,ub,ub,ub,ub,ub,ub,ug,ug,ug,ug,ux,ux,ux
ub,ur,ux,ur,ub,ux,ub,ug,ug,ug,ub,ub,ub,ub,ub,ub,ug,ug,ug,cg,ux,ux,ux
ub,ur,ux,ur,ub,ux,ux,ux,ug,ug,ub,ub,ub,ub,ub,ub,ug,ug,ug,ur,ux,ux,ux
ub,ub,ub,ur,ub,ux,ux,ux,ug,ub,ub,ub,cb,ub,ub,ub,ur,ug,ug,ur,ux,ux,ux
ug,ur,ux,ur,ug,ug,ug,ug,ug,ub,ub,ub,cb,ub,ub,ub,ur,ug,ug,ur,ux,ux,cg
ug,ur,ux,cr,ux,ux,ux,ux,ux,ub,ub,ub,ub,ux,ug,ux,ux,ug,ug,ur,ug,ux,ux
ug,ur,ux,ux,ux,ux,ux,ux,ux,ub,ub,ux,ux,ux,ug,ux,ux,ur,ux,ur,ug,ux,ux
ug,ur,ug,ug,ug,ug,ug,ug,ug,ub,ub,ug,ug,ug,ug,ub,ub,ub,ub,ur,ug,ux,ux
ux,ur,ux,ux,ux,ux,ux,ux,ux,ux,ux,ux,ux,ux,ux,ux,ub,ub,ub,ur,ux,ux,ux
cg,cb,ux,ux,ux,ux,ux,ux,ux,ux,ux,ux,ux,ux,ux,ux,ub,ux,ux,ur,ux,ux,ux
ub,ub,ub,ub,ub,ub,ub,ub,ub,ub,ub,ub,ub,ub,ub,ub,ub,ux,ux,ur,ur,ur,ur
ub,ub,ux,ux,ux,ux,ux,ux,ux,ux,ux,ux,ux,ux,ux,ux,ux,ux,ux,ux,ux,ux,ur
ub,ub,ub,ub,ub,ub,ub,ub,ub,ub,ub,ub,ub,ub,ub,ub,ub,ur,ur,ur,ur,ur,ur
cr,ub,ux,ux,ux,ux,ux,ux,ux,ux,ux,ux,ub,ub,ub,ub,ub,ux,ur,ux,ux,cb,cr
cg,ub,ub,ub,ub,ub,ub,ub,ub,ub,ub,ub,ub,ur,ur,ur,ur,ur,ur,cg,cb,ux,cr