ur,ur,ur,ur,ur,ur,ux,ur,ur,ur,ur,ur,ur,ur,ur,ur,ur,ur,ur,ub,ub,cr,ub
ur,ur,ur,ur,ur,ur,ur,ur,ur,ur,ux,ur,ur,ur,ur,ur,ur,ur,ur,ub,ub,ur,cb
ur,ur,ur,ur,ur,ur,ur,ur,ur,ur,ur,ur,ur,ur,ur,ur,ur,ur,ur,ub,ub,ub,ub
ur,ur,ur,cg,ur,ur,ur,ur,ur,cr,ur,ur,ur,ur,ug,cr,ub,ub,ub,ub,ub,ub,ux
ur,ur,ur,ug,ug,ug,ug,ug,ug,ug,ur,ur,ur,ur,ug,ub,ub,ub,ur,ur,ub,ub,ub
ur,ur,ur,ur,ur,ur,ur,ur,ur,ur,ur,ur,ur,ur,ub,cb,ub,ub,ur,ur,cb,ub,ub
ur,ur,ur,ur,ur,ur,ur,ur,ur,ug,ug,ur,ug,ur,ub,ub,ur,ur,ur,ub,ub,ub,ub
ur,ur,ur,ur,ur,ur,ur,ur,ur,ug,ug,ur,ug,ub,ub,ub,ub,ux,ub,ub,ub,ub,ub
ur,ur,ur,ur,ur,ur,ur,ur,ug,ug,ug,ug,cg,ub,ug,ug,ub,ub,ub,ub,ux,ux,ux
ur,ur,ur,ur,ur,ur,ur,cr,ur,ur,ub,ub,ug,ux,ux,ux,ux,ux,ub,ux,ux,ux,ux
ur,ur,ur,ur,ur,cr,ug,ub,ur,ux,ub,ug,ug,ug,ug,ux,ux,ux,ub,ux,ux,ux,ux
ur,ur,ux,ug,ub,ug,ug,ur,ur,ux,ub,ub,ug,ux,ug,ug,ux,ux,ub,ub,ub,ux,ux
ur,ur,ur,ug,ub,ug,ub,ub,ub,ub,cb,ub,ub,ux,ug,ug,ux,ux,ux,ux,ub,ux,ux
ur,ur,ur,ug,ux,ug,ub,ub,ub,ub,ub,ub,ub,ug,ug,ug,ub,ub,ub,ub,ub,ux,ux
ub,ub,ub,ug,ux,ug,ug,ug,ug,ub,ub,ub,ug,ug,ug,ug,ub,ub,ub,ub,ub,ux,ux
ub,ub,ug,ug,ug,ug,ug,ug,ug,ub,ub,ug,ug,cb,ug,ub,ub,ur,ur,ur,ur,ur,ux
ub,ub,ug,ux,ug,ug,ug,ug,ub,ug,ub,ug,ug,ub,ub,ub,ub,ur,ur,ur,ur,ur,ux
ub,ub,ug,ub,ug,ug,cg,ug,ug,ug,ug,ug,ub,ub,ub,ub,ub,ur,ur,ur,ur,ur,ux
ub,ub,ug,ub,ux,ug,ug,ug,ug,ug,ux,ux,ub,ux,ub,ub,cr,ur,ur,ur,ur,ur,ux
ub,ub,ug,ub,ub,ug,ug,ux,ux,ux,ux,ub,ub,ux,ux,ur,ur,ur,ur,ur,ur,ur,ux
ub,ub,ug,ux,ux,ux,ur,ux,ux,ux,ux,ub,ub,ub,ux,ur,ur,ur,ur,ur,ur,ur,ur
ub,ub,ug,ug,ug,ug,ug,ug,cg,ux,ux,ux,ux,ub,ub,ur,ur,ur,ur,ur,ur,ur,ur
ub,ub,ux,ux,ux,ux,ur,ur,ur,ur,ur,ur,ur,ur,ub,ub,ur,ur,ur,ur,ur,cb,ur