ux,ux,ux,ux,ux,ux,ux,ur,ur,ur,ur,ur,ur,ur,ur,ur,ur,ur,ur,ur,ur,ur,ur
ux,ux,ux,ux,ux,ux,ux,ur,ur,ur,ux,ur,ur,ur,ur,ur,ur,ur,ur,ur,ur,ur,ur
ux,ur,ug,ug,ug,ur,ur,ur,ur,ur,ur,ur,ur,ur,ur,ur,ur,ur,ur,ur,cr,ur,ur
ux,ug,ug,ug,ug,ur,ur,ur,ux,ur,ur,ur,ur,ur,ur,ur,ur,ur,ur,ur,ur,ur,ur
ux,ug,ug,ug,ug,ug,ux,ux,ux,ur,ux,ur,ur,ur,ur,ur,ur,ur,ur,ur,ur,ur,ur
ux,ur,ux,cg,ug,ug,ux,ux,ur,ur,ur,ur,ur,ur,ur,ur,cb,ur,ur,ur,ur,ur,ur
ux,ur,ux,ur,ux,ur,ur,ur,ur,ur,ur,ur,ur,ur,ur,cr,ub,ub,ub,cr,ur,ub,ub
ux,ur,ur,ur,ur,ur,ur,ur,ur,ur,ur,cg,ug,ug,ub,cr,ur,ub,ub,ub,ub,ub,ub
cg,ur,ur,ur,ur,ur,ur,ur,ur,ur,ur,ur,ur,ug,ub,ur,cb,ux,ux,ux,ux,ux,ub
ur,ur,ur,ur,ur,ur,ur,ur,ur,ur,ur,ur,ur,ug,ub,ub,ub,ux,ux,ux,ux,ux,ub
ur,ur,ur,ur,ur,ur,ur,ur,ur,ur,ur,cb,ub,ug,ur,ur,ub,ux,ux,ux,ux,ux,ub
ug,ux,ur,ur,ur,ur,ur,ur,ur,ur,ub,ub,cb,ub,ub,ub,ux,ux,ux,ux,ux,ux,ub
ug,ug,ug,ur,ur,ur,ur,ux,ub,ub,cr,ur,ug,ug,ub,ub,ux,ux,ux,ux,ux,ux,ub
ux,ux,ug,cb,ug,ug,ux,ux,ub,ub,ub,ug,ub,ug,ub,ub,ug,ux,ux,ux,ux,ux,ub
cg,ux,ug,ub,ub,ug,ug,ug,ug,ug,ux,ug,ug,ug,ub,ug,ug,ug,ux,ux,ux,ux,cr
ux,ug,ug,ux,ub,ug,ub,ub,ug,ux,cg,ug,ug,ug,ub,ub,ub,ub,ub,ux,ux,ux,ur
ux,ug,ux,ux,ub,ub,ub,ux,ug,ux,ux,ux,ub,ub,ub,ub,ub,ub,ub,ux,ux,ux,ur
ux,ug,ux,ub,ub,ub,ub,ux,ug,ub,ux,ux,ub,ub,ug,ug,ug,ug,ux,ux,ux,ux,ur
ux,ug,ub,ub,ux,ub,ub,ux,ug,ur,ur,ur,ub,ub,ur,ur,ur,ur,ur,ur,ur,ur,ur
ux,ug,ub,ub,ub,ub,ub,ub,ug,ub,ub,ux,ux,ux,ur,ur,ur,ur,ur,ur,ur,ur,ur
ux,ur,ur,ub,ub,ur,ur,ub,ur,ur,ur,ub,ub,ub,ub,ub,ub,ub,ur,ur,ur,ur,ur
ux,ur,ur,ub,ub,ur,ur,ub,ub,ur,ur,ub,ub,ub,ub,ub,ub,ub,ub,cb,ur,ur,ur
ux,ux,ux,ux,ur,ur,ub,ub,ub,cg,ux,ux,ub,ub,ub,ub,ub,ub,ub,ux,ur,ur,ur