ub,ub,cb,ub,ur,ur,ur,ur,ur,ur,ur,ur,ur,ur,ur,ur,ux,ux,ur,cg,ur,ug,ug
ub,ub,ur,ur,ur,ur,ur,ur,ur,ur,ur,ur,ur,cr,ub,ux,ux,ur,ur,ur,ur,ug,ur
ub,ub,ub,ur,ur,ur,ur,ur,ur,ur,ur,ur,ur,ur,ub,ur,ur,ur,ug,ug,ug,ug,cb
ub,ub,ur,ux,ur,ur,ur,ur,cg,ug,cr,ur,ur,ur,ub,ub,ub,ur,ur,ur,ur,ub,ub
ub,ur,ur,ur,ur,ur,ur,ur,ur,cb,ur,cb,ub,ur,ub,ug,ug,cg,ub,ub,ub,ub,ub
ur,ur,ur,ur,ur,ur,ur,ur,ur,ub,ur,ub,ub,ur,ug,ug,ub,ub,ub,ug,ub,ub,ub
ur,ur,ur,ur,ur,cr,ur,ur,cr,ur,cr,ur,ub,ub,ug,ub,ub,ub,ug,ug,ub,ub,ug
ur,ur,ur,ur,ur,ur,ur,ur,ur,ur,ug,ub,ub,ub,ug,ug,ub,ug,ug,ug,ux,ux,ug
ur,ur,ur,ur,ur,ur,ur,ur,ub,ub,ug,ub,ub,ub,ub,ug,ug,ug,ug,ug,ux,ux,ug
ur,ur,ur,ur,ur,ub,ub,ub,ug,ub,ug,ub,ub,ub,ub,ub,ux,ux,ux,ux,ux,ux,ug
ur,ur,ur,ub,ur,cr,ub,ug,ug,ub,ug,ub,ux,ug,ug,ug,ux,ux,ux,ug,ug,ug,ug
ux,ux,ux,ux,ur,ux,ux,ug,ug,ub,ug,ug,ub,ub,ub,ug,ug,ug,ux,ug,ux,ux,ux
ux,ux,ug,ug,ur,ux,ux,ug,ug,ub,ub,ub,ub,cb,ub,ug,ug,ug,ug,ug,ub,ub,ub
ux,ug,ug,ug,ur,ux,ux,ug,ug,ub,ub,ub,ub,ub,ug,ug,ug,ug,ug,ug,ug,ug,cg
ux,ug,ux,ug,ur,ux,ux,ug,ux,ub,ux,ub,ub,ux,cg,ug,ug,ug,ub,ub,ub,ux,ux
ux,ug,ux,ug,ur,ux,ux,ug,ux,ub,ux,ux,ux,ug,ug,ug,ug,ug,ub,ub,ub,ub,ub
ux,ug,ux,ug,ur,ug,ug,ug,ux,ub,ug,ug,ug,ug,ug,ug,ug,ug,ub,ub,ub,ub,ub
cg,ug,ux,ug,ur,ux,ug,ug,ux,cg,ug,ug,ug,ug,ug,ub,ug,ug,ub,ub,ub,ub,ub
ux,ug,ur,ur,ur,ug,ug,ug,ug,ug,ur,ur,ug,ug,ug,ug,ug,ug,ug,ug,ur,ur,ur
ux,ug,ur,ug,ur,ub,ub,ub,ub,ug,ug,ug,ug,ub,ux,ub,ub,ub,ub,ug,ub,ub,ur
cr,ug,ur,ug,ur,ug,ug,ug,ug,ug,ur,ur,ur,cb,ub,ur,ur,ur,ur,ur,ur,ur,ur
cg,ug,ur,ug,ug,ug,ur,ur,ur,ub,ur,ub,ub,ub,ub,ug,ug,ug,ug,ur,ur,cb,cr
cr,ug,ug,ub,ub,ub,ub,ub,ub,cb,ub,ub,ug,ub,ub,ug,ur,ur,ur,ur,cb,ux,cr