ur,ur,ur,ur,ur,ur,ur,ux,ur,ur,ur,ub,ub,cb,ur,ur,ur,cb,ub,ub,ur,ub,ub
ur,ur,ur,ur,ur,ur,ur,ur,ur,cr,cr,cr,ur,ur,cr,ur,ur,ur,ub,ug,ug,ug,ug
ur,ur,ur,ur,ur,ur,ur,ur,ur,ur,ur,ur,cb,ub,ub,ub,ub,ub,ub,cg,ug,ug,cg
ur,ur,ur,ur,ux,ur,ur,ur,cr,ur,ur,ur,ur,ub,ur,ub,ub,ub,ub,ug,ux,ug,ug
ur,ur,ur,ur,ur,ur,ur,ug,ug,ur,ur,ur,cb,ub,ub,ub,ux,ux,ub,ug,ug,ub,ug
ux,ur,ur,ur,ur,cg,cb,ug,ur,ur,ug,ug,cg,ub,ub,ub,ux,ux,ub,ub,ug,ug,ug
ur,ur,ur,ur,ug,ug,ub,ug,ug,ur,ug,ur,ug,ub,ub,ug,ug,ug,ug,ux,ub,ug,ug
ur,ur,ur,ur,ur,ub,ub,ub,ub,ub,ug,ug,ug,ub,ux,ug,ug,ug,ug,ux,ub,ug,ug
ur,ur,ur,ur,ub,ub,ub,ux,ug,ux,ux,ub,ug,ug,ug,ug,ug,ug,ug,ux,ub,ug,ug
ur,ur,ur,ur,ub,ub,ub,ub,ub,ux,ux,ub,ug,ub,ug,ug,ug,ug,ug,ux,ub,ug,ug
ur,ub,cb,ug,ub,ub,ug,ub,ub,ub,ub,ub,ub,ub,ug,ug,ug,ug,ug,ux,ub,ug,ug
ur,ub,ub,ug,ub,ub,ux,ug,ub,ub,ug,ug,ub,ub,ub,ug,ug,ug,ug,ug,ug,ug,ug
ub,ub,ub,ub,ub,ub,ub,ub,ug,ub,ug,ub,ub,ub,ub,ux,ux,ux,ux,ug,ug,ug,cg
ub,ub,ub,ub,ub,ub,ub,ub,ub,ub,ub,ub,ub,cb,ub,ub,ux,ux,ux,ux,ug,ug,ug
ub,ub,ub,ub,ub,ug,ug,ug,ug,ub,ub,ub,ub,ub,ub,ub,ux,ux,ux,ux,ug,ug,ug
ub,ub,ub,ub,ub,ux,ux,ux,ub,ub,ub,ub,ux,ux,ub,ub,ub,ux,ux,ux,ug,ug,ub
ub,ug,ug,ug,ug,ug,ug,ug,ug,ub,ub,ub,ub,ux,ux,ux,ug,ug,ux,ux,ug,ug,ub
cg,ug,ux,ux,ub,ux,ux,ub,ug,ug,ug,ug,ug,ug,ug,ug,ug,ug,ug,ur,ur,ug,ur
ur,ur,ur,ur,ur,ur,ur,ur,ur,ur,ur,ur,ur,ur,ur,ur,ur,ur,ug,ug,ug,ug,ur
ur,ug,ux,ux,ux,ux,ux,ub,ub,ub,ub,ux,ux,ux,ux,ux,ux,ux,ur,ur,ur,ur,ur
ur,ur,ur,ur,ur,ur,ur,ur,ur,ur,ur,ur,ur,ur,ur,ur,ur,ur,ur,ur,ur,ur,ur
cr,ux,ux,ux,ux,ux,ux,ux,ux,ub,ur,ur,ux,ux,ux,ux,cr,ur,ur,ur,ur,cb,cr
cg,ux,ux,ux,ux,ux,ux,ux,ux,ux,ux,ur,ur,ur,ur,ur,ur,ur,ur,cg,cb,ux,cr