ux,ux,ur,ur,ur,ur,ur,ub,ub,cr,ub,ug,ug,ug,ux,ux,ux,cb,ur,ur,ur,ur,ur
ux,ur,cr,ur,ur,ur,ur,ub,ub,cb,ub,ug,ub,ug,ub,ub,ub,ub,ur,ur,ur,ub,ur
ur,ur,ur,ur,ur,ur,ur,ur,ur,ur,ub,ug,ub,cg,ug,ub,ub,ub,ux,ux,ur,cr,ur
ur,ur,ug,ur,ur,ug,ug,ug,cr,ug,ub,ug,ug,ug,ub,ub,ub,ub,ub,cb,ux,ur,ub
ur,ur,ur,ur,ug,ug,ug,ug,ug,ug,ug,ug,ug,ub,ub,ub,ub,ub,ub,ug,ux,ub,ub
ur,ur,ur,ur,ur,cg,ug,ug,ug,ug,ug,ug,ug,ux,ug,ug,ug,ub,ug,ug,ug,ub,cg
ur,ur,ur,ur,ur,ur,cr,ub,ub,ub,ub,cb,ux,ux,ug,ug,ug,ub,ug,ug,ug,ub,ug
ur,ur,ug,ug,ug,ux,ux,ux,ux,ub,ub,ub,ug,ug,ug,ub,ub,ub,ub,ub,ub,ub,ug
ur,ur,ug,ux,ux,ux,ug,ug,ux,ub,ux,ux,ub,cb,ub,ub,ub,ub,ug,ug,ug,ug,ug
ux,ux,ux,ux,ux,ux,ug,ug,ug,cg,ug,ub,ub,ub,ub,ub,ub,ub,ug,ug,ug,ub,ug
ub,ub,ub,ux,ux,ux,ug,ug,ug,ub,ub,ub,ub,ub,ub,ug,ub,ub,ub,ub,ub,ug,ug
cb,ub,ub,ux,ux,ux,ug,ug,ug,ug,ub,ub,ub,ub,ub,ub,ub,ub,ub,ub,cb,ub,ub
ub,ub,ux,ux,ux,ux,ug,ug,ub,ug,ub,ub,ub,ub,ug,ug,ub,ug,ug,ub,ug,ux,ub
ub,ux,ux,ux,ux,ux,ug,ug,ug,ug,ug,ub,ug,ub,ub,ug,ug,ug,ub,ub,ug,ub,ub
cg,ug,ug,ug,ug,ug,ug,ug,ug,ug,ug,ug,ug,ug,ug,ug,ug,ug,ug,ux,ug,ub,ub
ur,ur,ur,ur,ur,ur,ur,ur,ur,ur,ur,ur,ur,ur,ur,ur,ur,ur,ur,ur,ur,ur,ur
ur,ux,ux,ux,ux,ux,ux,ux,ub,ux,ug,ug,ug,ug,ux,ug,ug,ug,ux,ux,ug,ub,ur
ur,ux,ug,ug,ug,ux,ux,ux,ub,ub,ub,ux,ux,ug,ux,cr,ur,ur,ur,ur,ur,ur,ur
ur,ug,ug,ux,ug,ux,ux,ub,ug,ug,ug,ug,ug,ug,ux,ux,ux,ux,ug,ug,ug,ux,ur
ur,ug,ux,ux,ug,ug,ux,ug,ug,ux,ux,ux,ux,ux,ux,ux,ux,ux,ux,ux,ug,ux,ur
ur,ur,ur,ur,ur,ug,ug,ug,ug,ug,ug,ug,ug,ug,ug,ug,ug,ug,ug,ug,ug,ur,ur
cr,ux,ug,ug,ug,ug,ug,ux,ux,ux,ux,ux,ux,ux,ux,ux,ux,ux,ux,ux,ux,ux,cb
cg,ux,ug,ug,ux,ux,ux,ux,ux,cg,ux,ux,ux,ux,ux,ux,ux,ux,ux,ux,ux,ux,ux