cb,cb,cb,cr,ur,ur,ur,ur,ur,ur,ur,ur,ur,ur,ur,ux,ux,ux,ux,ux,ux,ux,cb
ub,cb,cb,ur,ur,ur,ur,ur,ur,ur,ur,ur,ur,ur,ur,ur,ur,ur,ur,ur,ur,ur,ur
ub,ur,ur,ur,ur,ur,ur,ur,ur,ur,ur,ur,ur,ur,ur,ur,ur,ur,ur,ur,ur,ur,ur
ub,ur,ur,ur,cr,cr,ur,ur,ur,ur,ur,ur,ur,ur,ur,ur,ur,ur,ur,ur,ur,ur,ux
ub,ur,ur,ur,ug,cg,ur,ur,ur,ur,ug,ur,ur,ur,ur,ur,ug,ug,ug,ur,ux,ux,ux
ur,ur,ur,ur,cr,ug,ug,cg,ur,ur,ur,ur,ur,ur,ub,ub,cg,ug,ug,ug,ug,ux,ux
ur,ur,ur,ur,ur,ur,ur,ur,ur,ur,ur,ur,ur,ur,ur,ux,ug,ug,ug,ub,ug,ux,ux
cb,ub,cr,ub,ub,ub,ub,ur,ug,cr,ur,ur,ur,ur,ur,ug,ug,ug,ug,ug,ug,ur,ur
ur,cb,ur,ux,ub,ub,ug,ux,ug,ur,ur,ur,ur,ur,ur,ug,ug,ug,ur,ur,ur,ur,ur
ur,ub,ub,ux,ug,ug,ug,ug,ug,ux,ur,ur,ur,ur,ur,ug,ug,ug,ug,ub,ub,ux,ur
ug,ug,ux,ux,ug,ug,ug,ug,ug,ur,ur,ur,ur,ur,ur,ug,ug,ug,ug,ub,ub,ub,ur
ux,ux,ux,ug,ug,ug,ux,ub,ug,ug,cg,ur,ug,ug,ug,ug,ug,ug,ug,ux,ux,ux,ur
cb,ux,ux,ug,ug,ug,ub,ub,ug,ug,ug,ur,ug,ug,ux,ug,ug,ug,ug,ux,ux,ux,ur
ux,ux,ug,ug,ug,ug,ug,ug,cg,ug,ub,ug,ug,ug,ug,ug,ur,ux,ug,ux,ux,ux,ur
ux,ux,ug,ug,ug,ug,ug,ug,cb,ug,ub,ug,ug,ug,ug,ug,ur,ug,ug,ug,ux,ux,ur
ux,ug,ug,ug,ug,ug,ug,ub,ub,ug,ub,ux,cg,ug,ug,ug,ur,ur,ur,ur,ur,ur,ur
ug,ug,ug,ug,ug,ug,ug,ub,ub,ux,ug,ug,ug,ug,ux,ux,ur,cr,ug,ug,ux,ux,cb
ug,ug,ug,ug,ug,ug,ug,ug,ug,ug,ug,ux,ug,ug,ug,ux,ur,ug,cb,ub,ub,ub,ub
ug,ug,ug,ug,ub,ug,ug,ug,ux,ug,ug,ug,ug,ub,ub,ub,ub,ub,ub,ub,ub,ub,ub
ug,ug,ug,ug,ug,ug,ug,ug,ug,ug,ug,ug,ub,ub,ug,ug,ur,ub,ur,ur,ur,ur,ux
cr,ur,ug,ug,ug,ug,ug,ug,ug,ug,ub,ub,ub,ub,ub,ub,ur,ub,ur,ur,ur,ur,cr
cg,ur,ur,ur,ur,ug,ug,ug,ug,ug,ub,ub,ub,ub,ur,ur,ur,ur,ur,cb,cb,ur,cr
cr,cg,cg,cb,ux,ub,ug,ug,ug,ug,ux,ub,ub,ux,ux,cg,ur,ur,ur,cg,cg,ur,cr