ur,ur,ur,ur,cr,ub,cb,ur,ur,ur,ur,ur,ur,ur,ur,ur,ur,ur,ur,ur,ur,ur,ur
ur,ur,ur,ur,ur,ur,ur,ur,ur,ur,ur,ur,ur,ur,ur,ur,ur,ur,ur,ur,ux,ux,ur
ur,ur,ur,ur,ur,ur,ur,ur,ur,ur,ur,ur,cr,ur,ur,ur,ur,ux,ur,ur,ux,ux,ur
ur,ur,ur,ur,ur,ur,ur,ur,ur,ur,cr,ur,ur,ur,ur,ur,ur,ux,ur,ur,ux,ux,ur
cb,ur,ur,ur,ur,ur,ur,ur,ur,ur,ub,ur,ur,ur,ur,ur,ur,ur,ur,ur,ux,ux,ur
ur,ur,ur,ur,ur,ur,ur,ur,ur,ur,cb,ur,ur,ur,ur,cg,ur,ur,ur,ur,ux,ux,ur
ur,ur,ur,ur,ur,ur,ur,ur,ur,ur,ur,ur,ur,ur,ur,ug,ur,ur,ur,ur,ur,ur,ur
ur,ur,ur,ur,ur,ur,ux,ur,ur,cr,ub,ug,ur,ur,ur,ug,ug,ug,ur,ur,ur,ur,ur
cg,ur,ur,ur,ur,ub,ux,ux,ub,ub,ug,ug,ub,ug,ug,ug,ug,ug,ur,ur,ur,ur,ur
ur,ur,ug,ug,ug,cb,ub,ub,ub,ug,ug,ug,ub,ug,ug,ug,ug,ur,ur,ur,ur,ur,ur
ur,cr,ug,ub,ug,ub,ux,ub,ub,ub,ub,ug,ub,ug,ug,ug,ug,ub,ub,ub,ub,ub,ub
ub,ux,ug,ub,ug,ub,ux,ub,ub,ub,ub,ug,ub,ug,ug,ug,ug,ux,ux,ux,ux,ub,ub
ub,ux,ug,ub,ug,ug,ux,ux,ux,ub,ub,cb,ub,ub,ub,ug,ug,ux,ux,ux,ux,ub,ub
ub,ub,ug,ub,ub,ug,ux,ux,ux,ux,ub,ug,ug,ug,cg,ub,ub,ux,ux,ux,ux,ub,ub
cg,ub,ug,ub,ub,ug,ux,ux,ux,ux,ux,ub,ub,ub,ub,ug,ux,ux,ux,ux,ux,ub,ub
ub,ub,ug,ub,ub,ug,ux,ux,ux,ux,ux,ub,ux,ub,ug,ug,ux,ux,ux,ux,ux,ub,ub
ub,ux,ug,ub,ub,ug,ux,ux,ux,ux,ux,ub,ux,ub,ub,ux,ux,ux,ux,ux,ux,ub,ub
ub,ug,ug,ux,ub,ug,ux,ux,ux,ux,ux,ub,ux,ux,ux,ux,ux,ux,ux,ux,ux,ub,ub
ub,ug,ux,ux,ub,ug,ux,ux,ux,ux,ux,ub,ux,ux,ux,ux,ux,ux,ux,ux,ux,ub,ub
ub,ug,ux,ug,ug,ug,ug,ug,ug,ug,ug,ug,ug,ug,ug,ug,ug,ug,ug,ug,ug,ub,ub
ub,ug,ub,ug,ux,ug,ug,ug,ug,ub,ub,ub,ub,ub,ub,ub,ub,cr,ur,cb,ub,ub,ub
ug,ug,ub,ug,ug,ug,ug,ug,ug,ub,ub,ub,ub,ub,ub,ub,ub,ub,ub,ub,ub,ub,cb
ug,ug,ug,ug,ug,ug,ug,ug,cg,cg,ub,ub,ur,ux,ux,ux,ux,ux,ux,ux,ux,ux,ux