ur,cb,cb,cr,cr,ur,ur,ur,ur,ur,ur,ur,ur,ur,ur,ur,ur,ur,ur,ur,ur,ur,cb
ur,cb,cb,ux,ug,ug,ug,ur,ur,ur,ur,ur,ur,ur,ur,ur,ur,ur,ur,ur,ur,ur,ur
ur,ux,ux,cg,ug,ux,ur,ur,ur,ur,ur,ur,ur,ur,ur,ur,ur,ur,ur,ur,ur,ur,ur
ur,ur,ur,ux,ux,ux,ur,ur,ur,ur,ur,ur,ug,ur,ur,ur,ur,ur,ur,ur,ur,ur,ur
ur,ur,ur,ur,ur,ug,ug,ug,ug,ub,cr,ur,cg,cr,ur,cb,ub,ub,ur,ur,ur,ur,ur
ux,ux,ux,ux,ux,ug,ug,ug,ux,ug,ur,ur,ur,ur,ub,ub,ub,cr,ur,ur,ur,ur,ur
ux,ux,ux,ux,ux,ug,ug,ug,ug,ug,ur,ur,ur,ur,ur,ug,ug,ux,ug,ur,ur,ur,ur
cb,ux,ux,ur,ur,ug,ug,ur,ug,ug,ur,ur,ur,ur,ur,ur,ug,ur,ug,ur,ur,ur,ur
ux,ux,ux,ur,ur,ug,ug,ur,ug,ur,ur,ur,ur,ur,ur,ur,ug,ur,ug,ur,ur,ur,ur
ux,ux,ux,ur,ur,ur,ug,cg,ug,ur,cr,ur,ur,ur,ug,ub,ug,ug,cg,ur,ur,ug,ug
ur,ur,ur,ur,ur,ur,ug,ug,ug,ub,ub,ug,ug,cg,ug,ug,ub,ub,ub,ub,ub,ub,cb
ur,ur,ur,ur,ur,ub,ub,ub,ub,ub,ub,ug,ub,ub,ug,ug,ux,ux,ux,ux,ux,ug,ug
cb,ux,ux,ux,ux,ub,ug,ug,ub,ub,ug,cb,ub,ub,ug,ug,ux,ux,ux,ux,ux,ug,ug
ub,ub,ub,ub,ub,ub,ug,ug,ub,ub,ug,ug,ug,ug,ug,ug,ux,ux,ux,ux,ux,ug,ug
ub,ub,ub,ug,ug,cg,ug,ug,ub,ub,ug,ug,ug,ug,ub,ug,ub,ub,ub,ub,ub,ub,ux
ub,ug,ug,ug,ug,ug,ub,ub,ub,ub,ub,ub,ub,ug,ug,ug,ub,ub,ub,ub,ux,ub,ux
ug,ug,ug,ug,ug,ug,ug,ug,ug,ug,ug,ux,ux,ux,ux,ux,ux,ux,ux,ub,ux,ub,cb
ug,ug,ug,ug,ug,ug,ug,ug,ub,ug,ug,ux,ux,ux,ux,ux,ux,ux,ux,ub,ux,ub,ur
ug,ug,ug,ug,ub,ub,ux,ug,ux,ug,ux,ux,ux,ux,ux,ux,ux,ux,ux,ub,ux,ub,ur
ug,ug,ug,ug,ug,ub,ub,ub,ub,ur,ur,ur,ur,ur,ur,ur,ur,ur,ur,ur,ur,ur,ux
cr,ux,ug,cr,ur,ur,ur,ur,ur,ur,ub,ub,ub,ur,ur,ur,ur,ur,ur,ur,ur,ur,cr
cg,ux,ug,ug,ug,ub,ub,ux,ub,ub,ub,ux,cb,ux,ux,ux,ux,ux,ux,cb,cb,ur,cr
cr,cg,cg,cb,ug,ub,ub,ux,ub,ub,ux,ux,ux,ux,ux,cg,ux,ux,ux,cg,cg,ur,cr