ur,ur,ur,ur,ur,ur,ur,ur,ur,ur,ur,ur,ur,ur,ur,ub,ub,ur,ur,ur,ur,ur,ur
ur,ur,ub,cr,ub,ur,ur,ur,ur,ur,ur,ur,ur,ur,ur,ur,cb,cr,ur,ur,ur,ur,ur
ur,ur,cb,ur,ub,ur,ux,ux,ux,ur,ur,ur,ur,ur,ur,ur,ur,ur,ub,ux,ux,ur,ur
ur,ur,ur,ur,ur,ur,ur,ur,ur,ur,ur,ur,ur,ur,ur,ur,ur,ur,ug,ux,ux,ur,ur
ur,ur,ur,ur,ur,ux,ur,ur,ur,ur,ur,ur,ur,ur,ur,ux,ux,ux,ug,ux,ux,ur,ur
ur,ur,ur,ur,ur,ur,ur,ur,ur,ur,ur,ub,ug,ux,ux,ux,ux,ux,ug,ux,ux,ur,ur
ur,ur,ur,ur,ur,ur,ur,ur,ur,ur,ur,ub,ug,ux,ux,ux,ux,ux,ug,ux,ux,ur,ur
ur,ur,ur,ur,ur,ur,ur,ur,ur,ur,cr,ub,ug,ub,ux,ux,ux,ux,ug,ux,ux,ur,ur
ur,ur,ur,ur,ur,ur,ur,ur,ur,cg,ug,ub,ug,ub,ub,ux,ux,ux,ug,ux,ux,ur,ur
ur,ur,ur,ur,ur,ur,ur,ur,ur,ub,ug,ub,ug,ub,ub,ub,ux,ux,ug,ux,ux,ur,ur
cg,ur,cr,ur,ur,ur,ur,ur,ur,cr,ug,ub,ub,ub,ub,ub,ux,ux,ug,ux,ux,cr,ur
ur,ur,ug,ur,ur,ur,ur,ug,ug,ub,ub,ub,ub,ub,ux,ux,ux,ux,ug,ux,ur,ur,ur
ur,ur,ug,ur,ur,ur,ur,ub,ub,ug,ug,ub,cb,ub,ux,ux,ux,ux,ug,ux,ur,ux,ux
ur,ur,ug,ur,ur,ur,ur,ur,ug,ux,ux,ux,ub,ux,ux,ux,ux,ux,ug,ux,ur,ux,ux
ur,ur,cg,ur,ug,ur,ur,ur,ug,ug,ug,ug,ub,cb,ux,ux,ux,ux,ug,ux,ur,ux,ur
ux,ur,ux,ux,ur,ux,ux,ux,ur,ux,ux,ux,ux,ux,ux,ux,ux,ux,ug,ux,ur,ux,ur
ux,ur,ux,ux,ur,ux,ux,ux,ur,ux,ux,ux,ux,ux,ux,ux,ux,ux,ux,ux,ur,ux,ur
cb,ur,ub,ub,ub,ub,ub,ub,ub,ub,ub,ub,ub,ub,ub,ub,ub,ub,ub,ub,ub,ub,ub
ub,ur,ub,ur,ub,ub,ub,ub,ub,ub,ub,ub,ub,ub,ub,ub,ub,ub,ub,ux,ur,ur,ub
ub,ux,ub,ux,ux,ux,ux,ux,ur,ux,ux,ux,ux,ux,ux,ux,ux,ux,ub,ub,ur,ur,ub
ub,ux,ub,ux,ux,ux,ux,ux,ur,ux,ux,ux,ux,ux,ux,ux,ux,ux,ux,ub,ub,ub,ub
ub,ub,ub,ur,ur,ur,ur,ur,ur,ur,ur,ur,ur,ur,ur,ur,ur,ur,ur,ur,ur,ur,ur
ub,ub,ux,ux,ux,ux,ux,cg,ur,ur,ur,ur,ur,ur,ur,ur,ur,ur,ur,ur,ur,cb,ur