ur,ur,ur,ur,ur,ur,ur,ur,ur,ur,ur,ur,ur,ur,ur,ur,ux,ur,ur,ur,ur,ub,ub
ur,ur,ur,ur,ur,ur,ur,ur,ur,ur,ur,ur,ur,ur,ur,ur,cr,ur,ur,ur,ub,ub,ub
ur,ur,ur,ur,cg,ur,ur,ur,ur,ur,ur,ur,ur,ur,cr,ur,ub,ub,ub,ub,ub,ub,ub
ux,ug,ug,ug,ug,ur,ur,ur,ur,ur,ur,ur,ur,ur,ur,ur,ux,ub,ub,ub,ub,ub,ub
ux,ug,ug,ug,ug,ug,ur,ur,ur,ur,ur,ur,ur,ur,ur,ur,ur,ub,ub,cb,ub,ub,ub
ux,ur,ur,ur,ur,ug,ur,ur,ur,ur,ur,ur,ur,ur,ur,cb,ub,ub,ub,ub,ub,ub,ub
ux,ur,ur,ur,ur,ur,ur,ur,ur,ur,ur,ur,ur,ur,ur,ur,cr,ub,ub,ub,ub,ub,ub
ux,ur,ur,ur,ur,ur,ur,ur,ur,ur,ur,ur,cr,ur,ur,ur,ub,ub,ub,ub,ub,ub,ub
cg,ur,ur,ur,ur,ur,ur,cg,ur,ur,cg,ug,ug,ur,ub,ur,ux,ux,ux,ux,ux,ux,ub
ur,ur,ur,ur,ur,ur,ur,ug,ur,ur,ur,ur,ub,ub,ub,ub,ux,ux,ux,ux,ux,ux,ub
ur,ur,ur,ur,ur,ur,cr,ug,ur,ur,ur,ur,ub,ur,cb,ub,ub,ux,ux,ux,ux,ux,ub
ug,ux,ur,ur,ur,ur,ur,ur,ur,ur,ug,ub,ub,ub,ub,ub,ub,ux,ux,ux,ux,ux,ub
ug,ug,ug,ur,ur,ur,ur,ur,ux,ux,ub,ub,ub,ub,ub,ub,ux,ux,ux,ux,ux,ux,ub
ub,ub,ug,ub,ug,ug,ur,ur,ux,ug,ub,ub,ub,ug,ub,ub,ub,ub,ub,ux,ux,ux,ub
cg,ub,ug,ub,ug,ug,ug,ug,ug,ug,ug,ub,ub,ug,ub,ux,ug,ug,ux,ux,ux,ux,ub
ux,ug,ug,ub,ug,ug,ub,ub,ug,ux,ux,ux,ub,ug,ub,ub,ub,ub,ub,ux,ux,ux,ub
ub,ug,ux,ub,ux,ub,ub,ux,ug,ux,ux,ux,ub,ub,ub,ub,ub,ub,ub,ux,ux,ux,ub
ub,ug,ur,ur,ur,ub,ub,ur,ug,ub,ub,ub,ub,ub,ug,ug,ug,ug,ur,ur,ur,ur,ub
ur,ug,ux,ub,ux,ub,ub,ux,ug,ur,ur,ur,ub,cb,ur,ur,ur,ur,ur,ur,ur,ur,ub
ur,ug,ug,ug,ug,ug,ug,ug,ug,ub,ub,ux,ub,ux,ur,ur,ur,ur,ur,ur,ur,ur,ub
ur,ux,ub,ub,cr,ur,ur,ur,ur,ur,ur,ur,ur,ur,ur,ur,ur,ur,ur,ur,ur,ur,ub
ur,ub,ub,ux,ux,ux,ub,ub,ub,ux,ux,ux,ux,ux,ur,ur,ur,ur,ur,ur,ur,ur,ub
ur,ur,ur,ur,ur,ur,ub,ub,cb,cg,ux,ux,ux,ux,ux,ux,ux,ux,ux,ux,ux,ux,cb