ur,ur,ur,ur,ur,ur,ur,ub,ub,ur,cb,ub,ub,ub,cr,ur,ur,cb,ur,ur,ur,ur,ur
ur,ur,ur,ur,ur,ur,ur,ub,cb,ur,ux,ur,ur,ur,ur,ur,ur,ur,ur,ur,ur,ur,ur
ur,ur,ur,ur,ur,ur,ur,cr,ur,ug,ug,ug,ug,cg,ur,ur,ur,ur,ur,ur,ur,ur,ur
ur,ur,ur,cr,ur,ur,ug,ug,ug,ug,ug,ug,ug,ug,ur,ug,ug,ug,ub,ug,ub,ub,cr
ur,ur,ur,ug,ug,ug,ug,ug,ur,ur,ur,ur,ur,ug,ur,cg,ub,ug,ub,ug,ur,ub,ug
ub,ub,ub,ug,ug,ug,ug,ux,ug,ug,ug,ur,ur,ur,ub,ub,ub,ug,ug,ug,ub,ub,ug
ug,ux,ux,ug,ug,ug,ug,ux,ug,ux,cr,ur,cb,ub,ub,ug,ub,ub,ub,ub,ub,ub,ug
ug,ug,ug,ug,ux,ux,ux,ux,ug,ux,ub,ub,ub,ub,ur,ug,ug,ub,ug,ur,ub,ug,ug
ur,ur,ur,ur,ur,cg,ug,ug,ug,ug,ug,ug,ug,ub,ub,ub,ub,ub,ug,ur,ub,ug,ub
ur,ux,ux,ux,ux,ux,ux,ub,ub,ux,ub,ub,ub,ub,ub,ub,ub,ub,ug,ug,ug,ug,ur
ur,ux,ux,ug,ug,ug,ug,ug,ub,cb,ub,ub,ub,ub,ub,ub,cb,ub,ux,ux,ub,ub,ur
ur,ur,ur,ur,ur,ur,ur,ub,ub,ur,ur,ur,ur,ur,ur,ur,cr,ux,ux,ux,ux,ux,ur
cg,ux,ux,ux,ug,ug,ug,ub,ub,ub,ub,ub,ux,ug,ug,ug,ug,ug,ux,ux,ux,ux,ur
ux,ux,ux,ux,ux,ug,ug,ux,ux,ux,ux,ux,cg,ug,ug,ug,ug,ug,ux,ux,ux,ux,ur
ux,ux,ux,ug,ug,ug,ux,ux,ux,ux,ux,ux,ug,ug,ug,ug,ug,ug,ux,ux,ux,ux,ur
ux,ux,ux,ug,ux,ux,ux,ux,ux,ux,ux,ux,ug,ug,ug,ug,ug,ug,ux,ux,ux,ux,ur
ux,ux,ux,ug,ux,ux,ux,ux,ux,ux,ux,ux,ux,ug,ug,ug,ug,ug,ux,ux,ux,ux,ur
cg,ux,ux,ug,ux,ux,ux,ux,ux,ux,ux,ux,ux,ug,ug,ux,ux,ux,ux,ux,ux,ux,ur
ux,ux,ux,ug,ux,ux,ux,ux,ux,ux,ux,ux,ux,ux,ug,ux,ux,ux,ux,ux,ux,ux,ur
ux,ux,ux,ug,ux,ux,ux,ux,ux,ux,ux,ux,ux,ux,ug,ux,ux,ux,ux,ux,ux,ux,ur
ux,ur,ur,ug,ug,ug,ug,ug,ug,ug,ug,ug,ug,ug,ug,ux,ux,ux,ux,ux,ur,ur,ur
cr,ur,ur,ur,ur,ur,ur,ur,ur,ur,ur,ur,ur,ur,ur,ur,ur,ur,ur,ur,ur,cb,cr
cg,ur,ur,ur,ur,ux,ux,ux,ux,ux,ux,ux,ux,cb,ux,ux,ux,ux,ux,cg,cb,ux,cr