ur,cr,ub,ub,cb,ur,ur,ur,ur,ur,ur,ur,ur,ur,ur,ur,ur,ur,ur,ur,ur,ur,ur
ur,ur,ur,ur,ur,ur,ur,ur,ur,ur,ur,ur,ur,ur,ur,ur,ur,ur,ur,ur,ur,ur,ur
ur,ub,ub,ur,cr,ub,ur,ux,ur,ur,ur,ur,ur,ur,ur,ur,ur,ur,ur,ur,ur,ur,ur
ub,ub,ub,ur,ur,cb,ur,ur,ur,ur,ur,ur,ur,ur,ur,ur,ur,ur,ur,ur,ur,ur,ur
ub,ur,ur,ug,ug,ur,ur,ur,ux,ur,ur,ur,ur,ur,ur,ur,ur,ux,ux,ub,cr,ur,ur
cb,ur,cr,ub,ur,ur,ur,ur,ur,ur,ur,ur,ur,ur,ug,ug,ub,ux,ux,ub,ug,ur,ub
ur,ub,ug,ug,cr,ur,ur,ur,ur,ur,ur,ur,ub,ug,ug,ug,ug,ur,ur,ug,ug,ux,ub
ur,ub,ug,ug,ub,ux,ug,ug,ub,cb,ub,ug,ug,ug,ug,ug,ub,ub,ug,ug,ux,ux,ub
cg,ub,ug,ug,ub,ux,ug,ug,ug,ug,ub,ub,ug,ug,ug,ub,ub,ub,ug,ug,ur,ur,ub
ub,ub,ug,ug,ug,ub,ug,ug,ug,ug,ub,ub,ub,ug,ug,ub,ug,ub,ug,ug,ur,ur,ub
ub,ub,ug,ub,ug,ub,ug,ug,ug,ub,ub,ub,ub,ug,ub,ub,cb,ub,ur,ur,ur,ur,ub
ux,ub,ug,ub,ug,ub,ug,ug,ug,ub,ub,ub,ub,cg,ub,ur,ur,ur,ur,ur,ur,ur,cb
ux,ub,ug,ub,ug,ux,ug,ug,ug,ub,ub,ux,ub,ur,ub,ub,ur,ur,ur,ug,ug,ux,ux
ux,ub,ug,ug,ug,ux,ug,ug,ug,ub,ub,ux,ub,ub,ux,ub,ux,ug,ug,ug,ux,ux,ux
cg,ux,ug,ug,ug,ux,ug,ug,ug,ub,ub,ux,ug,ub,ub,ub,ub,ux,ux,ug,ux,ux,ux
ug,ug,ug,ug,ug,ug,ug,ug,cg,ur,ur,ur,ur,ur,ur,ur,ur,ur,ur,ur,ur,ur,cr
ug,ux,cg,ug,ug,ux,ug,ug,ug,ux,ux,ux,ux,ux,ux,ux,ux,ux,ux,ux,ux,ux,ux
ug,ux,ux,ug,ug,ux,ug,ug,ug,ux,ux,ux,ux,ux,ux,ux,ux,ux,ux,ux,ux,ux,ux
ug,ux,ux,ug,ug,ux,ux,ux,ug,ux,ux,ux,ux,ux,ux,ux,ux,ux,ux,ux,ux,ux,ux
ug,ux,ux,ug,ug,ux,ux,ux,ug,ux,ux,ux,ux,ux,ux,ux,ux,ux,ux,ux,ux,ux,ux
ug,ux,ux,ux,ux,ux,ux,ux,ug,ux,ux,ux,ux,ux,ux,ux,ux,ux,ux,ux,ux,ux,ux
ug,ux,ux,ux,ux,ux,ux,ux,ug,ux,ux,ux,ux,ux,ux,ux,ux,ux,ux,ux,ux,ux,cb
ug,ug,ug,ug,ug,ug,ug,ug,ug,cg,ux,ux,ux,ux,ux,ux,ux,ux,ux,ux,ux,ux,ux