ub,ur,cb,ur,ur,ur,ur,ur,ur,ur,ur,ur,ur,ur,ur,ux,cr,ur,ux,cg,ur,ur,ux
ub,ur,ur,ur,ur,ur,ur,ur,ur,ur,ur,ur,ur,ux,ur,ur,ur,ur,ur,ur,ur,ur,ur
cr,ub,ub,cr,ur,ur,ur,ur,ur,ur,ur,ur,ur,ur,ur,ur,ur,ur,ux,ur,ur,ur,ur
ur,ur,ur,ur,ur,ur,ur,ur,ur,ub,ub,ub,ub,ub,ub,ub,ub,cb,ur,ur,ur,ur,ur
ur,ur,ur,ur,ur,ur,ur,ur,ur,ur,ur,cg,ug,ur,ug,ur,ur,ur,ug,ug,cg,ur,ur
ur,ur,ur,ur,ur,ur,ur,ug,ug,ug,ug,ug,ug,ug,ug,ug,ug,ug,ug,ur,ur,ur,ur
ur,ur,ur,ug,ur,ur,ur,ur,ur,ug,ug,ug,ur,ug,ur,ur,ur,ur,ur,ug,cr,ur,ur
ux,ur,ur,cr,ug,ug,ug,ug,ug,ug,ug,ug,ub,ug,ug,ub,ub,ug,ub,ug,ub,ug,ub
ux,ur,ur,ur,ur,ur,ur,ur,ur,ur,ur,ur,ur,ur,ug,ug,ug,ug,ub,ug,ug,ug,ux
ux,ux,ux,ur,cr,ug,ur,ug,ug,ur,ug,ur,ug,ub,ug,ug,ug,ug,ug,ug,ug,ux,ux
ux,ux,ux,ur,ug,ux,ux,ux,ux,ur,ur,ur,ug,ug,ug,ug,ug,ug,ug,ug,ug,ux,ux
ux,ux,ux,ur,ug,ux,ux,ux,ux,ub,ux,ug,ub,cb,ug,ug,ug,ux,ug,ug,ug,ux,ux
cg,ux,ux,ur,ug,ug,ux,ux,ux,ub,ub,ub,ub,ug,ug,ug,ug,ux,ug,ug,ux,ux,ux
ux,ux,ux,ur,ux,ug,ux,ux,ub,ub,ub,ug,ub,ug,ug,ug,ug,ux,ug,ug,ux,ux,ux
ux,ux,ux,ur,ux,ug,ux,ux,ub,ub,ub,ub,ug,ug,ub,ug,ug,ub,ub,ux,ux,ux,ux
ux,ux,ux,ur,ux,ug,ug,ug,ug,ug,ub,ub,ub,ug,ug,ug,ug,ug,ug,ug,ug,ug,ux
ux,ux,ux,ur,ux,ux,ux,ux,ux,ux,ug,ug,ub,ug,ub,ub,ub,ub,ub,ub,ux,ug,ux
cg,ub,cb,ur,ug,ux,ub,ub,ug,ug,ug,ug,cb,ug,ub,ub,ug,ug,ux,ub,ug,ug,ux
ub,ub,ub,ub,ug,ub,ub,ub,ug,ug,ug,ux,cg,ug,ub,ub,ux,ug,ug,ug,ug,ux,ux
ub,ub,ub,ub,ug,ub,cb,ub,ub,ub,ux,ux,ub,ug,ux,ug,ug,ug,ux,ub,ux,ux,ux
cr,ux,ux,ub,ug,ux,ub,ub,ub,ux,ug,ug,ub,ug,ux,ug,ux,ux,ux,ub,ux,ux,ux
cg,cb,ur,ub,ug,ug,ub,ug,ug,ug,ug,ug,ub,cg,ub,ug,ub,ux,ux,ub,ux,cb,cr
cr,ux,ur,ub,ub,ub,ub,ub,ub,ub,ub,ub,ub,ub,ub,ub,ub,ub,ub,ub,cb,ux,cr