ub,cb,cb,cr,ur,ur,ur,ur,cr,ur,ur,ur,ur,ur,ur,ur,ur,ur,ur,cg,ux,ur,cg
ub,ur,ur,ur,ub,ub,ub,ur,ur,ur,ug,ug,cr,ur,ur,ur,ur,ur,ur,ur,ur,ur,ug
ub,ub,ub,ub,ub,ub,ur,ur,ur,ur,ug,ur,ur,ur,ur,ur,ur,ug,ug,ur,ur,ux,ug
ur,ur,ur,ur,ur,ur,ur,ur,ur,ur,ug,ur,ug,ur,ur,ur,ug,ur,ug,ur,ur,ur,ug
ur,ur,ur,ur,ur,ur,ux,ur,ur,cr,cg,ub,ug,ug,ug,ug,ug,ug,ug,ur,ur,ub,ug
ur,ur,ur,ur,ur,ur,ur,ur,ub,cb,ub,ub,ux,ug,ur,ur,ur,ur,ur,ur,ur,ub,ug
ur,ur,ur,ur,ur,ur,ub,ub,cg,ub,ub,ug,ug,ug,ug,ug,ug,ur,ub,ub,ux,ub,ug
ur,ur,ur,ur,ur,ur,ug,ux,ug,ub,ub,ug,ub,ub,ub,ux,ux,ur,ug,ub,ux,ub,ug
ur,ur,ur,ur,ur,cr,ug,ug,ug,ug,ug,ug,ug,ub,ub,ub,ub,ur,ug,ub,ux,ub,ug
ux,ux,ux,ug,ug,ur,ur,ux,ub,ub,ub,ub,ub,ub,ub,ug,ug,ur,ug,ug,ug,ug,ug
ux,ux,ux,ug,ug,ug,ub,ub,ub,ub,ub,ub,ub,ub,ub,ux,ux,ur,ug,ug,ug,ug,cb
ug,ug,ug,ug,ug,ug,ub,cg,ug,ug,ug,cb,ug,ug,ub,ub,ub,ur,ug,ug,ug,ub,ux
ub,ug,ug,ug,ug,ug,ub,ub,cb,ux,ug,ug,ug,ub,ub,ug,ub,ur,ug,ug,ug,ub,ux
ub,ub,ug,ug,ug,ug,ub,ux,ux,ug,ug,ug,ug,ux,ux,ux,ub,ur,ug,ug,ug,ub,ux
ux,ub,ub,ub,ub,ub,ub,ux,ub,ug,ug,ug,ug,ux,ux,ux,ux,ur,ub,ug,ug,ub,ux
cg,ub,ub,ug,ug,ub,ux,ub,ub,ug,ub,ug,ug,ux,ub,ux,ux,ur,ub,ub,ug,ub,ux
ux,ub,ub,ux,ug,ug,ug,ug,ux,ug,ug,ux,ux,cb,ub,ub,ub,ur,ub,ux,ug,ub,ux
ux,ub,ub,ug,ug,ux,ux,ug,ug,ug,ug,ux,ub,ub,ux,ux,ux,ur,ux,ux,ug,ub,ub
ux,ub,ub,ug,ug,ux,ux,ug,ug,ux,ug,ux,ub,ux,ux,ux,ux,ur,ux,ux,ug,ub,ub
ux,ub,cg,ug,ug,ux,ux,ug,ug,ux,ug,ux,ux,ux,ux,ux,ux,ur,ux,ux,ug,ub,ub
cr,ub,ug,ug,ug,ux,ux,ug,ug,ub,ug,ug,ug,ug,ug,ug,ug,ur,ug,ur,ur,ub,ub
cg,ub,ug,ug,ug,ux,ug,ug,ub,ub,ur,ur,ur,ur,ur,ur,ur,ur,ur,ur,ux,cb,cr
cr,ux,ux,ux,ug,ug,ug,ux,ub,ux,ux,ux,ux,ux,ux,ux,ux,ux,ur,cr,cb,ux,cr