ur,ur,ur,ur,ur,ur,ur,ur,ur,ur,ur,ur,ux,ux,ux,ux,ur,ur,ur,ur,ur,ur,ur
ur,ur,ur,ur,ur,ur,ur,ur,ur,ur,ur,ur,ur,ur,ur,ur,ur,ur,ur,ur,ur,ur,ur
ur,ub,ub,ub,ub,cb,ur,ur,ur,ur,ur,ur,ur,ur,ur,ur,ur,ur,ur,ur,ur,ur,ur
ux,ub,ur,ur,ur,ur,ur,ur,ur,ur,ur,ur,ur,ur,ur,ur,ur,ur,ur,ur,ur,ur,ur
ux,ub,ur,ur,ur,ur,ur,ur,ur,ur,ur,ur,ur,ur,ur,ur,ur,ur,ur,ur,ur,ur,ur
ux,ub,ur,ur,ur,ur,ur,ur,ur,ur,ur,ur,ur,cr,cb,ub,ub,ur,ur,ur,ur,ur,ur
ux,ub,ur,ur,ur,ur,ur,ur,ur,ur,ur,ur,ur,ub,ub,ug,ub,ur,ur,ur,ur,ur,ur
ur,ub,cr,ur,ur,cr,ur,ur,ur,ur,ur,ur,ub,ub,ub,ug,ub,cr,ur,ur,ur,ur,cb
cg,ub,ur,ur,ur,ug,ug,ur,ur,ug,cr,ug,cb,ur,ub,ub,ub,ur,ur,ur,ur,ur,ur
ur,ub,ur,ub,ux,ug,ug,ux,ur,ug,ug,ug,ux,ur,ub,ub,ux,ux,ux,ux,ur,ur,ur
ub,ub,ur,ub,ux,ug,ug,cg,ur,ux,ug,ug,ux,ub,ub,ub,ub,ux,ux,ux,ur,ub,ub
ub,ur,ur,ub,ur,ug,ug,ug,ub,ub,ug,ug,ub,ub,ub,ub,ub,ux,ux,ux,ur,ux,ub
ub,ur,ur,ub,ur,ug,ur,ur,ub,ub,ug,ug,ug,ug,ub,ub,ux,ux,ux,ux,ur,ux,ub
ub,ub,ur,ub,ur,ug,ur,ur,ub,ux,ug,ub,ub,ub,ub,ub,ub,ub,ub,ux,ur,ux,ub
cg,ub,ur,ub,ur,cg,ux,ux,ux,ux,ug,ub,ub,cb,ub,ug,ug,ug,ug,ug,ur,ub,ub
ux,ub,ux,ub,ux,ux,ux,ux,ux,ux,ub,ub,ub,ub,ub,cg,ug,ug,ug,ug,ur,ux,ur
ub,ub,ux,ub,ux,cb,ub,ux,ux,ux,ux,ux,ub,ug,ug,ug,ug,ug,ug,ux,ur,ur,ur
ub,ub,ur,ur,ur,ub,ub,ur,ur,ub,ub,ub,ub,ub,ug,ug,ug,ug,ur,ur,ur,ur,ur
ur,ub,ux,ub,ux,ub,ub,ux,ur,ur,ur,ur,ur,ur,ur,cr,ub,ub,ug,ub,ub,ux,ur
ur,ux,ux,ub,ux,ux,ub,ub,ur,ub,ub,ux,ub,ub,ub,ub,ux,ux,ux,ux,ux,ux,ur
ur,ux,ub,ub,ux,ux,ub,ub,ur,ux,ux,ux,ux,ur,ux,ux,ux,ux,ux,ux,ux,ux,ur
ur,ub,ub,ux,ux,ux,ux,ux,ur,ux,ux,ux,ux,ur,ux,ux,ux,ux,ux,ux,ux,ux,ur
ur,ur,ur,ur,ur,ur,ur,ur,ur,cg,ux,ux,ux,ur,ur,ur,ur,ur,ur,ur,ur,ur,ur