ur,ur,ur,ur,ur,ur,ur,ur,ur,ur,ur,ur,ur,ur,ur,ur,ur,cb,ur,ur,ur,ur,ur
ur,ux,ux,ux,ur,ur,ur,ur,ur,ur,ur,ur,ur,ur,ur,ur,ur,ur,ur,ur,ur,ur,ur
ur,ux,ux,cr,ur,ur,ur,ur,ur,ur,ur,ur,ur,ur,ur,ur,ur,ur,ur,ur,ur,ur,ur
ur,ur,ur,ur,ur,ur,ur,ur,ur,ur,ur,ur,ur,ur,ur,ur,ur,ur,ur,ur,ur,ur,ur
cb,ur,ur,ur,ur,ur,ur,ur,ur,ur,ur,ur,ur,ur,ur,ur,ur,ur,ur,ur,ur,ur,ur
ur,ur,ur,ur,ur,cr,ur,ur,ur,cg,ug,ur,ur,ur,ur,ur,ur,ur,ur,ur,ur,ur,ur
ur,ur,ur,ur,ur,ur,ur,ur,ur,ur,ug,ur,ur,ur,cg,ug,ur,ur,ur,ur,ur,ur,ur
ur,ur,ur,ur,ur,ur,ur,cr,ur,ur,ug,ug,ug,ug,ug,ug,ur,ur,ur,ur,ur,ur,ur
ur,ur,cr,cr,ur,ux,ug,ug,ug,ug,ug,ug,ur,ur,ur,ur,ur,ur,ur,ur,ur,ur,ur
ux,ux,ux,ux,ux,ux,ux,ux,ux,ux,ug,ug,ug,ur,ub,ug,ug,ug,ur,ur,ug,ux,ub
ux,ux,ux,ux,ux,ux,ux,ux,ug,ug,ur,ub,ug,ub,ub,ur,ur,ug,ur,ug,ux,ux,ub
ub,ub,ub,ub,ub,ub,ub,ub,ub,ub,ur,ur,ug,ug,ug,ug,ug,ug,ug,ug,ug,ub,ub
ub,ux,ux,ux,ux,ux,ux,ux,ub,ub,ub,ub,ub,ug,ug,ug,ub,ub,ux,ug,ug,ux,cg
ub,ux,ux,ux,ux,ux,ux,ux,ub,ub,ub,ub,ub,ub,ub,ub,ub,ub,ub,ub,ug,ug,ug
ub,ux,ux,ux,ux,ux,ux,ux,ub,ug,ug,ub,ug,ux,ug,cb,ub,ub,ub,ub,ug,ug,ug
ub,ux,ux,ux,ux,ux,ux,ux,ub,ub,ub,ub,ug,ug,ug,ub,ub,cb,ub,ub,ug,ug,ug
ub,ub,ub,ub,ub,cg,ug,ug,ug,ug,ug,ug,ug,ug,ub,ub,ub,ub,ub,ub,ub,ub,ub
cg,ux,ux,ux,ux,ux,ux,ux,ub,ux,ub,ub,ub,ub,ub,ug,cb,ub,ub,ub,ub,ub,ub
ux,ux,ux,ux,ux,ux,ux,ub,ub,ux,ub,ub,ub,ub,ub,ug,cb,ub,ub,ub,ub,ub,ub
ux,ux,ux,ux,ug,ug,ug,ug,ug,ug,ug,ug,ug,ub,ub,ub,ub,ub,ub,ub,ub,ub,ub
ux,ux,ux,ug,cr,ur,ur,ur,ur,ur,ur,ur,ur,ur,cg,ur,ur,ur,ur,ur,ur,ur,ur
cr,ux,ux,ug,ug,ug,ug,ug,ug,ug,ug,ug,ug,ug,ug,ub,ux,ub,ux,ux,ux,cb,cr
cg,ux,ux,ux,ux,ux,ux,ux,ux,ux,ub,ub,ux,cb,ub,ub,ux,ux,ux,cg,cb,ux,cr