ur,ur,ur,ur,ur,ur,ur,ur,ur,ur,ur,ur,ur,ur,ur,ur,ur,ur,ur,ur,ur,ur,ur
ur,ur,ur,ur,ux,ur,ur,ur,ur,ur,ur,ur,ur,ur,ur,ur,ur,ur,ur,ur,ur,ur,ur
ur,ur,ur,ur,ur,ur,ur,ur,ur,ur,ur,ur,ur,ur,ur,ur,ur,ur,ur,ur,ur,ur,ur
ur,ur,ur,ur,ur,ur,ur,ur,ur,ur,ur,ur,ur,ur,ur,ur,ur,ur,cr,ur,ur,ur,ur
ur,ur,ur,ur,ur,ur,ur,ur,ur,ur,ur,cr,ur,cb,ub,ub,ux,ux,ub,ub,ub,ur,ur
ur,ur,ur,ur,ur,ur,ur,ur,ur,ur,ur,ur,cr,ub,ur,ub,ur,ur,ur,ur,ur,ur,ur
ur,ur,cr,ur,ur,ur,ur,ur,ur,ur,ur,ur,ur,ub,ub,ub,ub,ux,ux,ux,ux,ur,ur
ur,ur,ug,ug,cg,ur,ur,ur,ur,ur,ur,ur,ur,ub,ub,ub,ug,ug,ug,ux,ux,ux,ur
ur,ux,ur,ur,ur,ur,ur,ur,ur,ur,ur,ur,cr,ub,ub,ub,cg,ug,ug,ux,ux,ux,ur
ur,ux,ur,ur,ux,ur,ur,ur,ur,ur,ur,ur,ur,ub,ub,ub,ug,ug,ub,ub,ux,ux,ur
ur,ux,ur,ux,ur,ur,ur,ur,ur,ur,ur,ur,ur,ub,ur,cb,ug,ug,ur,ub,ub,ub,ur
ur,ux,ur,ur,ur,ur,ur,ur,ur,ur,ur,ur,ur,ub,ub,ub,ug,ub,ub,ux,ux,ub,ur
ur,ur,ur,ur,ur,ur,ur,ur,ur,ux,ug,ug,cr,ub,ub,ug,ug,ug,ub,ub,ub,ub,ur
ur,ur,ur,ur,ur,ur,ur,ur,ur,ug,ug,ub,ug,ug,ug,ug,ug,ug,ug,ub,ub,ub,ur
ur,ur,ur,ur,ur,ur,ug,ug,ug,ug,ub,ub,ug,ux,ug,ug,ug,ug,ug,ub,ub,ub,ur
ur,ur,ur,ug,ug,ug,ug,ur,ub,ug,ug,ug,ug,ux,ug,ug,ug,ug,ug,ug,ub,ub,ur
ux,ug,ux,ug,ux,ux,ux,ug,cg,ug,ub,ug,ug,ux,ux,ub,ug,ug,ug,ug,ub,ub,ur
ux,ug,ux,ug,ux,ux,ux,ug,ug,ug,ug,ux,ux,ux,ux,ub,ub,ub,ub,ub,ub,ub,ur
ur,ur,ur,ug,ur,ur,ur,ur,ur,ur,ug,ug,ug,ub,ub,ub,ur,ub,ub,ub,ub,ub,ur
ur,ug,ux,ug,ug,ux,ux,ux,ux,ux,ux,ux,ux,ub,cb,ub,ub,ub,ur,ub,ub,ub,ur
cb,ug,ux,ux,ug,ug,ug,ug,ug,ug,ug,ug,ug,ub,ub,ub,ub,ur,ur,ub,ub,ub,ur
ub,ub,ub,ub,ub,ub,ub,ub,ub,ur,ur,ur,ur,ur,ur,ur,ub,ur,ur,ur,ur,ur,ur
cb,ux,ux,ux,ux,ux,ux,ux,ub,ub,ub,ub,ub,ub,ub,ub,ub,ux,ux,ux,ux,cb,ur