cb,cb,cb,cr,ur,ur,ur,cr,ub,ub,cb,ur,ur,ur,ur,ux,ub,ux,ur,ur,ur,ur,cb
ur,ur,ur,ur,ur,ur,ur,ur,ub,ub,ub,ur,cr,ur,ur,ub,ub,cb,ub,ur,ur,ur,ux
ur,ur,ur,ur,ur,ur,ur,ur,cg,ur,ub,ur,ub,ur,ur,ub,ub,ub,ub,ur,ur,ur,ur
ur,ur,ur,ur,ur,ur,ur,ur,ug,ub,ub,ur,ub,ux,ur,ub,ub,ur,ur,ur,ur,ur,ur
ur,ur,ur,cg,ug,ur,ur,ug,ug,ub,ur,ux,cb,ur,ur,ub,ur,ur,ur,ur,ur,ur,ur
ur,ur,ur,ur,ug,ur,ur,ux,ur,ub,ur,ur,ur,ur,ur,ur,ur,ur,ur,ur,ur,ur,ur
ur,ur,cr,ug,ug,ub,ur,ur,ur,ub,ug,ux,ux,ux,ux,ux,ur,ur,cg,ug,cr,ur,ur
cb,ug,ug,ub,ug,ug,ub,ub,ub,ub,ug,ux,ux,ux,ux,ux,ur,ur,ur,ur,ur,ur,cr
ux,ux,ux,ub,ug,cb,ub,ub,ub,ub,ug,ux,ux,ug,ug,ug,ur,ur,ur,ur,ur,ur,ur
ux,ub,ub,ub,ub,ub,ub,ub,ub,ub,ub,ub,ux,ug,ux,ug,ur,ug,ug,ug,ug,ug,ux
ux,ub,ub,ub,ug,ug,ub,ub,ub,cg,ub,ub,ug,ug,ux,ug,ur,ug,ug,ug,ug,ug,ux
ux,ux,ub,ub,ub,ub,ub,ug,ug,ug,ub,ub,ug,ug,ug,ug,ug,ug,ug,ug,ug,ug,ux
cb,ux,ub,ub,ub,ur,ub,ub,ub,ug,ub,ub,ub,ug,ug,ug,ug,ug,ug,ug,ug,ug,ux
ub,ub,ub,ub,ub,ub,ub,ub,ub,ug,ub,ub,ub,ug,cb,ug,ug,ug,ug,ug,ug,ug,ux
ub,ub,ub,ub,ug,ub,ub,ub,ub,ug,ug,ub,ub,ug,ub,ug,ug,ug,ug,ug,ug,cr,ux
ux,ux,ux,ux,ug,ub,ux,ux,ux,ug,ug,ug,ub,ub,ub,ux,ug,ug,ug,ug,ug,ur,ux
ux,ux,ux,ux,ub,ub,ux,ux,ux,ug,ug,ux,ug,ug,ug,ug,ug,ux,ug,ug,ug,ur,ux
cr,ux,ux,ux,ub,ux,ux,ux,ux,ug,ug,ug,ug,ug,ux,ux,ur,ug,ug,ug,ug,ur,ub
cg,ux,ux,ux,ub,ux,ux,ux,ux,ug,ux,ux,ux,ug,ux,ux,ur,ug,ur,ux,ux,ur,ub
cb,ub,ub,ub,ub,ub,ub,ub,ub,ug,ug,ug,ug,ug,ub,ub,ur,cg,ur,ug,ug,ur,ub
ux,ub,ux,ux,ux,ux,ux,ux,ux,ux,ux,ux,ux,ux,ux,ux,ur,ux,ur,ur,ur,ur,cr
cr,ub,ub,ub,ub,ub,ub,ub,ub,ub,ub,ub,ub,ub,ub,ub,ur,cb,cg,ux,cb,ur,cr
cg,cb,cg,cb,ux,ux,ux,ux,ux,ux,ux,ux,ux,ux,ux,cg,ur,ur,ur,cg,cg,ur,cr