ur,ur,ur,ur,ur,ur,ur,ur,ur,ur,ur,ur,ur,ug,cb,ub,ub,cr,ur,ub,ub,ub,ub
ur,ur,ur,ur,ur,ur,ur,ur,ux,ux,ux,ur,ur,cg,ur,ur,ur,ur,ur,ub,ub,ub,ub
ur,ur,ug,ug,cg,ur,ur,cr,ur,ur,ux,ur,ur,ur,ur,ur,cr,ub,ub,ub,ux,ub,cb
ur,ur,ug,ug,ug,ug,ug,ur,ur,ur,ur,ur,ur,ux,ur,ur,cr,cb,ub,ub,ux,ux,ub
ur,ux,ug,ug,ug,ug,ug,ur,ur,ur,ur,ur,ur,ur,ur,ur,cb,ur,ub,ux,ux,ux,ub
ur,cr,ur,ur,ug,ur,ur,ur,ug,ur,ur,ur,ur,ur,ur,ur,ub,ur,ug,ux,ux,ux,ub
ub,ur,ub,ur,ug,ur,ur,ur,ur,ux,ur,ur,ur,ur,ur,ug,ub,ug,ug,ug,ux,ux,ub
ub,ur,ur,ur,ug,ug,ur,ug,ur,ur,ur,ug,ug,ug,ug,ub,ub,ub,ug,ug,ux,ux,ux
ug,ux,ux,ux,ux,cb,ux,ug,ug,ug,cg,ux,ug,ug,ub,ub,ub,ub,ub,ux,ux,ux,ux
ug,ux,ug,ug,ug,ub,ug,ug,ug,ug,ug,ug,ug,ug,ub,ub,ub,ub,ub,ur,ur,ur,ur
ug,ux,ug,ux,ub,ub,ub,ub,ub,ub,ub,ub,ug,ug,ug,ub,ub,ub,ub,ur,ux,ux,ur
ug,ux,ug,ux,ub,ug,ub,ub,ub,ub,cb,ub,ug,ug,ug,ug,ug,ug,ug,ur,ur,ur,ur
ug,ux,ug,ux,ub,ug,ux,ux,ub,ub,ub,ub,ub,ub,ub,ub,ub,ub,ub,ur,ub,ub,ub
ug,ux,ug,ux,ub,ug,ug,ux,ux,ug,ub,ub,ub,ub,ub,ug,ug,ug,ug,ur,ur,ur,ur
ug,ux,ug,ux,ub,ug,ug,ux,ux,ub,ub,ub,ub,ub,ub,ux,ux,ug,ug,ur,ub,ub,ur
ug,ux,ug,ux,ub,ub,ub,ub,ux,ub,ub,ux,ux,ux,ub,ub,ub,ub,ub,ur,ub,ub,cr
ug,ux,ug,ux,ux,ug,ug,ub,ub,ub,ub,ub,ug,ug,ub,ub,ub,ub,ub,ur,ub,ub,ub
ug,ux,ug,ux,ux,ug,ug,ux,ub,ub,ux,ux,ug,ux,ub,ub,ub,ub,ux,ur,ub,ub,ub
ug,ux,ug,ux,ux,ug,ug,ux,ub,ub,ub,ub,ub,ub,ub,ux,ux,ub,ub,ur,ub,ub,ub
ur,ur,ur,ur,ur,ur,ur,ur,ub,ur,ur,ur,ur,ub,ub,ur,ur,ur,ub,ur,ux,ub,ub
ur,ux,ux,ux,ux,ux,ux,ux,ux,ux,ux,ux,ux,ub,ub,ub,ux,ur,ur,ur,ub,ub,ub
ur,ux,ux,ux,ux,ux,ux,ux,ux,ux,ux,ux,ux,ux,ub,ux,ux,ur,ur,ur,ub,ub,ub
ur,ur,ur,ur,ur,ur,ur,ur,ur,ur,ur,ur,ur,ur,ur,ur,ur,ur,ur,ur,ur,ub,ub