ur,ur,ur,ug,ug,ug,ug,cg,ur,ur,ur,ur,ur,ur,ur,ur,ur,ur,ur,ur,ur,ur,ur
ur,ur,ur,ur,ur,ur,ur,ur,ur,ur,ur,ur,ur,ur,ur,ur,ur,ur,ur,ur,ur,ur,ur
ur,ur,ur,ur,ur,ur,ur,ur,ur,ur,ur,ur,ur,ur,ur,ur,ur,ur,ur,ur,ur,ur,ur
ur,ur,ur,ur,cr,ug,ur,ur,ur,cr,ur,ur,ur,ur,ur,ur,ur,ur,ur,ur,ur,ur,ur
ur,ur,ur,ur,ug,ug,ur,ur,ur,ur,ux,ur,ur,cr,ur,ur,ur,ur,cr,ur,ur,cr,ur
ur,ur,ur,ur,ug,ug,ur,ur,ur,ur,ur,ur,ub,ub,ur,ur,ur,ur,ur,ur,ur,ur,ur
ur,ur,ur,ur,ur,ug,ug,cg,ur,ur,ur,ur,ub,ub,ur,ur,ur,ux,ux,ur,ux,ux,ur
ur,ur,ur,ug,ux,ur,ur,ur,ur,ur,ux,ur,ur,ub,ub,ub,ur,ug,ug,ur,ur,ur,ur
ur,ur,ur,ug,ux,ur,ur,ur,ur,ur,ur,ub,ub,ub,ub,ub,ur,ub,ux,ur,ur,ux,ur
ur,ur,ur,ug,ux,ux,ux,ux,ub,ub,ub,ub,ub,ub,ub,cb,ug,ug,ux,ur,ur,ux,ur
ux,ux,ug,ug,ug,ug,ug,ug,ub,ub,ug,ug,ub,ug,ub,ub,ub,ug,ux,ur,ur,ux,ur
ux,ux,ug,ug,ux,ux,ux,ux,ub,ub,ub,ug,ub,ug,ub,ub,ub,ug,ux,ur,ur,ux,ur
ux,ux,ug,ug,ux,ux,ux,ux,ub,ub,ub,ub,ub,ug,ub,ug,ug,ux,ux,ur,ur,ux,ur
ux,ux,ug,ug,ux,ux,ux,ux,ug,cb,ub,ub,ub,ub,ux,ux,cg,ux,ux,ur,ur,ux,ur
ux,ux,ug,ug,ux,ux,ux,ux,ux,ub,ub,ux,ux,ug,cb,ug,ug,ug,ug,ur,ur,ux,ur
ux,ux,ug,ux,ux,ux,ux,ux,ub,ub,ux,ug,ug,ub,ub,ug,ug,ug,ug,ur,ur,ux,ur
ux,ux,ug,ux,ux,ux,ux,ux,ub,ub,ub,ug,ub,ub,ug,ug,ug,ug,ug,ur,ur,ux,ux
ux,ux,ux,ux,ux,ux,ux,ux,ux,ux,ub,ub,ub,ub,ub,ug,ug,ug,ug,ur,ur,ux,ux
ux,ux,ux,ux,ux,ux,ux,ux,ux,ux,ub,ub,ub,ub,ug,ug,ux,ux,ux,ur,ur,ux,ux
ux,ux,ux,ux,ux,ux,ux,ux,ux,ux,ux,ux,ub,ur,ux,ux,ux,ux,ux,ur,ur,ux,ux
ux,ux,ux,ux,ux,cb,ub,ub,ub,ub,ub,ub,ub,ub,ub,ub,ub,ub,ub,ur,ur,ux,ux
ux,ux,ux,ux,ux,ux,ux,ux,ux,ux,ux,ux,ux,ur,ux,ux,cr,ur,ur,ur,ur,ux,ux
cb,ux,ux,ux,ux,ux,ux,ux,ux,ux,ux,ux,ux,ur,ur,ur,ur,ur,ur,ur,ur,cb,ux