ux,ux,ux,ux,ux,ux,ux,ux,ux,ur,ur,ur,ur,ur,ur,ur,ur,ur,ur,ur,ur,ur,ur
ux,ux,ux,ux,ux,ux,ux,ux,ux,ur,ux,ur,ur,ur,ur,ur,ur,ur,ur,ur,ur,ur,ur
ux,ur,ug,ug,ug,ur,ur,ur,ur,ur,ur,ur,ur,ur,ur,ur,ur,ur,ur,ur,ur,ur,ur
ux,ug,cg,ug,ug,ux,ux,ux,ux,ur,ur,ur,ur,ux,ux,ur,ur,ur,ur,ur,ur,ur,ur
ux,ug,ug,ug,ug,ug,ux,ux,ux,ur,ux,ur,ur,ur,ur,ur,ur,ur,ur,ur,ur,ur,ur
ux,ug,ug,ug,ug,ug,ux,ux,ux,ur,ux,ur,ur,ur,ur,ur,cb,ur,ur,ur,ur,ur,ur
ux,ur,ux,ur,ux,ur,ur,ur,ur,ur,ur,ur,ur,ur,ur,ur,ub,cr,ur,ur,cr,ur,ur
ux,ur,ur,ur,ur,ur,ur,ur,ur,ur,cr,ur,ub,cr,ur,ur,ur,ur,ub,ub,cr,ur,ur
cg,ur,ur,ur,ur,ur,ur,ur,ur,ur,ub,cb,ub,cr,cb,ur,ub,ux,ux,ux,ux,ux,ur
ur,ur,ur,ur,ur,ur,ur,ur,ur,ur,ug,ug,ur,ub,ub,ub,ub,ux,ux,ux,ux,ux,ur
ur,ur,ur,ur,ur,ur,ur,ur,ur,ur,cb,ug,cg,ug,ur,ur,ub,ux,ux,ux,ux,ux,ur
ug,ux,ur,ur,ur,ur,ur,ur,ur,ur,ub,ub,ub,ub,ub,ub,ux,ux,ux,ux,ux,ux,ur
ub,ub,ug,ur,ur,ur,ur,ux,ub,ub,ub,ub,ub,ug,ub,ub,ux,ux,ux,ux,ux,ux,ur
cb,ub,ub,ub,ug,ug,ux,ux,ub,ub,ub,ug,ub,ug,ub,ub,ug,ux,ux,ux,ux,ux,ur
cg,ub,ub,ub,ub,ug,ug,ug,ug,ug,ux,ug,ug,ug,ub,ug,ug,ux,ux,ux,ux,ux,ur
ux,ug,ug,ux,ub,ug,ub,ub,ug,ux,ug,ug,ug,ug,ub,ub,ub,ub,ub,ux,ux,ux,ur
ux,ug,ux,ux,ub,ub,ub,ux,ug,ux,ug,ux,ub,ub,ub,ub,ub,ub,ub,ux,ux,ux,ur
ux,ug,ux,ub,ub,ub,ub,ux,ug,ux,ug,ug,ug,ub,ux,ug,ug,ug,ux,ux,ux,ux,ur
ux,ug,ub,ub,ux,ub,ub,ux,ug,ur,ur,ur,ug,ub,ur,ur,ur,ur,ur,ur,ur,ur,ur
ux,ug,ub,ub,ub,ub,ub,ub,ug,ux,ux,ux,ug,ux,ur,ur,ur,ur,ur,ur,cb,ub,ub
ux,ur,ur,ub,ub,ur,ur,ub,ur,ur,ur,ub,ug,ub,ub,ub,ub,ub,ur,ur,ur,ur,ub
ux,ur,ur,ub,ub,ur,ur,ub,ub,ur,ur,ub,ug,ub,ub,ub,ub,ub,ub,ub,ub,ub,ub
ux,ux,ux,ux,ux,ux,ub,ub,ub,cg,ux,ux,cg,ub,ub,ub,ub,ub,ub,ux,ur,ub,ub