ur,ur,cb,ur,ur,cr,ub,ub,ub,cb,ur,ur,ur,ur,ur,ur,ux,ux,ux,cg,ug,ug,ug
ur,ur,ur,ur,ur,ur,ur,ur,ur,ur,ur,ur,ub,ub,ur,ur,ux,ux,ux,ug,ug,ug,ug
ur,ur,ur,ur,ur,ur,ub,ub,ub,ur,ur,ur,ub,ub,ur,ug,ug,ug,ub,ug,ug,ur,ug
ur,ur,ur,ur,ur,ur,cb,ur,cr,ur,ur,ub,ub,cr,ug,ug,ug,ug,ub,ug,ug,ug,ug
ux,ub,ub,ur,ur,ur,ur,ur,ub,ux,ur,ur,ur,ur,ur,ug,ub,ub,ub,ux,ug,ug,ug
ux,ub,ub,ub,ux,cr,ur,ur,ur,ur,ur,cr,ug,ug,ug,ug,ug,ug,ug,ug,ug,ug,ug
ug,ug,ug,ur,ur,ub,ux,ux,ux,ux,ux,ur,ur,ub,ur,ug,ug,ug,ug,ux,ux,ug,ug
ug,ub,ub,ub,ur,ub,ux,ux,ux,ug,ug,ug,ug,ub,ur,ug,ux,ub,ug,ux,ux,ug,ug
ug,ug,ug,ug,ug,ug,ug,ug,ug,ug,ug,ug,ug,ug,ug,ug,ug,ug,ug,ux,ux,ug,ug
ux,ux,ux,ux,ur,ur,ur,ux,ug,ug,ug,ug,ug,ug,ur,cg,ux,ug,ug,ub,ub,ub,ub
cb,ub,ub,ub,ub,ub,ux,ux,ug,ug,ug,ug,ub,ug,ur,ug,ug,ug,ub,ub,ub,ub,ub
ux,ux,ux,ux,ux,ux,ug,ug,ug,ux,ub,ub,ub,ub,ur,ug,ub,ug,cb,ub,ub,ub,ub
ux,ux,ux,ux,ux,ux,ug,ug,ug,ux,ux,ux,ux,ub,ur,ur,ur,ug,ub,ug,cb,ub,ub
ux,ux,ux,ux,ux,ux,ug,ug,ug,ug,ug,ug,ub,ub,ub,ub,ub,ug,ub,ug,ub,ub,ub
ux,ux,ux,ux,ug,ug,ug,ug,ug,ug,ug,ux,ub,ub,ub,cg,ug,ug,ub,ug,ug,ub,cg
cg,ux,ux,ug,ug,ug,cr,ur,ur,ur,ur,ur,ur,ur,ur,ug,ur,cg,ur,ug,ur,ub,ug
ux,ux,cg,ug,ug,ug,ug,ug,ug,ug,ug,ug,ug,ug,ug,ug,ug,ug,ug,ug,ug,ub,ug
ux,ux,ug,ug,ug,ug,ug,ug,ux,ug,ug,ug,ug,ug,ug,ug,ub,ug,ug,ug,ug,ub,ug
ux,ux,ug,ug,ug,ug,ug,ug,ug,ug,ug,ug,ug,ux,ux,ux,ub,ug,ug,ug,ub,ub,ug
ux,ux,ug,ug,ug,ug,ug,ug,ug,ug,ug,ug,ub,ub,ug,ug,ub,ug,ug,ug,ub,ug,ug
cr,ux,ug,ug,ug,ux,ux,ug,ux,ug,ug,ub,ub,ub,ug,ug,ug,cb,ub,ub,ub,ub,ub
cg,ux,ux,ux,ug,ux,ug,ug,ug,ug,ug,ug,ux,ux,ub,ub,ub,ub,ub,ub,ub,cb,cr
cr,ux,ux,ux,ug,ug,ug,ug,ug,ug,ug,ug,ub,ub,ub,ux,ux,ux,ux,ux,cb,ux,cr