ur,cr,ur,ur,ur,ur,ur,ur,ur,ur,ur,ur,ur,cr,ux,ur,ur,cb,ur,ur,ur,ur,ur
cb,ub,ur,ur,ur,ur,ur,ur,ur,ur,ur,ug,ug,ug,ux,ur,ur,ug,ug,ug,ug,ug,ur
ub,ub,ur,ur,ur,ur,ur,ur,ur,ur,ur,ug,ur,ug,ur,ur,ur,ur,ur,ur,ur,ur,ur
ur,ur,ur,cg,ur,ur,ur,ur,ur,ur,ur,ug,ug,ug,ug,ur,ug,ug,ub,ur,ur,ur,ur
ur,ur,ur,cr,ur,cr,ur,ur,ur,ur,ur,ug,ug,ub,ub,ur,ug,ug,ug,ur,ug,ug,ur
ur,ur,ur,ur,ug,ug,ug,ug,ur,ub,ur,ux,ug,ub,ub,ur,ug,ub,ug,cr,ug,ug,ux
cr,ur,ur,ur,ug,ug,ur,ug,ur,ub,ur,ub,ub,ub,ub,ur,ug,ub,ug,ug,ug,ug,ux
ur,ur,ur,ur,ub,ub,ug,ug,ur,ur,ur,ub,ub,ub,ub,ur,ug,ub,ug,ug,ug,ug,ux
ub,ub,ub,ub,ub,ur,ux,ur,ux,ur,ub,ub,ug,ub,ub,ur,ug,ug,ug,ug,ug,ug,ux
cb,ub,ub,ub,ub,ux,ux,ur,ur,ub,ub,cb,ug,cg,ug,ur,ub,ug,ux,ug,ug,ug,ux
ug,ub,ub,ub,ub,ux,ux,ux,ub,ub,ub,ub,ub,ug,ug,ur,ub,ub,ux,ug,ug,ug,ux
ub,ub,ub,ub,ub,ux,ux,ux,ux,ub,ub,ug,ub,cb,ug,ur,ub,ub,ux,ug,ug,ug,ux
ug,ug,ug,ug,ug,ug,ug,ug,ug,ug,ug,ug,ub,ub,ub,ub,ub,ub,ub,ub,ug,ug,cg
ug,ub,ub,ub,ub,ux,ux,ux,ub,ub,ug,ug,ux,ub,ub,ub,ub,ub,ub,ug,ug,ug,ux
ug,ug,ug,ug,ug,ug,ug,ug,ug,ub,ub,ub,ux,ux,ub,ub,ux,ux,ux,ug,ug,ug,ux
ug,ub,ub,ub,ub,ux,ux,ux,ug,cg,cb,ub,ug,ug,ub,ur,ux,ux,ug,ug,ug,ug,ux
ug,ug,ug,ub,ub,ug,ug,ug,ug,ug,ug,ug,ug,ug,ux,ur,ux,ux,ug,ux,ug,ug,ux
cg,ur,ur,ub,ug,ug,ug,ug,ug,ug,ub,ur,ur,ur,ur,ur,ur,ur,ug,ux,ug,cg,ux
ux,ur,ux,ub,ug,ug,ug,ug,ug,ug,ug,ug,ug,ug,ug,ur,ux,ur,ug,ug,ug,ux,ux
ux,ur,ux,ub,ux,ux,ux,ux,ux,ux,ux,ux,ux,ux,ux,ur,ux,ur,ug,ug,cb,ub,ub
ux,ur,ux,ub,ub,ub,ub,ub,ub,ub,ub,ub,ub,ub,ub,ub,ub,ub,ub,ub,ub,ub,ub
cr,ur,ux,ux,ux,ux,ux,ux,ux,ux,ux,ux,ux,ux,ux,ur,ux,ur,ur,ux,ux,ub,cb
cg,ur,ur,ur,ur,ur,ur,ur,ur,ur,ur,ur,ur,ur,ur,ur,ur,ur,ur,cg,ub,ux,ur