ur,cb,cb,cr,ur,ur,ur,ur,ur,ur,ur,ur,ur,ur,ur,ur,ub,ub,ub,ub,ub,ub,cb
ur,ur,cb,ur,ur,ur,ur,cr,ur,ur,ur,ur,ur,ur,ur,cr,ur,ur,ur,ur,ur,ur,ur
ur,ur,ur,ur,ur,ur,ur,cr,ug,ug,ug,ur,ub,ub,ub,ur,ur,ur,ur,ur,ur,ur,ur
ur,ug,ur,ur,ug,ur,ub,ug,ug,ug,ug,ug,ug,ug,ub,ur,ur,ur,ur,ur,ur,ur,cr
ur,ur,cr,ur,ug,ur,ug,ug,ug,ug,ug,ug,ug,ug,ug,ub,ux,ux,ux,ux,ub,ub,ur
ur,ur,ug,ur,ug,ur,ub,ub,ur,ug,ub,ug,ug,ux,cg,cg,ug,ug,ug,ug,ub,ub,ur
ur,ur,ur,ur,cg,cb,ur,ub,ur,ug,ub,ug,ug,ug,ub,ug,ug,ug,ug,ug,ub,ub,ur
cb,ug,ur,ur,ur,ub,ub,ub,ug,ug,ub,ug,ux,ux,ub,ug,ug,ug,ug,ug,ub,ub,ur
ux,ub,ux,ur,ur,ub,ub,ub,ug,ub,ux,ug,ux,ux,ub,ug,ug,ug,ug,ug,ug,ug,ur
ux,ub,ux,ur,ur,ur,ur,ux,ux,ub,ub,ug,ug,ug,ub,ub,ub,ub,ub,ub,ub,ub,cb
ub,ub,ub,cb,ug,ub,ub,ux,ub,ub,ug,ug,ug,ug,ur,ug,ug,ug,ug,ug,ug,ux,ur
ub,ub,ub,ug,ug,ub,ub,ux,ub,ub,ug,ug,ug,ug,ur,ug,ug,ug,ug,ug,ug,ux,ur
cb,ub,ub,ur,ux,ub,ub,ub,ub,ug,ug,ug,ug,ux,ur,ux,ux,ug,ug,ug,ug,ug,ur
ub,ub,ub,cg,ug,cb,ub,ub,ub,ug,ub,ub,ug,ug,ug,ug,ug,ug,ub,ub,ub,ub,ur
ub,ub,ub,ub,ub,ub,ux,ux,ux,ug,ux,ug,ug,ux,ur,ug,ux,ux,ux,ux,ux,ub,ur
ub,ub,cg,ux,ux,ur,ug,ug,ux,ug,ug,ug,ug,ug,ur,ug,ux,ug,ug,ux,ux,ub,ur
ub,ug,ug,ug,ug,ub,ux,ug,ug,ug,ug,ug,ug,ug,ug,ug,ug,ug,ug,ux,ux,ub,ur
ub,ug,ug,ug,ug,ug,ux,ug,ug,ug,ug,ug,ug,ug,ur,ug,cg,ug,ug,ux,ux,ub,ur
ub,ug,ug,ug,ug,ug,ug,ug,ug,ug,ug,ug,ug,ug,ur,ur,ur,ur,ur,ur,ur,ur,ur
cb,ug,ug,ug,ug,ug,ug,ug,ux,ux,ux,ux,ux,ux,ur,ur,ug,ug,ug,ux,ux,ux,cb
cr,ug,ug,ug,ug,ug,ug,ug,ug,ug,ug,ug,ug,ug,ug,cr,ux,ux,ux,ux,ux,ux,cr
cg,ug,ug,ug,ug,ug,ug,ug,ux,ux,ux,ux,ux,ux,ur,ux,ux,ux,ux,cb,cb,ux,cr
cr,cg,cg,cb,ux,ur,ur,ur,ur,ur,ur,ur,ur,ur,ur,cg,ux,ux,ux,cg,cg,ux,cr