ur,ur,ur,ur,ur,ur,ur,ur,ur,ur,ur,ur,ur,ur,ur,cr,cg,ub,cb,ub,ub,ub,ub
ur,ur,ur,ur,ur,ur,ur,ur,ur,ur,ux,ur,ur,ur,cr,ux,ug,ux,ub,ub,ub,ub,ub
ur,ur,ur,ur,ur,ur,ur,ur,ur,ur,ux,ur,ur,ur,ur,ub,ug,ux,ux,ub,ux,ub,cb
ur,ur,ur,ur,cg,ug,ug,ug,ur,ur,ur,ur,ur,ux,ur,ur,ug,cb,ub,ub,ux,ux,ub
ur,ux,ur,ur,ug,ug,ug,ug,ur,ur,ur,ur,ur,ur,ur,ur,ur,ub,ub,ux,ux,ux,ub
ur,ur,cr,ur,ug,ur,ur,ug,cg,ur,ur,ur,ur,ur,cr,ug,ug,ug,ug,ux,ux,ux,ub
ub,ur,ub,ur,ug,ur,ur,ur,ur,ux,ur,ur,ur,ur,ur,ug,ug,ug,ug,ug,ux,ub,ub
ub,ur,ur,ur,ug,ug,ur,ug,ub,cr,ur,ug,ug,ug,ug,ub,ub,ub,ug,ug,ux,ub,ux
ug,ux,ux,ux,ub,ug,ub,ub,ub,ub,ub,ux,ug,ug,ub,ub,ub,ub,ub,ux,ux,ub,ux
ug,ux,ug,ug,ug,ug,ug,ug,ug,ug,ug,ug,ug,ug,ub,ub,ub,ub,ub,ur,ur,ur,ur
ug,ux,ug,ux,ub,ug,ug,ug,ug,ug,cb,ub,ug,ug,ug,cb,ug,ub,ub,ur,ux,ux,ur
ug,ux,ug,ux,ub,ug,ub,ub,ub,ub,ug,cb,ug,ug,ug,ug,ug,ug,ug,ur,ur,ur,ur
ug,ux,ug,ux,ub,ug,ug,ux,ub,ub,ub,ub,ub,ub,ub,ub,ub,ub,ub,cr,ub,ub,ub
ug,ux,ug,ux,ub,ug,ug,ux,ux,ug,ub,ub,ub,ub,ub,ug,ug,ug,ug,ur,ub,ub,ub
ug,ux,ug,ux,ub,ug,ug,ux,ux,ub,ub,ub,ub,ub,ub,ux,ux,ug,ug,ur,ub,ub,ub
ug,ux,ug,ux,ub,ub,ub,ub,ux,ub,ub,ux,ux,ux,ub,ub,ub,ub,ub,ur,ub,ub,ub
ug,ux,ug,ux,ux,ug,ug,ub,ub,ub,ub,ub,ug,ug,ub,ub,ub,ub,ub,ur,ub,ub,ub
ug,ux,ug,ux,ux,ug,ug,ux,ub,ub,ux,ux,ug,ux,ub,ub,ub,ub,ux,ur,ub,ub,ub
ug,ux,ug,ux,ux,ug,ug,ux,ub,ub,ub,ub,ub,ub,ub,ux,ux,ub,ub,ur,ub,ub,ub
ur,ur,ur,ur,ur,ur,ur,ur,ub,ur,ur,ur,ur,ub,ub,ur,ur,ur,ub,ur,ux,ub,ub
ur,ux,ux,ux,ux,ux,ux,ux,ux,ux,ux,ux,ux,ub,ub,ub,ux,ur,ur,ur,ub,ub,ub
ur,ux,ux,ux,ux,ux,ux,ux,ux,ux,ux,ux,ux,ux,ub,ux,ux,ur,ur,ur,ub,ub,ub
ur,ur,ur,ur,ur,ur,ur,ur,ur,ur,ur,ur,ur,ur,ur,ur,ur,ur,ur,ur,ur,ub,ub