ur,cb,ur,ur,ur,ur,ur,ur,ur,ur,ur,ur,ur,ur,ur,ur,ub,ub,ur,ur,ur,ur,ur
ur,ub,ub,ur,ur,ur,ur,ur,ur,ur,ur,ur,ur,ur,ur,ur,cr,ub,ub,ur,ur,ur,ur
ur,ur,cr,ur,ur,ur,ur,ur,ur,ur,ur,ur,ur,ur,ur,ur,ur,ub,ub,ur,ur,ur,ur
ux,ur,ur,ur,ur,ux,ur,ur,ur,ur,ur,ur,cb,ub,ur,ur,ur,ub,ub,ur,ur,ur,cb
ur,ur,ur,ur,ur,ur,ur,ux,ur,ur,ur,ur,ur,ub,cr,ur,ur,ur,ur,ur,ur,ur,ux
ur,ur,ur,ur,ur,ur,ur,ur,ur,ur,ur,cr,ur,ub,ub,ur,ur,ug,ub,ub,ur,ur,ux
ux,ux,ur,cr,ur,ur,ur,ur,ur,ur,ur,ur,ur,ur,ur,ur,ur,ug,ur,ur,ur,ur,ur
ux,ux,ur,ur,ur,ur,ur,ug,ug,ug,cg,ur,cg,ur,ur,ur,ur,ug,ur,ur,ur,ur,ur
cg,ur,ur,ur,ur,ur,ur,ug,ur,ur,ur,ur,ug,ur,ur,ug,ug,ug,ur,ur,ur,ur,ur
ur,ur,ur,ur,ur,ur,ur,ug,ug,ug,ur,ur,ug,ub,ug,ug,ug,ug,ur,ur,ur,ur,ur
ur,ur,ur,ur,ur,ur,ur,ur,ug,ug,ur,ur,ug,ub,ug,ug,ug,ug,ux,ur,ur,ur,ur
ur,ur,ur,ur,ur,ur,ur,ur,ur,ub,ur,ub,ug,ug,ug,ug,ug,ug,ug,ux,ur,ur,ur
ur,ur,ur,ur,ur,ur,ur,ug,ur,cr,ub,ub,ub,ub,ub,ub,ub,ub,ub,ux,ug,ux,ux
ur,ur,ur,ur,ur,ur,ur,ug,cb,ub,ub,ub,ub,ug,ub,ub,ub,ub,ub,ub,ub,ub,ub
cg,ur,ur,ur,ur,ur,ur,ux,ub,ub,ub,ug,ug,ug,cb,ug,ub,ub,ub,ug,ug,ux,ub
ug,ug,ug,ug,ug,ug,ug,ug,ub,ub,ug,ug,ub,ub,ub,ug,ug,ub,ug,ug,ux,ux,ub
ug,ux,ux,ug,ug,ug,ug,ug,ub,ux,ug,ux,cb,ub,ub,ub,ug,ug,ux,ux,ux,ux,ub
ug,ux,ux,ug,ux,ug,ug,ug,ub,ug,ug,ux,ub,ub,ub,ub,ux,ug,ux,ux,ux,ux,ub
ug,ux,ux,ug,ug,ug,ug,ux,ub,ux,ux,ux,ux,ux,ub,ub,cg,ug,ux,ux,ux,ux,ub
ug,ux,ux,ug,ug,ug,ug,ux,ub,ux,ux,ux,ux,ux,ux,ux,ux,ux,ux,ux,ux,ux,ub
ub,ub,ub,ub,ub,ub,ub,ub,ub,ub,ub,ub,ub,ub,ub,ub,ub,ub,ub,ub,ub,ub,ub
ub,ux,ux,ug,ug,ug,ug,ux,ub,ux,ux,ux,ux,ux,ux,ux,ux,ux,ux,ux,ux,ux,cb
ub,ub,ub,ub,ub,ub,ub,ub,ub,cg,ux,ux,ux,ux,ux,ux,ux,ux,ux,ux,ux,ux,ux