ur,ur,ur,ur,ur,ur,ur,ur,ur,ur,ur,ur,ur,ur,ur,cr,ur,ur,ur,ur,ug,ur,cb
ur,ur,ur,ur,ur,ur,ur,ur,ur,ur,ur,ur,ur,ur,ur,ur,ur,ur,cr,ur,ug,ug,ux
ur,ur,ur,ur,ur,ur,ur,ur,ur,ur,ur,ur,ur,ur,ur,ur,cr,ur,cr,ug,ug,ug,ux
ur,ur,ur,cg,cr,ur,ug,ug,cb,ug,ur,ur,ur,ux,ub,ug,ug,ub,ub,ug,ux,ug,ux
ur,ur,ur,ub,ub,ur,ur,ub,ub,ur,ur,ur,ub,ub,ub,ug,ug,ug,ub,ug,ug,ug,ux
ur,ur,ur,ub,ub,ub,ur,ub,ub,ub,ub,ug,ug,ug,ux,ug,ub,ug,ug,ug,ug,ug,ux
ur,ur,ur,ub,ux,ug,ug,ug,ug,ug,ug,ug,ug,ub,ub,ug,ub,cg,ug,ux,ug,ux,ux
ur,ur,ur,ub,ug,ug,ux,ux,ub,ug,ug,ur,ug,ub,ux,ug,ub,ux,ug,ug,ug,ux,ux
cg,ur,ux,ub,ug,ug,ug,ug,ub,ug,ub,ub,ug,ub,ub,ug,ub,ux,ux,ug,ug,ux,ux
ur,ur,ux,ub,ug,ug,ug,ug,ur,ug,ug,ub,ug,ug,ug,ug,ub,ub,ug,ug,ug,ux,ux
ur,ux,ux,ub,ug,ux,ug,ug,ur,ug,ug,ub,ub,ug,ub,ug,ug,ub,ug,ux,ug,ug,ug
ur,ur,ur,ub,ug,ux,ug,ug,ur,ug,ug,ur,ug,ug,ux,ug,ug,ub,ug,ug,ug,ux,ug
ur,ur,ur,ub,ug,ur,ug,ug,ug,ug,ub,ur,ug,ug,ub,ug,ug,ub,ux,ux,ug,ug,ug
ur,ur,ur,ub,ug,ub,ug,ug,ug,ub,ub,ug,ub,cb,ub,ub,ub,ux,ux,ux,ux,ug,ug
ur,ur,ur,ub,ug,ub,cg,ug,ug,ub,ub,ug,ub,cb,ub,ub,ub,ub,ub,ux,ux,ug,ug
ur,ur,ux,ub,ug,ub,ub,ug,ug,ug,ug,ug,ub,ub,ub,ug,ug,ub,ub,ub,cb,ug,ug
ur,ur,ur,ub,ug,ur,ur,ur,ub,ub,ub,ub,ub,ub,ur,ug,ur,ub,ub,ub,ub,ub,ur
ur,ux,ux,ub,ug,ux,ux,ux,ux,ux,ux,ub,ub,ub,ug,ug,ug,ug,ub,ub,ug,ub,ur
ur,ux,ux,ub,ug,cr,ur,ur,ur,ur,ur,ur,ur,ur,ur,ur,ur,ur,ur,ur,ur,ub,ub
ur,ux,ux,ub,ux,ux,ux,ux,ux,ux,ug,ug,ug,ur,ux,ug,ug,ug,ug,ug,ub,ux,ub
ur,ux,ub,ub,ux,ux,ux,ux,ux,ux,ux,ur,ux,ur,ux,ux,ux,ux,ux,ug,ub,ub,ub
ur,ub,ub,ux,ux,ux,ux,ux,ux,ux,ux,ur,ux,ux,ux,ux,ux,ux,ux,ug,ub,ub,ub
cb,ub,ur,ur,ur,ur,ur,ur,ur,ur,ur,ur,ux,ux,ux,ux,ux,ux,ux,ux,ux,ub,ub