ux,ux,ur,ur,ur,ur,ur,ur,ur,ur,ur,ur,ux,ux,ux,ux,ux,ux,ur,ur,ub,ub,cb
ux,ux,ux,ur,ur,ur,ur,ur,ur,ur,ur,ur,ux,ux,ux,ux,ur,ur,ur,ur,cr,ur,ur
ux,ur,ur,ur,ur,ur,ur,ur,ur,ur,ur,cr,ux,ux,ux,ux,ur,ub,ub,ub,ub,ub,ub
ux,ur,ur,ur,ur,ug,ur,ur,ur,ur,ur,ur,ux,ug,ug,ug,ur,ub,ub,ub,ub,ux,ub
ux,ur,ur,ur,cr,ug,ur,ur,ur,ur,cr,ur,ug,ug,ur,ug,ur,ur,ub,ub,ub,ub,ub
ur,ur,ux,ur,ur,ug,ur,ur,ur,ur,ug,ug,ug,ur,ur,ug,ur,ur,ur,ur,ub,ub,ub
ur,ur,ux,ur,ur,ug,cg,ur,ur,ur,ur,ur,ur,ur,ur,ug,ur,ur,ux,ur,ub,ub,ub
ur,ur,ur,ur,ur,ur,ur,ur,ur,ur,ur,ur,ur,ur,ur,ug,ug,ug,ug,cg,ub,ub,ub
cg,ux,ur,ur,ur,ur,ur,ur,ur,ur,cr,ub,ub,cb,ub,ub,ub,ub,ub,ub,ub,ub,ub
ux,ux,ur,ur,ur,ur,ur,ur,ur,ur,ur,ub,ur,ur,ub,ug,ub,ub,ub,ub,ub,ub,ub
ur,ur,ur,ur,ux,ux,ur,ub,ub,ub,ub,ur,cg,ug,ug,ug,ub,ub,ur,ur,ur,ur,ub
cb,ub,ur,ur,ur,ur,ur,ub,ur,ur,ur,ub,ub,ub,ub,ug,ub,ub,ub,ub,ub,ub,ub
ub,ub,ur,ur,ur,ur,ur,cb,ur,ur,ur,ur,ur,ug,ug,ug,ub,ub,ub,ux,ux,ux,ux
ub,ub,ur,ur,ur,ur,ur,ur,ub,ux,ux,ux,ub,ug,ur,ub,ub,ub,ub,ub,ux,ux,ux
cg,ub,ux,ux,ux,ux,ub,ub,ub,ub,ub,ux,ub,ug,ub,ub,ux,ub,ux,ux,ux,ux,ux
ub,ub,ug,ug,ug,ug,ub,ub,ub,ug,ub,ub,ub,ub,ub,ub,ub,ub,ux,ux,ux,ux,ux
ub,ur,ug,ug,ug,ug,ub,ub,ub,ux,cb,ub,ub,ub,cb,ub,ub,ub,ux,ux,ux,ux,ux
ub,ub,ug,ux,ug,ug,ub,ub,ub,ub,ub,ub,ub,ux,ur,ug,ug,ub,ux,ux,ux,ux,ux
ub,ub,ug,ug,ug,ug,ub,ub,ug,ux,ub,ub,ux,ux,ur,ux,ug,ub,ux,ux,ux,ux,ux
ub,ub,ug,ug,ug,ug,ub,ub,ug,ug,ug,ux,ux,ux,ur,ux,ux,ub,ux,ux,ux,ux,ux
ub,ub,ug,ux,ux,ux,ux,ur,ux,ux,ux,ux,ux,ux,ur,ux,ub,ub,ux,ux,ux,ux,ux
ub,ub,ub,ub,ub,ub,ub,ub,ub,ub,ub,ub,ux,ux,cr,ux,ub,ux,ux,ux,ux,ux,cb
ub,ub,ux,ux,ux,ux,ux,ux,ux,cg,ux,ub,ub,ub,ub,ub,ub,ux,ux,ux,ux,ux,ux