ur,ur,cb,ur,ur,ur,ur,ur,ur,ur,ur,ur,cr,ur,ur,ur,ur,cb,ur,ur,ur,ur,ur
ur,ur,ur,ur,ur,ur,ur,ur,ur,ur,ur,ur,ur,ur,ur,ur,ur,ur,cr,ur,ug,cg,ur
ur,ur,ur,ur,ur,ur,ur,ur,ur,ur,ur,ur,ur,ur,ur,ur,ur,ug,ub,ug,ug,ux,ub
ur,ur,ur,ur,ur,ur,ur,ur,ur,ur,ur,ur,ur,ur,ur,ug,ur,ug,ub,cb,ug,ub,ub
ux,ur,ur,ur,ur,ur,ur,ur,ur,ur,ur,ur,cr,ug,ur,ub,ug,ug,ux,ug,ug,ub,ug
ux,ur,ur,ur,ur,ur,ur,cg,ur,ur,ur,ur,ur,ug,ur,ux,ug,ug,ug,ug,ux,ux,ug
ux,ur,ur,ur,ur,ur,cb,ug,ug,cr,ug,ub,ug,ug,ur,ub,ug,ub,ub,ug,ux,ux,ug
ux,ur,ur,ur,cr,ub,ub,ub,ur,ub,cb,ur,ur,ug,ur,ux,ug,ub,ux,ug,ux,ux,ug
ux,ux,ur,ur,ug,ug,ug,ug,ur,ub,ub,ub,ub,ug,ub,ux,ug,ux,ux,ug,ux,ux,ug
ux,ux,ux,ur,ug,ug,ug,ug,ug,cg,ub,ub,ub,ug,ub,ub,ug,ux,ux,ug,ug,ug,ug
ux,ux,ux,ur,ur,ub,ux,ug,ub,ub,ub,ub,ur,ug,ug,ug,ug,ux,ux,ug,ux,ux,ux
ux,ux,ux,ur,ur,ub,ub,ug,ug,ug,ug,ug,ug,ug,ug,ug,ug,ub,ub,ub,ub,ub,ub
cg,ur,ur,ur,ub,ub,ub,ux,ug,ug,ug,ug,ug,ug,ug,ug,ug,ub,ug,ub,ub,ub,ub
ur,ur,ub,ub,ub,ub,ug,ub,ug,ug,ug,ug,ug,ug,ug,ug,ug,cb,ux,ub,ub,ub,ub
ur,ub,ub,ub,ub,ub,ug,ub,ug,ug,ug,ug,ug,ug,ug,ug,ug,ux,ux,ug,ux,ux,ub
ub,ub,ub,ux,ux,ug,ug,ux,ug,ug,ug,ug,ug,ug,ug,ug,ug,ux,ux,ug,ux,ux,ub
ub,ub,ub,ub,ug,ug,ug,ux,ug,ug,ug,ug,ug,ug,ug,ug,ug,ur,ur,ug,ur,ur,ub
cg,ux,ux,ux,ug,ux,ug,ub,cg,ux,ux,ug,ug,ug,ug,ug,ug,ug,ux,ug,ux,ux,ub
ur,ur,ub,ub,ug,ug,ug,ub,ub,ub,ub,ub,ub,ub,ub,ub,ub,ub,ub,ub,ub,ub,ub
ur,ur,ur,ur,ur,ur,ur,ur,ur,ur,ur,ur,ur,ur,ur,ur,ur,ur,ur,ur,ur,ur,ur
ur,ur,ur,ur,ur,cr,ub,ub,ub,ub,ub,ub,ur,ur,ur,ur,ur,ur,ur,ug,ur,ur,ur
cr,ux,ux,ux,ux,ux,ux,ux,ux,ux,ub,ub,ux,ux,ux,ux,ux,ux,ux,ug,ux,cb,cr
cg,ux,ux,ux,ux,ux,ux,ux,ux,ux,ub,ub,ux,cb,ux,ux,ux,ux,ux,cg,cb,ux,cr