ub,ub,cr,ub,ur,ur,ur,ur,ur,ur,ur,ur,ur,cr,ub,ub,ub,ub,ur,ur,ur,ux,cb
ub,ux,ur,ub,ug,ug,ug,cg,ur,ur,ur,ur,ur,ur,ur,ub,cb,ub,ux,ur,ur,ux,ux
ub,cb,ur,ug,ug,ur,ur,ur,ur,ur,ur,ur,ur,ur,ur,ur,ur,ur,ur,ur,ub,ur,ur
ur,ur,ub,ur,ug,ur,ur,ub,cg,ug,ur,ur,ur,ur,ug,ux,ux,ur,ux,cr,ur,ux,ur
ur,ur,ub,ub,ug,ur,ur,ur,cr,ug,ug,ug,ur,ur,ug,ux,ux,ux,ux,ux,ur,ur,ur
ur,ub,ug,ub,ug,ub,ub,ub,ur,cr,ug,ug,ux,ug,ug,ux,ux,ux,ux,ux,ux,ur,ux
ub,ub,ug,ub,ug,ub,ug,ug,ug,ur,ur,ug,ug,ug,ug,ub,ux,ux,ux,ux,ux,ux,ux
ub,ub,ug,ub,ub,ub,ug,ug,ug,ub,ub,ug,ug,ug,ux,ub,ux,ux,ux,ux,ux,ux,ux
cg,ub,ug,ub,ub,ug,ub,ub,ub,ub,ub,cb,ub,ub,ub,ub,ub,ux,ux,ux,ux,ux,ux
ur,ur,ug,ug,ug,ug,ug,ub,ug,ub,ub,ub,ub,ub,ub,ub,ub,ug,ug,ur,ur,ur,ur
ur,ux,ux,ug,ug,ux,ux,ub,cb,ub,ub,ug,ug,ug,ug,ug,ug,ug,ub,ux,ux,ux,ur
ur,ux,ux,ug,ug,ux,ux,ub,ub,ub,ub,ub,ug,ug,ug,ug,ug,ug,ub,ux,ux,ux,ur
ur,ux,ux,ug,ug,ux,ux,ux,ux,ux,ub,ub,ug,ub,cg,ug,ug,ug,ub,ux,ux,ux,ur
ur,ux,ux,ug,ug,ux,ux,ux,ux,ux,ub,ub,ub,ug,ug,ug,ux,ug,ux,ux,ux,ux,ur
ur,ux,ux,ug,ug,ux,ux,ux,ux,ux,ux,ub,ub,ug,ug,ug,ug,ug,ux,ux,ux,ux,ur
ur,ux,ux,ug,ug,ur,ur,ur,ur,ur,ub,ub,ub,ub,ub,ub,ug,ug,ur,ur,ur,ur,ur
ur,ux,ux,ug,ug,ur,ux,ux,cb,ub,ub,ub,ug,ug,ug,cr,ur,ur,ur,ur,ur,ur,ur
ur,ux,ux,ug,ug,ur,ux,ux,ub,ub,ug,ub,ub,ub,ub,ub,ug,ux,ux,ux,ux,ux,ur
ux,ux,ux,ug,ug,ur,ug,ug,ug,ug,ux,ux,ub,ub,ug,ug,ug,ux,ux,ux,ux,ux,ur
ux,ux,ux,ux,ug,ur,ug,ug,ux,ux,ux,ux,ux,ux,ux,ux,ux,ux,ux,ux,ux,ux,ur
ux,ux,ux,ux,ux,ur,ux,ux,ux,ux,ux,ux,ux,ux,ux,ux,ux,ux,ux,ux,ux,ux,ur
ux,ux,ux,ux,ux,ur,ux,ux,ux,ux,ux,ux,ux,ux,ux,ux,ux,ux,ux,ux,ux,ux,ur
ux,ux,ux,ux,ux,ur,ur,ur,ur,ur,ur,ur,ur,ur,ur,ur,ur,ur,ur,ur,ur,ur,ur