ur,ur,ur,ur,ur,ur,ur,ur,ur,ur,cb,ub,ub,ub,ub,ub,ub,ub,ub,ub,ub,ub,ub
ur,ur,ur,ur,ur,ur,ur,ur,ur,ur,ur,ur,ur,ur,ur,ur,ur,ur,ur,ur,ur,ur,ub
ur,ur,ur,ug,ug,ug,ur,ur,ur,ur,ur,ur,ur,ur,ur,ur,ur,ur,ur,ur,ur,ur,ub
ur,ur,ur,ug,ug,ug,ur,cr,ur,ur,ur,ur,ur,ur,ur,ur,ur,ur,ur,cr,ur,ur,ub
ur,ur,ur,ur,ug,cr,cb,ur,ur,ur,ur,ur,ur,ur,ur,ur,ur,ur,cb,ub,ur,ur,ub
ur,ur,ur,ur,ug,cg,ub,ur,ur,ur,ur,cr,ur,ur,cg,ur,ur,ur,ug,ug,ur,ur,ub
ug,ux,ux,ur,ur,ug,ub,ub,ub,ug,ug,ub,ur,ur,ug,cr,ug,ug,ug,ug,ur,ur,ub
ug,ug,ug,ug,ug,ug,ub,ug,ub,ub,ub,ub,ub,ug,ug,ug,ug,ug,ur,ur,ur,ur,ub
cg,ux,ux,ux,ug,ub,ub,ug,ub,ug,ub,ub,ub,ug,ug,ug,ug,ug,ux,ux,ug,ux,ub
ux,ux,ux,ub,ub,ub,cg,ug,ub,ub,ub,ub,ub,ub,ug,ub,ub,ux,ux,ux,ug,ux,ub
ux,ux,ux,ug,ux,ug,ux,ux,ug,ub,ub,ub,cb,ub,ub,ub,ub,ux,ux,ux,ug,ux,ub
ux,ux,ug,ug,ux,ug,ux,ux,ug,ux,ux,ub,ub,ux,ux,ug,ub,ux,cb,ux,ug,ux,ub
ux,ux,ug,ux,ux,ug,ux,ux,ug,ux,ux,ux,ug,ux,ug,ug,ub,ux,ub,ux,ug,ux,ub
ux,ux,ug,ug,ux,ug,ux,ux,ug,ux,ux,ux,ug,ux,ux,ux,ub,ub,ub,ux,ug,ux,ub
cg,ub,ux,ug,ux,ug,ux,ux,ug,ux,ux,ux,ug,ux,ux,ux,ub,ub,ux,ux,ug,ux,ub
cb,ub,ub,ug,ux,ug,ux,ux,ug,ux,ux,ux,ug,ux,ux,ux,ub,ub,ux,ux,ug,ux,ub
ub,ub,ub,ug,ug,ug,ux,ux,ug,ux,ux,ux,ug,ug,ux,ux,ub,ub,ux,ux,ug,ux,ub
ub,ub,ub,ub,ub,ub,ub,ub,ub,ub,ub,ub,ub,ub,ub,ub,ub,ub,ub,ub,ub,ub,ub
ub,ub,ux,ux,ug,ug,ux,ux,ug,ug,ug,ug,ug,ug,ux,ux,ux,ug,ug,ug,ug,ux,ur
ub,ub,ux,ux,ux,ux,ux,ub,ub,ug,ug,ug,ug,ug,ug,ug,ug,ug,ub,ub,ux,ux,ur
ur,ur,ur,ur,ur,ur,ur,ur,ur,ur,ur,ur,ur,ur,ur,ur,ur,ur,ur,ur,ur,ur,ur
ur,ub,ub,ux,ux,ux,ux,ux,ur,ur,ur,ur,ur,ur,ur,ur,ur,ur,ur,ur,ur,ur,cb
ur,ur,ur,ur,ur,ur,ur,ur,ur,cg,ux,cr,ur,ur,ur,ur,ur,ur,ur,ur,ur,ur,ur