ur,ur,ur,ur,ur,ur,ur,ur,ur,ur,ur,ur,ur,ur,ur,ub,cr,ur,ur,ur,ur,ur,ur
ur,ur,ur,cb,ub,ur,ur,ur,ur,ur,ur,ur,ur,ur,ur,ur,ub,ub,ur,ur,ur,ur,ur
ur,ur,cr,ub,ub,ur,ux,ux,ux,ur,ur,ur,ur,ur,ur,ur,ur,cb,ub,ux,ux,ur,ur
ur,ur,ur,ur,ur,ur,ur,ur,ur,ur,ur,ur,ur,ur,ur,ur,ur,ur,ug,ux,ux,ur,ur
ur,ur,ur,ur,ur,ux,ur,ur,ur,ur,ur,ur,ur,ur,ur,ux,ux,ux,ug,ux,ux,ur,ur
ur,ur,ur,ur,ur,ur,ur,ur,ur,ur,ur,ub,ug,ux,ux,ux,ux,ux,ug,ux,ux,ur,ur
ur,ur,ur,ur,ur,ur,ur,ur,ur,ur,ur,cr,ug,ux,ux,ux,ux,ux,ug,ux,ux,ur,ur
ur,ur,ur,ur,ur,ur,ur,ur,ur,ur,ur,ur,ug,ub,ux,ux,ux,ux,ug,ux,ux,ur,ur
ur,ur,ur,ur,ur,ur,ur,cg,ug,cr,ug,ub,ug,ub,ub,ux,ux,ux,ug,ux,ux,ur,ur
ur,ur,ur,ur,ur,ur,ur,ur,ur,ur,ug,ub,ug,ub,ub,ub,ux,ux,ug,ux,ux,ur,ur
cg,ur,ur,ur,ur,ur,ur,ur,ur,ur,ug,ub,ub,ub,ub,ub,ux,ux,ug,ux,ux,ur,ur
ur,ur,ur,ur,ur,ur,ur,ug,ug,ub,ub,ub,ub,ub,ux,ux,ux,ux,ug,ux,cr,ur,ur
ur,ur,cr,ur,ur,ur,ur,ub,ub,ug,ug,ub,ub,ub,ux,ux,ux,ux,ug,ux,ur,ux,ux
ur,ur,ug,ur,ur,ur,ur,ur,ug,ux,ux,cb,cb,ux,ux,ux,ux,ux,ug,ux,ur,ux,ux
ur,ur,ug,ur,ug,ur,ur,ur,ug,ug,ug,ug,ub,ub,ux,ux,ux,ux,ux,ux,ur,ux,ux
ux,ur,ug,ux,ur,ux,ux,ux,ur,ux,ux,ux,ux,ux,ux,ux,ux,ux,ux,ux,ur,ux,ux
ub,cb,cg,ux,ur,ux,ux,ux,ur,ux,ux,ux,ux,ux,ux,ux,ux,ux,ux,ux,ur,ux,ur
ub,ur,ub,ub,ub,ub,ub,ub,ub,ub,ub,ub,ub,ub,ub,ub,ub,ub,ub,ub,ub,ub,ub
ub,ur,ub,ur,ub,ub,ub,ub,ub,ub,ub,ub,ub,ub,ub,ub,ub,ub,ub,ux,ur,ur,ub
ub,ux,ub,ux,ux,ux,ux,ux,ur,ux,ux,ux,ux,ux,ux,ux,ux,ux,ub,ub,ur,ur,ub
ub,ux,ub,ux,ux,ux,ux,ux,ur,ux,ux,ux,ux,ux,ux,ux,ux,ux,ux,ub,ub,ub,ub
ub,ub,ub,ux,ur,ur,ur,ur,ur,ur,ur,ur,ur,ur,ur,ur,ur,ur,ur,ur,ur,ur,ur
ub,ub,ux,ux,ux,ux,ux,cg,ur,ur,ur,ur,ur,ur,ur,ur,ur,ur,ur,ur,ur,cb,ur