ur,ur,ur,cr,ur,ux,ux,ux,ux,ux,ux,ux,ux,ux,ux,ux,ux,ux,ux,ur,ur,ur,ur
ur,ur,ur,ur,ur,ux,ux,ux,ux,ux,ur,ur,ur,ur,ur,ur,ur,ur,ur,ur,ur,ur,ur
ur,ur,ur,ur,ur,ub,ub,ub,ub,ub,ub,ub,ub,ub,cb,ur,ur,ur,ur,ur,ur,ur,ur
ur,ur,ur,ur,ur,ur,ur,ur,ur,ur,ur,ur,ur,ur,ur,ur,ur,ur,ur,ur,ur,ur,ur
ur,ur,ur,ur,ug,ur,ur,ur,ur,ur,ur,ur,ub,ur,ug,ug,cr,ur,ur,ur,ur,ur,ur
ur,ur,ur,ub,ug,ur,ur,ur,ur,ur,cb,ub,ur,ur,ug,ur,ur,ur,ur,ur,ur,ur,ur
ur,ux,ug,ug,ug,ug,ur,ug,cr,ur,cr,ub,ub,ur,cg,ur,ur,ur,ur,ur,ur,ur,ur
ur,ur,ug,ug,ug,ug,ur,ug,ur,ur,ur,ub,ub,ur,ub,ur,ur,ur,ur,ur,ur,ur,ur
ux,ux,ug,ug,ur,ug,ur,ug,ur,ur,ur,ub,ub,ur,ur,ur,ur,ur,ur,ur,ur,ur,ur
ux,ux,ug,ug,ux,ug,ur,ug,ug,ug,ur,ur,ur,ur,ur,ur,ur,ur,ur,ur,ur,ur,ur
ux,ux,ug,ug,ux,ug,ux,ug,ug,ux,ub,cb,ur,ur,ur,ur,ur,ug,ux,ux,ur,ur,ur
ux,ux,ug,ug,ur,ug,ur,ug,ug,ur,ub,ub,ur,ur,ur,ur,ur,ur,ur,ur,ur,ur,ur
ur,ur,ug,ug,ug,ug,ur,ug,ug,ux,ug,ug,ur,ur,ur,ur,ug,ug,ub,ub,ux,ur,ur
ur,ur,ug,ub,ug,ug,ug,ug,ug,ug,ug,ub,ur,ur,ur,ur,ug,ug,ug,ub,ub,ur,ur
ur,ur,ug,ub,ug,ug,ug,ug,ug,ug,ux,ux,ur,ur,cr,ur,ug,ug,ug,ub,ub,ur,ur
ub,ub,cg,ub,ub,ub,ug,ug,ug,ug,ug,ug,ur,ux,ug,ur,cr,ug,ug,ug,ub,ur,ur
ub,ux,ux,ug,ux,ux,ug,ug,ug,ug,ux,ug,ug,ug,ug,ug,cg,ug,ug,ug,ux,ur,ur
ub,ux,ux,ug,ux,ux,ux,ug,ug,ug,ug,ux,ur,ux,ux,ub,ub,ub,ub,ub,ux,ur,ur
ub,ux,cb,ub,ub,ub,ub,ub,ub,ub,ub,ug,ur,ub,ub,ub,ux,ub,ub,ub,ub,ur,ur
ub,ux,ux,ub,ub,ub,ub,ub,ub,ub,ub,ux,ur,ub,ub,ub,ub,ub,ux,ub,ub,ur,ur
ub,ux,ux,ux,ug,ub,ub,ub,ub,ub,ub,ub,ub,ub,ub,ur,ur,ur,ur,ur,ur,ur,ur
ub,ub,ub,ub,ub,ub,ub,ub,ub,ur,ur,ur,ur,ur,ur,ur,ub,ur,ur,ur,ur,ur,ur
cb,ux,ux,ux,ux,ux,ux,ux,ub,ub,ub,ub,ub,ub,ub,ub,ub,ux,ux,ux,ux,cb,ur