cb,cb,cb,cr,ur,ur,ur,ur,ur,ur,ur,ur,ur,ur,ur,ur,ur,ur,cr,ub,cb,ur,cb
ur,ur,ur,ur,ur,ur,ur,ur,ur,ur,ur,ur,ur,ur,ur,ur,ur,ur,ur,ub,cg,ug,cg
ur,ur,ur,ur,ur,ur,ur,ur,ur,ur,ur,ur,ur,ur,ur,ur,ur,ur,ur,ur,cr,ug,ug
ur,ur,ur,cg,ug,ur,ur,cr,ug,ur,ur,ur,ur,ur,ur,ur,ur,ur,ug,ur,ur,ub,ug
ur,ur,ur,ur,ug,ug,ug,ug,ug,ug,ug,cr,ur,ur,ur,ur,ug,ug,ug,ug,ug,ug,ug
ur,ur,ur,ub,ub,ug,ub,ug,ux,ux,cb,ub,ub,ug,ur,ur,ug,ug,ug,ug,ug,ug,ug
ur,ur,ur,ub,ub,ub,ub,ub,ub,ux,ub,ub,ug,ug,ur,ug,ug,ux,ug,ug,ug,ug,ug
cb,cr,ur,cb,ug,ux,ux,ub,ub,cb,ub,ub,ug,ug,ug,ug,ux,ux,ug,ug,ug,ug,ug
ug,ug,ug,ug,ug,ug,ug,ug,ub,ub,ub,ub,ub,cg,ug,ug,ux,ug,ug,ug,ug,ug,ug
ug,ug,ug,ug,ux,ux,ux,ux,ug,ub,ub,ub,ub,ug,ug,ux,ux,ug,ug,ug,ub,ub,ug
ug,ug,ug,ug,ux,ux,ux,ux,ug,ub,ug,ub,ug,ug,ug,ug,ug,ub,ub,ub,ub,ub,ug
ug,ug,ug,ug,ux,ux,ug,cg,ug,ug,ug,ug,ug,ug,ug,ux,ug,ub,ub,ub,ub,ub,ug
cb,ux,ux,ug,ux,ux,ug,ux,ug,ug,ug,ug,ub,ub,ub,ub,ug,ug,ux,ux,ux,ub,ug
ug,ug,ug,ug,ux,ux,ug,ug,ug,ug,ug,ug,ug,ub,ug,ub,ub,ub,ub,ub,ub,ub,ug
ug,ug,ux,ux,ug,ug,ug,ug,ug,ug,ug,ub,ug,ug,ug,ug,ug,ug,ug,ug,ug,ug,ug
ux,ug,ux,ux,ug,ux,ux,ub,ub,ub,ub,ub,ub,ug,ux,ux,ug,ux,ux,ux,ux,ux,ug
ux,ug,ug,ug,ug,ux,ub,ub,ur,ur,ur,ub,ub,ub,ub,ub,ub,ub,ur,ur,ur,ur,ug
cr,ux,ug,ug,ux,ux,ub,ux,ux,ux,ux,ub,ub,ub,ub,ub,ub,ub,ux,ux,ux,ux,ug
cg,ux,ug,ug,ux,ux,cb,ux,ux,ux,ux,ux,ux,ug,ug,ug,ug,ug,ug,ug,ug,ug,ug
cb,ur,ur,ur,ur,ur,ur,ur,ur,ur,ur,ur,ur,ur,ur,ur,ur,ur,ur,ur,ur,ur,ur
ux,ur,ux,ux,ux,ux,ux,ux,ux,ux,ux,ux,ux,ux,ux,ux,ux,ux,ux,ux,ux,ux,cr
cr,ur,ur,ur,ur,ur,ur,ur,ur,ur,ur,ur,ur,ur,ur,ur,ur,cb,cg,ux,cb,ux,cr
cg,cb,cg,cb,ux,ux,ux,ux,ux,ux,ux,ux,ux,ux,ux,cg,ur,ur,cr,cg,cg,ux,cr