ur,ur,ur,ur,ur,ur,ur,ur,ur,ur,ur,ur,ur,ur,ur,ur,ux,cb,ux,ux,ux,ur,ur
ur,ur,ur,ur,ur,ur,ur,ur,ur,ur,ur,ur,ur,ux,ux,ur,ur,ur,ur,ur,ur,ur,ur
ur,ur,cr,ur,ur,ur,ur,ur,ur,ur,cb,ub,ub,cr,ur,ur,ur,ur,ur,ur,ur,ur,ur
ur,ur,ur,ur,cg,ur,ur,ur,ub,ub,ub,ub,ug,ug,ug,ug,ug,ug,cg,ur,ur,ur,ur
ur,ur,ur,ug,ug,ur,ur,ur,ub,ur,ug,ub,ub,ur,ug,ug,ux,ux,ux,ux,ux,ux,ux
ur,cr,ur,cr,ur,ur,ur,ur,ub,ug,ug,ub,ub,cb,ux,ug,ux,ux,ux,ux,ux,ux,ux
ub,ur,ur,ur,ur,ur,ur,ur,ub,ug,ur,ug,ug,ug,ug,ug,ux,ux,ux,ux,ux,ux,ux
ub,cb,ur,ur,ux,ux,ub,ub,ub,ub,ub,ux,ux,ug,ug,ux,ux,ux,ux,ux,ux,ux,ux
ur,ur,ur,ub,ub,ub,ub,ub,ub,ub,ub,ug,ux,ug,ug,cr,ux,ux,ux,ux,ux,ux,ux
ur,ur,cr,ub,cb,ub,ub,ub,ub,ub,ub,ug,ux,ug,ug,ur,ux,ux,ux,ux,ux,ux,ux
ub,ub,ub,ub,ub,ub,ub,ub,ub,ub,ug,ug,ux,ug,ug,ur,ug,ug,ub,ub,ux,ux,ux
ug,ug,ug,ug,ug,ug,ub,ub,ub,ub,ug,ug,ub,ug,ub,ur,ug,ub,ub,ub,ub,ur,ux
ug,ug,ug,ug,ug,ug,ug,ug,ug,ug,ug,ug,ug,ug,ug,ur,ug,ub,ub,ub,ub,ug,cg
ux,ug,ux,ug,ux,ux,ux,ux,ug,ug,ug,ug,ug,ug,cg,ur,ub,ub,ub,ug,ux,ur,ur
ux,ug,ux,ug,ux,ux,ux,ux,ug,ug,ug,ug,ug,ug,ug,ur,ub,ur,ur,ur,ur,ur,ur
ux,ug,ux,ug,ux,ux,ux,ux,ug,ug,ug,ug,ug,ug,ug,ur,ub,ub,ub,ub,ux,ur,ur
ux,ug,ux,ug,ux,ux,ux,ux,ug,ug,ug,ug,ug,ug,ug,ur,ub,ub,ub,ux,ux,ur,ur
cg,ug,ux,ug,ux,ux,ux,ux,ug,ug,ug,ug,ub,ub,ux,ur,ub,ub,ub,ux,ux,ur,ur
ux,ug,ux,cg,ux,ux,ux,ux,ug,ug,ug,ug,ub,ub,ux,ur,ub,ux,ux,ux,ux,ur,ur
ur,ug,ur,ur,ur,ur,ur,ur,ur,ur,ug,ug,ub,ub,ub,ub,ub,ur,ur,ur,ur,ur,ur
ur,ug,ur,ur,ur,ur,ur,ur,ur,ug,ug,cb,ub,ur,ur,ur,ur,ur,ur,ur,ur,ur,ur
cr,ug,ux,ux,ux,ux,ux,ux,ux,ux,ux,ug,ux,ux,ux,ux,ux,ux,ux,ux,ux,cb,cr
cg,ug,ug,ug,ug,ug,ug,ug,ug,ug,ug,ug,ux,cb,ux,ux,ux,ux,ux,cg,cb,ux,cr