ux,cb,cb,cr,ux,ur,ur,ur,ur,ur,ur,ur,ur,ur,ur,ur,ur,ur,ug,ur,ur,ux,cb
ux,cb,cb,ux,ux,ur,ur,ur,ur,ur,ur,ur,ur,ur,ur,ur,ur,ur,ug,ug,ur,ur,ur
ux,ux,ux,ur,ur,ur,ur,ur,ur,ur,ur,ur,ur,ur,ur,ur,ur,ur,ug,ug,ur,ur,ur
ur,ur,ur,ur,ur,ur,ur,ur,ur,ur,ur,ur,ur,ur,ur,ur,ur,ur,ug,ug,ur,ur,ur
ur,cb,ub,ur,ur,ur,ur,ur,ur,ur,ur,ur,ur,ur,ur,ur,ur,ur,ug,ug,ug,ug,ur
ur,ur,cr,ur,ur,ur,ur,ur,ur,ur,ur,ur,cg,ug,ug,ur,ur,ur,ug,ug,ug,ug,ug
ur,ur,ur,ur,ur,ur,ur,ur,ur,cr,ur,ur,ur,ur,cr,ur,ur,ub,ub,ug,ug,ug,ug
cb,ur,ur,ur,ur,ur,ur,cr,ur,ur,cg,ur,ur,ur,ur,ur,ur,ub,ub,ub,ub,ub,ug
ur,ur,ur,ur,ur,ur,ur,ug,ur,ur,ug,ug,ug,cr,ur,cb,ub,ub,ub,ub,ug,ub,ug
ur,cb,ub,ub,ub,ub,cg,ug,ub,ux,ug,ug,ug,ug,ug,ug,ug,ug,ug,ug,ug,ub,ug
ux,ux,ux,ug,ug,ux,ux,ux,ux,ux,ug,ug,ug,ug,ug,ub,cb,ug,ur,ub,ug,ub,ug
ux,ux,ux,ug,ug,ug,ux,ux,ux,ux,ub,ub,ub,ub,ug,ub,ug,ub,ug,ug,ub,ub,ug
cb,ux,ux,ug,ux,ux,ux,ux,ux,ux,ub,ub,ub,ub,ub,ub,ug,ug,ug,ug,ug,ub,ug
ux,ux,ux,ug,ux,ux,ux,ux,ux,ux,ub,ub,ub,ub,ug,ug,ug,ug,ug,ug,ug,ub,ug
ug,ug,ux,ug,ug,ug,ux,ux,ux,ux,ub,cg,ug,ug,ug,ug,ux,ug,ug,ug,ub,ub,ug
ug,ug,ug,ug,ug,ug,ug,ug,ux,ux,ux,ux,ux,ub,ub,ub,ug,ug,ug,ug,ug,ub,cg
ug,ug,ug,ug,ug,ug,ug,ug,ux,ux,ux,ux,ux,ux,ux,ux,ux,ug,ux,ug,ug,ux,cb
ug,ug,ug,ug,ug,ug,ug,ug,ux,cg,ux,ux,ux,ux,ux,ux,ux,ug,ux,ug,ug,ux,ux
ur,ur,ur,ur,ur,ug,ug,ug,ug,ug,ur,ur,ur,ur,ur,ur,ur,ur,ur,ur,ug,ux,ux
ur,ur,ur,ur,ur,ur,ur,ur,cr,ug,ug,ux,ux,ux,ux,ux,ux,ug,ug,ug,ug,ux,ux
cr,ug,ug,ug,ug,ug,ug,ug,ug,ug,ug,ux,ux,ux,ux,ux,ux,ux,ux,ux,ux,ux,cr
cg,ux,ux,ux,ux,ug,ug,ug,ug,ug,ux,ux,ux,ux,ux,ux,ux,ux,ux,cb,cb,ux,cr
cr,cg,cg,cb,ux,ux,ux,ux,ux,ux,ux,ux,ux,ux,ux,cg,ux,ux,ux,cg,cg,ux,cr