ug,ug,ug,ug,ug,ug,ug,ur,ur,ur,ur,ur,ur,ur,ur,ur,ur,cr,ur,ub,ux,ux,ux
ug,ur,ur,ur,ur,ur,cg,ur,ur,ur,ur,ur,ur,ur,ur,ur,ur,ub,cb,ub,ux,ux,ux
cr,ur,ur,ur,ur,ur,ur,ur,ur,ur,ur,ur,ur,ur,ur,ur,ur,ux,ux,ub,ux,ux,ux
ur,ur,ur,ur,ur,ur,ur,ur,ur,ur,ur,ur,ur,ur,ur,ur,ur,ur,ux,ub,ub,ux,ux
ur,ur,ur,ur,ur,ur,ur,ur,ur,ur,ur,ur,ur,ur,cg,ug,ug,ur,ux,ub,ub,ub,ux
ur,ur,ur,ur,ur,ur,ur,ur,ur,ur,cb,ub,ur,ur,ur,ur,ug,ur,ur,ur,ur,ur,ux
ur,ur,ur,ur,ug,ug,ur,ur,ur,ur,ur,ub,ur,ur,cr,ug,ug,ur,ux,ux,ux,ux,ux
ur,ur,ur,ur,ug,ug,ur,ur,ur,ur,ub,ub,ur,ug,ug,ug,ug,ur,ur,ux,ux,ux,cb
cg,ur,ur,cg,ur,ur,ur,ur,ur,ur,ur,ur,ur,ug,ug,ug,ug,ur,ur,ux,ux,ux,ux
ur,ur,ur,ug,ug,ug,ur,ur,ur,ur,ub,ur,ug,ug,ug,ug,ur,ur,ur,ux,ux,ux,ux
ur,ur,ur,ug,ug,cr,ur,ur,ur,ur,ub,cr,ub,ub,ux,ux,ux,ux,ur,ux,ux,ux,ux
ur,ur,ur,ur,ur,ur,ur,ur,ur,ur,ub,ub,ub,ub,ug,ug,ug,ug,ux,ux,ux,ux,ux
ur,ur,ur,ur,ur,ur,cr,ur,ub,ur,ug,ub,ub,ub,ug,ug,ug,ug,ux,ux,ux,ux,ux
ux,ux,ub,ux,ux,ug,ub,ub,ub,ur,ub,ub,ub,ug,ug,ug,ug,ug,ux,ux,ux,ux,ux
cg,ux,ub,ux,ux,ux,ub,ub,ub,ur,ub,ug,ug,ug,ug,ug,ug,ux,ux,ux,ux,ux,ux
ux,ux,ub,ux,ux,ux,ub,ub,ub,ub,ub,ub,ug,ug,ug,ug,ug,ux,ux,ux,ur,ur,ur
ux,ux,ub,ux,ub,ub,ub,ub,ub,ub,ub,cb,ux,ug,ug,ug,ur,ur,ur,ur,ur,ux,ur
ux,ux,ub,ux,ux,ux,ub,ub,ub,ub,ub,ub,ux,ug,ug,ug,ux,ux,ux,ux,ur,ux,ur
ux,ux,ub,ux,ux,ux,ub,ub,ux,cb,ux,ub,ub,ub,ux,ur,ux,ux,ux,ux,ur,ux,ur
ux,ux,ub,ux,ux,ux,ux,ub,ub,ur,ux,ux,ux,ux,ux,ur,ux,ux,ux,ux,ur,ux,ur
ur,ur,ub,ur,ur,ur,ur,ur,ur,ur,ur,ur,ur,ur,ur,ur,ux,ux,ux,ux,ur,ux,ur
ur,ux,ub,ub,cb,ux,ux,ux,ur,ux,ux,ux,ux,ux,ux,ur,ur,ur,ur,ur,ur,ux,ur
ur,ur,ur,ur,ur,ur,ur,ur,ur,cg,ux,ux,ux,ux,ux,ur,ur,ur,ur,ur,ur,ur,ur