ur,ur,ur,ur,ur,ur,ur,ur,ur,ur,ub,ub,cr,ur,cb,cr,ur,cb,ur,ur,ur,ur,ur
cg,cr,ur,ur,ur,cr,ub,ub,cb,ur,ur,ur,ur,ur,ub,ur,ur,ur,ur,ur,ur,ur,cr
ug,ur,ug,ug,ug,cg,ur,ur,ug,ur,ur,ur,ur,ur,ub,ur,ur,ur,ur,ur,ur,cb,ub
ug,ur,ug,ug,ug,ur,ur,ug,ug,ur,ur,ur,ur,ur,ub,ub,ur,ur,ur,ur,ur,ur,ur
ug,ug,ug,ug,ug,ug,ug,ug,ug,ur,ur,ur,ur,ur,cg,ub,ur,ur,ur,ur,ur,ug,ur
ub,ub,ub,ug,ug,ug,ug,ur,ug,ug,ug,ub,ub,ur,ug,ug,ug,ug,ur,ur,ub,ug,ur
ug,ux,ux,ug,ug,ug,ug,ur,ug,ur,ug,ub,ub,ur,cb,ub,ub,ub,ub,ug,ug,ug,ur
ug,ug,ug,ug,ub,ub,ub,ub,ug,ur,ug,ug,ug,ur,ur,ub,ub,ur,ub,ur,ur,ur,ur
ux,ux,ux,ux,ug,ug,ux,ux,ug,ug,ug,ug,ug,ug,ub,ub,ub,ub,ub,ub,ub,ub,ub
ux,ux,ux,ux,ug,ug,ug,ug,ug,ug,ug,ub,ug,ug,ub,ub,ub,ub,ub,ub,cb,ub,ub
ux,ux,ux,ug,ug,ug,ug,ug,ug,ug,ug,ug,ug,ug,ub,ub,ub,ub,ub,ub,ub,ub,cr
ux,ux,ux,ug,ug,ub,ub,ux,ux,ux,ug,ug,ux,ug,ux,ux,ux,ub,ub,ub,ub,ub,ur
cg,ux,ux,ux,ug,ug,ug,ux,ux,ux,ug,ug,ux,ug,ux,ug,ug,ub,ux,ub,ub,ub,ur
ux,ux,ub,ub,ub,ug,ug,ux,ux,ux,ug,ug,ux,ug,ux,ug,ux,ub,ux,ub,ub,ub,ur
ux,ux,ub,ug,ug,ug,ug,ux,ug,ug,ug,ug,ug,ug,ug,ug,ux,ub,ux,ux,ux,ux,ur
ux,ux,ub,ug,ux,ux,ug,ux,ug,ug,ug,ug,ug,ub,ub,ub,ub,ub,ux,ux,ux,ux,ur
ux,ub,ub,ug,ux,ux,ux,ux,ug,ux,ux,ux,ug,ux,ux,ux,ux,ux,ux,ux,ux,ux,ur
cg,ux,ux,ug,ux,ux,ux,ux,ug,ug,ug,ug,ug,ux,ux,ux,ux,ux,ux,ux,ux,ux,ur
ux,ux,ux,ug,ux,ux,ux,ux,ug,ug,ug,ug,ug,ug,cg,ux,ux,ub,ub,ub,ub,ub,ur
ur,ur,ur,ug,ur,ur,ur,ur,ug,ug,ug,ug,ug,ug,ug,ur,ur,ur,ux,ux,ux,ux,ur
ur,ur,ur,ug,ug,ug,ug,ug,ug,ug,ug,ug,ug,ug,ug,ux,ux,ux,ux,ux,ur,ur,ur
cr,ur,ur,ur,ur,ur,ur,ur,ur,ur,ur,ur,ur,ur,ur,ur,ur,ur,ur,ur,ur,cb,cr
cg,ur,ur,ur,ur,ur,ur,ur,ur,ur,ur,ur,ur,cb,ux,ux,ux,ux,ux,cg,cb,ux,cr