ur,cb,cb,cr,ur,ur,ur,ur,ur,ub,ub,cb,ur,ur,ug,ug,ug,ug,ug,ug,ug,ur,cb
ur,ur,cb,ur,ur,ur,ur,ur,ur,ub,ur,ur,ur,ug,ug,ub,ub,ub,ur,ur,ug,ur,ux
ur,ur,ur,ur,ur,ur,ur,ur,ur,ub,cr,ur,ur,ug,ub,ug,ug,ug,ug,ug,ug,ur,ux
ur,ur,ur,ur,ur,ur,ur,ur,ur,ur,ur,ur,ur,cg,ux,ur,ur,ur,ur,ur,ur,ur,ux
ur,ur,ur,ur,ur,ur,ur,ur,ur,ur,ur,ur,ur,ur,ur,ur,ur,ur,ur,ur,ur,ur,ur
ur,ur,ur,ur,ur,ur,ur,ug,ur,ur,ur,ur,ur,ur,ug,ug,ug,ug,ug,ug,ur,ur,ur
ur,ur,ur,ur,ur,ur,ug,ug,ur,ur,ur,ur,ur,cr,ug,ug,ug,ug,ug,ug,ug,ur,ur
cb,cr,ur,ur,ur,ur,ur,ur,ur,ur,cg,ur,ur,ur,ug,ug,ug,ug,ug,ug,ug,ur,ur
cb,cb,ub,ur,ur,ur,ur,ur,ur,ur,ug,ug,ug,cb,ub,ug,ug,ux,ug,ug,ug,ug,ux
ub,cr,ur,ur,ur,ur,ur,ur,ur,ur,ur,ur,ur,ur,ub,ub,ug,ug,ug,ug,ug,ug,ux
ub,ur,ur,cr,ur,ux,ux,ug,ux,ux,ub,ug,ug,ur,ub,ug,ug,ug,ug,ug,cg,ug,ux
ux,ub,ub,ux,ur,ug,ug,ug,ux,ux,ug,ug,ux,ur,cg,ug,ux,ug,ug,ug,ux,ug,ux
cb,ub,ub,ux,ur,ug,ug,ug,ug,ub,ug,ug,ub,ur,ug,ug,ux,ug,ug,ug,ux,ug,ux
ub,ub,ub,ug,ur,ug,ug,ug,ug,ux,ub,ub,ub,ur,ug,ug,ug,ug,ug,ug,ux,ug,ux
ub,ub,ug,ug,ur,ug,ug,ux,ux,ux,ux,ux,ub,cr,ug,ug,ug,ug,ug,ug,ux,ug,ux
ux,ux,ug,ug,ur,ug,ug,ux,ux,ux,ux,ub,ug,ug,ug,ug,ug,ug,ug,ug,ux,ug,ux
ux,ux,ug,ug,ug,cg,ug,ug,ug,ux,ub,ug,ug,ug,ug,ug,ux,ux,ux,ug,ux,ug,ux
ur,ug,ug,ug,ur,ug,ug,ug,ug,ug,ug,ug,ug,ug,ug,ur,ur,ur,ur,ur,ur,ur,ur
ur,ug,ug,ug,ug,ug,ug,cb,ub,ux,ux,ux,ug,ug,ug,ug,ug,ux,ux,ug,ux,ug,ur
cr,cg,ug,ug,ug,ug,ug,ub,ub,ub,ub,ub,ub,ub,ub,ub,ub,ub,ub,ub,ub,ub,cb
cg,ub,ub,ub,ub,ub,ub,ub,ub,ub,ug,ux,ug,ug,ug,ug,ug,ux,ug,ug,ug,ug,cr
cr,ub,ub,ub,ub,ub,ub,ug,ug,ug,ug,ur,ug,ur,ux,ux,ux,ub,ub,cb,cb,ug,cr
cg,ur,cg,cb,ux,ug,ug,ug,ux,ux,ug,ug,ug,ur,ur,cg,ux,ux,ux,cg,cg,ug,cr