ur,ur,ur,ur,ur,ur,ur,ur,ur,ur,ur,ur,ur,ur,ur,ur,ur,ur,ur,ur,ur,ur,cb
ur,ur,ur,ur,ur,ur,ur,ur,ur,ur,ur,ur,ur,ur,ur,ur,ur,ur,ur,ur,ur,ur,ur
ur,ur,ur,ur,ur,ur,ur,ur,ur,ur,ur,ur,ur,ug,ug,ug,ug,ur,ur,ur,cr,ur,ur
ur,ur,ur,ug,cr,ur,ug,cr,ur,ug,ur,cg,ub,ug,ur,ur,ug,cr,ub,ur,ur,ug,ur
ur,ur,ur,ug,ub,ur,ur,ub,cr,ug,ug,ug,ub,cg,ub,ug,ug,ur,ur,ur,ur,ur,ur
ur,ur,ur,ug,ug,ug,ug,ug,ur,ur,ur,ur,ub,ug,ux,ug,ug,ug,ug,ug,ug,ug,ux
ux,ux,ur,ug,ux,ug,ug,ug,ur,ur,ug,cb,ub,ub,ub,ug,ug,ug,ug,ux,ug,ux,ux
ux,ux,ur,ub,ug,ug,ux,ux,ub,ug,ug,ub,ub,ub,ux,ug,ug,ug,ug,ug,ug,ux,ux
cg,ux,ux,ub,ug,ug,ug,ug,ub,ug,ub,ub,ug,ub,ub,ug,ug,ug,ux,ug,ug,ux,ux
ux,cb,ux,ub,ug,ug,ug,ug,ur,ug,ux,ub,ug,ug,ug,ug,ux,ux,ug,ug,ug,ux,ux
ub,ub,ux,ub,ug,ux,ug,ug,ur,ug,ug,ub,ub,ug,ub,ug,ug,ub,ub,ub,ug,ug,ug
ub,ux,ux,ub,ug,ux,ug,ug,ur,ug,ug,cb,ug,ug,ux,ub,ub,ub,ub,ub,ug,ux,ug
ub,ux,ux,ub,ug,ur,ug,ug,ug,ug,ub,ub,ub,ug,ub,cb,ub,ub,ub,ub,ub,ux,ug
ub,ur,ux,ub,ug,ub,ug,ug,ug,ug,ug,cg,ub,ub,ub,ub,ub,cb,ub,ux,ub,ux,ug
ub,ur,ur,ub,ug,ub,ug,ug,ug,ug,ug,ub,ub,ub,ub,ub,ub,ub,ub,ux,ub,ux,ug
ub,ur,ux,ub,ug,ub,ug,ug,ug,ug,ug,ug,ub,ub,ub,ug,ug,ub,ub,ub,ub,ux,ug
ub,ur,ur,ub,ug,ur,ug,ur,ub,ug,ub,ub,ub,ub,ur,ug,ur,ub,ub,ub,ub,ub,ur
cr,ux,ux,ub,ug,ux,ug,ug,ug,ug,ux,ub,ub,ub,ug,ug,ug,ug,ub,ub,ug,ub,ur
ur,ur,ur,ur,ur,ur,ur,ur,ur,ur,ur,ur,ur,ur,ur,ur,ur,ur,ur,ur,ur,ub,ub
ur,ur,ux,ub,ux,ux,ux,ux,ux,ux,ug,ug,ug,ux,ux,ug,ug,ug,ug,ug,ux,ux,ub
ur,ur,ub,ub,ux,ux,ux,ux,ux,ux,ux,ur,ux,ux,ux,ux,ux,ux,ux,ux,ux,ux,ux
ur,ur,ub,ux,ux,ux,ux,ux,ux,ux,ux,ur,ux,ux,ux,ux,ux,ux,ux,ux,ux,ux,ux
ur,ur,ur,ur,ur,ur,ur,ur,ur,ur,ur,ur,ux,ux,ux,ux,ux,ux,ux,ux,ux,ux,ux