ux,ur,ur,ur,ur,ur,ur,ur,ur,ur,ur,ur,ur,ur,ur,ur,ur,ur,ur,ur,ur,ur,ur
ux,ur,ur,ur,ur,ur,ur,ur,ur,ur,ur,cb,ur,ur,ur,ur,ur,ur,ur,ur,ur,ur,ur
ur,ur,ur,ur,ur,ur,ur,ur,ur,ur,ur,ub,ub,cr,ub,ur,ur,ur,ur,ur,ur,ur,ur
ur,ur,ur,ur,cg,ur,ur,ur,ur,ub,ub,ur,ur,cr,ub,ur,ur,ur,ur,ur,ur,ur,ur
ux,ur,ur,ur,ug,ur,ur,ur,ur,ub,ub,ur,ur,ur,cb,ur,ur,ur,ur,ur,ur,ur,ur
ux,ur,ur,ur,cr,ug,ur,ur,ur,ur,ub,cr,ur,ub,ub,ur,ur,ur,ur,ur,ur,ur,ur
ux,ux,ur,ur,ur,ug,ug,ur,ur,cr,cb,ub,ub,ub,ub,ur,ur,ur,ur,ur,ur,ur,ur
ux,ux,ur,ur,ur,ur,ug,ur,ur,ug,ug,ug,ub,ub,ux,ux,ux,ux,ux,ux,ug,ux,ub
ur,ur,ur,ux,ur,ur,cg,ur,ug,ug,ug,ug,ug,ux,ux,ug,ux,ux,ux,ux,ug,ux,ub
ur,ur,ur,ur,ur,ur,ur,ur,ug,ug,ug,ug,ug,ug,ug,ug,ux,ux,ux,ug,ug,ux,ub
ur,ur,ur,ur,ur,ur,ug,ug,ug,ug,ug,ub,ub,ub,ub,ub,ub,ug,ug,ug,ub,ux,ub
ur,ur,ur,ur,ur,ub,ux,ub,ub,ub,ug,ub,ug,cb,ub,ub,ub,ug,ub,ux,ub,ux,ub
ux,ub,ub,ug,ub,ub,ux,ub,ug,ug,ug,ub,cg,ub,ub,ub,ub,ug,ub,ux,ub,ux,ub
ux,ux,ux,ug,ub,ub,ub,ub,ug,ub,ub,ub,ug,ub,ub,ub,ug,ug,ug,ug,ug,ug,ug
cg,ux,ux,ug,ub,ub,ub,ux,cb,ub,ub,ub,ug,ug,ug,ug,ug,ub,ub,ug,ub,ux,ug
ux,ux,ux,ug,ub,ub,ub,ub,ug,ub,ub,ux,ux,ux,ub,ub,ug,ub,ub,ug,ub,ux,ug
ux,ux,ux,ug,ux,ub,ub,ub,ug,ub,ug,ug,ug,ub,ug,ug,ug,ub,ub,ug,ub,ux,ug
ux,ux,ux,ug,ug,ug,ub,ub,ug,ub,ug,ub,ug,ub,ug,ub,ub,ug,ug,ug,ub,ux,cg
ux,ux,ux,ux,ux,ux,ux,ux,ug,ug,ug,ux,ug,ug,ug,ux,ux,ux,ux,ux,ub,ux,ub
ux,ux,ux,ux,ux,ux,ux,ux,ux,ux,ux,ux,ux,ux,ux,ux,ux,ux,ux,ux,ub,ux,ub
ux,ux,ux,ux,ux,ux,ux,cr,ur,cb,ub,ub,ub,ub,ub,ub,ub,ub,ub,ub,ub,ub,ub
cr,ux,ux,ux,ux,ux,ux,ux,ux,ux,ux,ux,ub,ub,ub,ub,ub,ub,ub,ub,ub,ux,cb
cg,ux,ux,ux,ux,ux,ux,ux,ux,cg,ux,ux,ux,ux,ux,ux,ux,ux,ux,ux,ux,ux,ux