ur,ur,ur,ur,ur,ur,ur,ur,ur,ur,ur,ur,ur,ur,ur,ur,ur,ur,ur,cg,ur,ur,ur
ur,ur,ur,ur,ur,ur,ur,ur,ur,ur,ur,ur,ur,ur,ur,ur,ur,ur,ur,ur,ur,ur,ur
ur,ur,ur,ur,ur,ur,ur,ur,ur,ur,ur,ur,ur,ur,ur,ur,ur,ur,ur,ub,cr,ur,ub
ur,ur,ur,ur,ur,ur,ur,ur,ur,ur,ur,ur,ur,ur,cr,ug,cg,ur,ur,cr,ub,ub,cg
ur,ur,ur,ur,ur,ur,ur,ur,ur,ur,ur,ur,ur,ur,ur,ur,ur,ur,ur,ur,ub,ug,ug
ur,cr,ur,ur,ur,ur,ur,ur,ur,ur,ur,ur,ur,ur,ur,ub,ug,ub,ub,ub,ux,ug,ug
cb,ur,ur,ur,ur,ug,ug,ug,cg,ur,ur,ub,ub,ub,ub,ub,ug,ub,ux,ub,ub,ub,ug
ub,cb,ub,ur,ug,ug,ur,ur,ur,ur,ub,ug,ub,ub,ub,cb,ug,ub,ux,ub,ub,ub,ug
ur,ur,cr,ur,ug,ur,ur,ur,ub,ub,ug,ug,ub,cb,ug,ub,ub,ub,ub,ub,ux,ug,ug
ur,ur,ub,ux,ug,ug,ug,ug,ug,ub,ub,ug,ub,ub,ub,ub,ux,ug,ub,ub,ub,ub,ug
ub,ub,ub,ub,ub,cb,ug,ug,ug,ug,ub,ub,ub,ug,ub,ub,ug,ug,ub,ug,ug,ug,ug
ub,ub,ux,ux,ug,ug,ug,ug,ug,ub,ub,cb,ub,ub,ub,ug,ug,ux,ux,ug,ux,ug,ux
ub,ux,ug,ug,ug,ug,ug,ug,ug,ug,ub,ub,ub,ub,ub,ux,ug,ug,ug,ug,ub,ub,ub
ub,ug,ug,ug,ug,ug,ug,ug,ug,ug,ug,ub,ub,ub,ub,cg,ug,ug,ux,ub,ub,ub,ub
ub,ug,ux,ug,ug,ug,ug,ug,ub,ug,ug,ub,ug,ug,ug,ug,ug,ug,ub,ub,ub,ug,ux
ub,ug,ub,ug,ug,ug,ug,ug,ug,ug,ug,ug,ux,ug,ug,ub,ub,ug,ub,ub,ub,ub,ub
ux,ug,ux,ug,ug,ug,ug,ug,ug,ug,ug,ug,ug,ug,ug,ub,ug,ug,ub,ub,ub,ub,ub
cg,ug,ur,ug,ur,ur,ug,ug,ur,ur,ug,ug,ug,ug,ug,ub,ug,ug,ub,ub,ub,ub,ub
ux,ug,ur,ur,cr,ug,ug,ug,ug,ux,ug,ug,ug,ug,ug,ub,ug,ux,ub,ub,ub,ub,ub
ux,ug,ur,ug,ug,ug,ug,ug,ug,ug,ug,ug,ug,ug,ug,cb,ug,ug,ug,ur,ur,ur,ur
cr,ug,ur,ug,ug,ug,ug,ug,ug,ux,ux,ux,ux,ux,ux,ux,ux,ux,ux,ur,ur,ur,ur
cg,ug,ur,ur,ur,ur,ur,ur,ur,ur,ur,ur,ur,ur,ur,ur,ur,ur,ur,ur,ur,cb,cr
cr,ug,ug,ug,ug,cg,ur,ur,ur,ur,ur,ur,ur,ur,ur,ur,ur,ur,ur,ur,cb,ux,cr