ur,ur,ur,ur,ur,ur,ur,ur,ur,ur,ur,ur,ur,ur,ur,ub,ub,ub,ub,ub,ur,ur,ur
ux,ur,ur,ur,ur,ur,ur,ur,ur,ur,ur,ur,ur,ur,ur,ur,ur,ur,ur,ub,ur,ur,ur
ux,ur,ur,ur,ug,ug,cg,ur,ur,ur,ur,ur,ur,ur,ur,ur,ur,ur,ur,ub,ub,cb,ux
ur,ur,ur,ug,cr,ur,ur,ur,ur,ur,ur,ur,ur,ur,ur,ur,ur,ur,ur,ub,ub,ux,cb
ur,ur,ur,ug,ur,ur,ur,ur,ur,ur,ur,ur,ur,ur,ur,ur,ur,ug,ug,ub,ub,ub,ux
ur,ur,ur,ur,ur,ur,ur,ur,ur,ur,ur,ur,ur,ur,ur,ug,ug,ug,ug,ub,ub,ub,ub
ur,ur,ur,ur,ur,ur,ur,ur,ur,ur,ur,ur,ur,ur,cr,ug,ug,ug,ug,ur,ub,ub,ub
ur,ur,ur,ur,ur,ur,ur,ur,ur,ur,ug,ur,ug,ug,ug,ug,ug,ug,ug,ux,ub,ub,ub
cg,ur,ur,ub,ur,ur,ur,ur,ur,ur,ug,ug,ug,ug,ug,ug,ug,ug,ug,ux,ub,cg,ub
ur,ur,ur,ub,ur,cr,ur,ur,cr,ur,ub,ub,ug,ug,ug,cg,ug,ug,ug,ur,ub,ug,ub
ur,ur,ur,ub,ur,ub,ub,cb,ur,ur,ub,ub,ub,ug,ug,ug,ug,ug,ug,ug,ub,ug,ub
ur,ur,ur,cr,ub,ub,ub,ur,ug,ur,ub,ub,ub,ug,ug,ug,ug,ug,ug,ug,ub,ug,ub
ur,ur,ur,ub,ub,ub,ug,ug,ug,ub,ub,ug,ub,ub,ug,ug,ug,ug,ug,ug,ub,ug,ub
ub,ub,ux,ub,ub,ug,ux,ub,ub,ub,cb,ug,ug,ub,ub,ub,ug,ug,ug,ug,ug,ug,ub
cg,ub,ux,ub,ug,ug,ub,ux,ux,ub,ur,ug,ug,ug,ug,ur,ug,ug,ug,ur,ur,ur,ur
ub,ub,ux,ub,ug,ux,ub,ux,ub,ub,ur,ug,ug,ub,ub,ub,ub,ub,ug,ur,ur,ur,ur
ub,ub,ug,ub,ug,ux,ux,ux,ux,ux,ug,ug,cb,ub,ub,ub,ub,ug,ur,ur,ur,ur,ur
ub,ub,ub,ub,ux,ux,ux,ux,ux,ux,ug,ux,ub,ub,ub,ub,ub,ug,ug,ug,ur,ur,ur
ub,ub,ug,ub,ub,ux,ux,ux,ux,ux,ug,ug,ub,ub,ub,ur,ub,ub,ur,ug,ur,ur,ur
ub,ub,ug,ux,ub,ux,ux,ux,ux,ux,ur,ug,ug,ug,ug,ug,ub,ub,ub,ug,ur,ur,ur
ur,ur,ur,ur,ur,ur,ur,ur,ur,ur,ur,ux,ux,ub,ub,ug,ug,ug,ug,ug,ur,ur,ur
ur,ub,ub,ub,ub,ub,ub,ux,ux,ux,ur,ur,ur,ur,ur,ur,ux,ux,ur,ur,ur,ur,cb
ur,ur,ur,cr,ux,cb,ub,ux,ux,cg,ur,ur,ur,ur,ur,ur,ur,ur,ur,ur,ur,ur,ur