ux,ux,ux,ur,ur,ur,ur,ur,ur,ur,ur,ur,ur,ur,ur,ur,ur,ur,ur,ur,ur,ur,ur
ur,ur,ur,ur,ur,ur,ur,ur,ur,ur,ur,ur,ur,ur,ur,ur,ur,ur,ur,ur,ur,ur,cr
ur,ur,ug,ug,ug,ur,ur,ur,ur,ur,ur,ur,ur,ur,ur,ur,ur,ur,ur,ur,ur,ur,ur
ur,ur,ug,ug,ug,ur,ur,ur,ur,ur,ur,ur,ur,ur,ur,ur,ur,ur,ur,ur,ur,ug,cr
ur,ur,ug,ug,ug,ug,ur,ur,ur,ur,ur,ur,ur,ur,ur,ur,ug,cr,ug,ur,ur,ug,ur
ur,ur,ur,ur,ug,cg,cb,ub,cr,ur,ur,ur,ur,ur,ur,ur,ug,ur,ug,ug,ur,ug,ug
ur,ur,ur,ur,ur,ur,ur,ub,cr,ur,ur,ur,ur,ur,cg,ug,ug,ur,ur,ug,ug,ug,ug
ux,ux,ur,ur,ur,ur,ub,ub,cb,ub,ub,ub,ur,ur,ur,ur,ur,ur,ur,ur,ux,ub,ub
cg,ux,ux,ux,ux,ug,ub,ub,ub,ub,ub,ub,ub,ur,ux,ur,ux,ur,ub,ux,ub,ub,ub
ub,ub,ub,ub,ux,ug,ub,ub,ub,ub,ub,ub,cr,ur,ux,ur,ur,ur,ub,ub,cb,ub,ub
ub,ux,ux,ub,ux,ug,ub,ub,ub,ub,ub,ub,ub,ub,ux,ux,ug,ug,ub,ub,ub,ub,ub
ub,ux,ux,ub,ub,ug,ub,ug,ub,ub,ub,ub,ub,ub,ub,ug,ug,ub,ub,ub,ub,ub,ub
ub,ux,ux,ub,ub,ug,ub,ub,ub,ug,ug,ub,ub,ub,ub,ub,ug,ub,ub,ub,ub,ub,ub
ub,ux,ux,ub,ub,cb,ub,ub,ub,ub,ug,ub,ub,ub,ub,ub,ux,ub,ub,ub,ub,ub,ub
ub,ux,ux,ub,ux,ub,ub,ub,ux,ub,ug,ub,ug,ug,ug,ub,ub,ub,ub,cb,ub,ub,ub
ub,ux,ux,ub,ux,ub,ub,ug,ux,ub,ug,ug,ug,ub,ug,ub,ub,cg,ub,ux,ux,ux,ub
ub,ux,ux,ub,ux,cb,ub,ug,ug,ub,ug,ug,ug,ub,ug,ug,ug,ug,ub,ux,ux,ux,ub
ub,ux,ux,ub,ux,ub,ux,ux,ug,ug,ug,ug,ux,ug,ug,ug,ug,ug,ub,ux,ux,ux,ub
ub,ux,ux,ub,ux,ub,ug,ug,ug,ug,ug,ug,ug,ug,ug,ug,ug,ug,ub,ux,ux,ux,ub
ub,ux,ux,ub,ux,ub,ux,ux,ux,ux,ux,ux,ux,ux,ub,ub,ub,ub,ub,ub,ux,ux,ub
ub,ux,ux,ub,ux,ub,ux,ux,ux,ux,ux,ux,ux,ux,ux,ux,ux,ux,ux,ub,ub,ub,ub
ub,ux,ux,ub,ux,ub,ub,ub,ub,ub,ub,ub,ub,ub,ub,ub,ub,ub,ub,ub,ub,ub,ub
ub,ub,ub,ub,ub,ub,ub,ub,ub,ub,ub,ub,ub,ub,ub,ub,ub,ub,ub,ub,ub,ub,ub