ur,ur,ur,ur,cg,ub,ub,ur,ur,ur,ur,ur,ur,ur,ur,ur,ur,ug,ux,cg,ux,ux,ux
cr,ur,ur,ur,ug,ub,ub,ur,ur,ur,ug,ux,ux,ur,ur,ur,ur,ug,ux,ux,ux,ux,ux
cr,ur,ur,ur,cb,ub,ug,ug,ug,cg,ur,cr,ux,ur,ur,ur,ux,ug,ug,ux,ux,ux,ux
ub,ub,ub,ub,ug,ub,ug,ur,ur,ur,ux,ur,ux,ur,ur,ug,ug,ug,ug,ux,ux,ux,ux
ub,ug,ub,ub,ub,ub,cb,ug,cg,ur,ur,ur,ug,ug,ug,ug,ux,ug,ug,ux,ux,ux,ux
ub,ug,ub,ur,cb,ur,ur,ur,cr,ug,ug,ug,ug,ug,ug,ug,ug,ug,ug,ux,ux,ux,ux
ug,ug,ub,ur,ug,cr,cb,ub,cg,ub,ug,ug,ug,ug,ug,ug,ug,ug,ug,ux,ux,ux,ux
ug,ub,ub,ug,ug,ug,ug,ug,ug,ug,ub,ug,ub,ub,ug,ug,ug,ug,ug,ux,ux,ux,ux
ub,ub,ug,ug,ug,ug,ug,ug,ug,ug,ub,ug,ug,ug,ug,ug,ug,ug,ug,ug,ux,ux,ux
ub,ub,ub,ug,ub,ub,ug,ug,ub,ub,ub,ub,ub,ug,ub,ux,ux,ug,ux,ug,ug,ug,ug
ub,ub,ub,ub,ub,ur,ug,ug,ub,ub,ub,ub,ub,ug,ug,ug,ug,ug,ug,ug,ug,ug,ug
ub,ub,ub,ub,ur,ur,ug,ug,ub,ub,ub,ub,ub,ub,ug,ug,ug,ug,ug,ux,ux,ug,ug
ub,ub,ub,ug,ug,ug,ug,ug,ub,ub,ub,cb,ub,cb,ug,ug,ug,ug,ug,ug,ux,ug,ug
ub,ub,ub,ug,ux,ux,ug,ug,ug,ub,ub,ub,ub,ub,ug,ug,ug,ug,ug,ug,ug,ug,ug
ub,ub,ub,ug,ub,ux,ug,ub,ug,ub,ug,ub,ub,ub,ub,ug,ug,ug,ug,ug,ug,ug,ug
ub,ub,ub,ug,ub,ux,ug,ug,ug,ug,ug,ub,ub,ub,ux,ux,ux,ux,ug,ug,ux,ug,ug
ub,ub,ub,ug,ub,ub,ub,ug,ub,ub,ug,ug,ub,ub,ug,ug,ug,ug,ug,ur,ur,ur,ur
cg,ub,ub,ug,ub,ub,ub,ug,ux,ub,ux,ug,ub,ug,ug,ux,ux,ux,ug,ux,ur,ur,ur
ux,ub,ub,ug,ug,ub,ug,ug,ux,ub,ux,ux,ub,ub,cg,ux,ux,ux,ug,ux,ur,ur,ur
ux,ub,ub,ub,ug,ug,ug,ub,cr,ur,ur,ur,ur,ub,cb,ur,ur,ur,ur,ur,ur,ur,ur
cr,ur,ur,ur,ur,ur,ur,ur,ur,ur,ur,ur,ur,ur,ur,ur,ur,ur,ur,ur,ur,ur,ur
cg,ur,ub,ub,ub,ux,ub,ub,ub,ub,ux,ux,ux,ux,ux,ux,ux,ux,ux,ur,ur,cb,cr
cr,ur,ur,ur,ur,ur,ur,ur,ur,ur,ur,ur,ur,ur,ur,ur,ur,ur,ur,ur,cb,ux,cr