cb,cb,cb,cr,ur,ur,ur,ur,ur,ur,ur,ur,ur,ur,ur,ur,ur,ur,ur,ur,ur,ur,cb
ux,ux,ux,ur,ur,ur,ux,ur,cr,ur,ur,ur,ur,ur,ur,ur,ur,ur,ur,ur,ur,ur,ur
ur,ur,ur,ur,ur,ur,ur,ur,ur,ur,ur,ur,cr,ur,ur,ur,ub,cb,ur,ur,ur,ur,ur
ur,ur,ur,cr,ur,ur,ur,ur,ur,ur,ur,ur,ur,ur,ur,ur,ub,ur,ur,ub,ur,ur,ur
ur,ur,ur,ur,cg,ug,ur,ur,ur,ur,ur,ur,cr,cr,ur,ub,ub,ur,ug,ux,ur,ur,ur
ur,ur,ur,ur,ug,ub,ub,cg,ub,ur,ur,ur,ug,ug,ug,ug,ug,ug,ug,ug,cg,ur,ur
ur,ur,ub,ur,ug,ub,ub,ug,ub,ug,ur,ur,ug,ur,ur,ur,ug,ug,ur,ug,ug,ur,ur
cb,ub,ug,cb,ug,ub,cb,ug,ur,ug,ug,ug,ug,ug,ug,ug,ug,ug,ug,ug,ug,ux,ug
ur,ub,ur,ub,ub,ur,ur,ur,ur,ur,ur,ug,ug,ug,cg,ug,ug,ug,ux,ux,ug,ux,ug
ub,ub,ur,ub,ur,ur,ub,ub,cr,ug,ug,ug,ug,ug,ug,ug,ur,ug,ux,ub,ug,ug,ug
ur,ub,ur,ub,ur,ur,ub,ub,ub,ug,ug,ug,ug,ug,ug,ug,ur,ux,ux,ug,ug,ug,ux
ub,ub,ub,ub,ug,ug,ub,ub,ub,ug,ug,ug,ug,ug,ug,ug,ur,ux,ug,ug,ux,ug,ux
cb,ub,ub,ug,ug,ux,ug,ug,ub,ug,ug,ug,cb,cg,ug,ug,ur,ub,ug,ub,ux,ug,ux
ux,ug,ug,ug,ug,ug,ug,ug,cb,ug,ug,ug,ub,ub,ub,ug,ur,ux,ug,ub,ux,ug,ux
ux,ug,ug,ug,ug,ug,ug,ug,ug,ug,ug,ug,ub,ub,ub,ub,ur,ux,ug,ub,ug,ug,ux
ug,ug,ug,ug,ug,ug,ug,ug,ug,ug,ug,ug,ub,ub,ub,ub,ur,ux,ug,ub,ux,ux,ux
ug,ug,ug,ug,ug,ux,ug,ug,ug,ug,ug,ux,ux,ug,ux,ux,ur,ux,ug,ug,ux,ux,ux
cr,ux,ux,ux,ug,ux,ug,ug,ug,ug,ug,ux,ux,ug,ux,ux,ur,ux,ug,ug,ub,ub,ub
cg,ux,ux,ux,ug,ug,ug,ug,ug,ug,ug,ub,ub,ug,ub,ub,ur,ub,ug,ug,ub,ub,ub
cb,ux,ux,ux,ug,ux,ux,ux,ug,ug,ug,ux,ux,ug,ug,ug,ug,ug,ug,ug,ux,ux,ux
ux,ux,ux,ux,ux,ux,ux,ux,ug,ug,ug,ug,ug,ug,ug,ug,ug,ug,ug,ug,ux,ux,cr
cr,ux,ux,ux,ux,ux,ux,ux,ux,ux,ux,ux,ux,ux,ux,ux,ur,cb,cg,ux,cb,ux,cr
cg,cb,cg,cb,ux,ux,ux,ux,ux,ux,ux,ux,ux,ux,ux,cg,ur,ur,ur,cg,cg,ux,cr