ux,ur,ur,ur,ur,ur,ur,ur,ur,ur,ur,ur,ur,ur,ur,ur,ur,ur,ur,ur,ur,ur,ur
ux,ur,ur,ur,ur,ur,ur,ur,ur,ur,ur,ur,cr,ub,ur,ur,ur,ur,ur,ur,ur,ur,ur
ur,ur,ur,ur,ur,ur,ur,ur,ur,ur,ur,ur,ur,cb,ur,ur,ur,ur,ur,ur,ur,ur,ur
ur,ur,ur,ur,ur,ur,ur,ur,ur,ur,ur,ur,ur,ur,ur,ur,ur,ur,ur,ur,ur,ur,ur
ur,ur,ur,ur,ur,ur,ur,ur,ur,ur,ur,ur,ur,ur,ur,ur,ur,cr,ub,ur,ur,ur,ur
ur,ur,ur,ur,ur,cg,cr,ur,ur,ur,ur,cb,ub,ub,ub,ub,cb,ub,ub,ur,ur,ur,ur
ur,ux,ur,ur,ur,ug,cg,ug,ug,ug,ug,ub,ub,ub,ub,ub,ub,ub,ug,ug,cr,ur,ur
ur,ur,ur,ur,ur,ug,ur,ur,ug,ug,ug,ug,ub,ub,ux,ux,ux,ux,ux,ux,ug,ux,ub
ur,ur,ur,ur,ur,ug,ur,ug,ug,ug,ug,ug,ug,ux,ux,ug,ux,ux,ux,ux,ug,ux,ub
ur,ur,ur,ur,ur,ug,ur,ub,ug,ug,ug,ug,ug,ug,ug,ug,ux,ux,ux,ug,ug,ux,ub
ur,ur,ur,ur,ug,ug,ug,ug,ug,ug,ug,ug,ug,ug,cb,ub,ub,ug,ug,ug,ub,ux,ub
ur,ur,ur,cr,ux,ub,ux,ub,ub,ub,ug,ug,ug,ug,ub,ub,ub,cg,ub,ux,ub,ux,ub
ux,ub,ub,ug,ub,ub,ux,ub,ug,ug,ug,ug,ug,ug,ub,ub,ub,ub,ub,ux,ub,ux,ub
ux,ux,ux,ug,ub,ub,ub,ub,ug,ub,ux,ux,ub,cb,ub,ub,ub,ub,ub,ux,ub,ux,ub
cg,ux,ux,ug,ub,ub,ub,ug,ug,ug,ux,ub,ub,ub,ub,ub,ub,ub,ub,ug,ub,ux,ub
ux,ux,ux,ug,ub,ub,ub,ub,ug,ux,ux,ux,ux,ux,ub,ub,ub,ub,ub,ug,ub,ux,ub
ux,ux,ux,ug,ux,ub,ub,ub,ug,ub,ug,ug,ug,ub,ug,ug,cg,ub,ub,ug,ub,ux,ub
ub,ub,ub,ug,ug,ug,ub,ub,ug,ub,ug,ub,ug,ub,ug,ub,ub,ug,ug,ug,ub,ux,ub
ub,ub,ub,ub,ux,ux,ux,ux,ug,ug,ug,ux,ug,ug,ug,ux,ux,ux,ux,ux,ub,ux,ub
ux,ux,ux,ub,ub,ub,ux,ux,ux,ux,ux,ux,ux,ux,ux,ux,ux,ux,ux,ux,ub,ux,ub
ux,ux,ux,ux,ux,ux,ux,ux,ux,ux,ux,ux,ub,ub,ub,ub,ub,ub,ub,cr,ur,cb,ub
cr,ux,ux,ux,ux,ux,ux,ux,ux,ux,ux,ux,ub,ub,ub,ub,ub,ub,ub,ub,ub,ux,cb
cg,ux,ux,ux,ux,ux,ux,ux,ux,cg,ux,ux,ux,ux,ux,ux,ux,ux,ux,ux,ux,ux,ux