ur,ur,ur,ur,ur,ur,ur,ur,ur,ur,ur,ur,ur,ur,ur,ub,ub,ur,ur,ur,ur,ur,ur
ur,ur,ur,cb,ub,ur,ur,ur,ur,ur,ur,ur,ur,ur,ur,ur,ub,ub,ur,ur,ur,ur,ur
ur,ur,cr,ub,ub,ur,ur,ur,ur,ur,ur,ur,ur,ur,ur,ur,ur,cb,ug,ux,ux,ur,ur
ur,ur,ur,ur,ur,ur,ur,ur,ur,ur,ub,cr,ur,ur,ub,ub,ux,ub,ug,ux,ux,ur,ur
ur,ur,ur,ur,ur,ur,ur,cg,ug,ug,ug,ug,ug,ub,ug,ug,ub,ub,ug,ux,ux,ur,ur
ur,ur,ur,ur,ur,ur,ur,ur,ur,ur,cr,ub,ug,ub,ub,ug,ux,ub,ug,ux,ux,ur,ur
ur,ur,ur,ur,ur,ur,ur,ur,ur,ur,ur,ub,ug,ub,ux,ug,ux,ub,ug,ux,ux,ur,ur
ur,ur,ur,ur,ur,ur,ur,ur,ur,ug,ub,ub,ug,ub,ux,ug,ub,ub,ug,ux,ux,ur,ur
ur,ur,ur,ur,ur,ur,ur,ur,ug,ug,ub,ub,ug,ub,ub,ug,ux,ux,ug,ux,ux,ur,ur
ur,ur,ur,ur,ur,ur,ur,ur,ub,ub,ub,ub,ug,ub,ub,ub,ux,ux,ug,ux,ux,ur,ur
cg,ur,ur,ur,ur,ur,ur,ur,ub,cb,ub,ub,ub,ub,ub,ub,ux,ux,ug,ux,ux,cr,ur
ur,ur,ux,cr,ur,ur,ub,ub,ub,ub,ub,ub,ub,cb,ur,ur,ur,ur,ug,ur,ur,ur,ur
ur,cr,ux,cg,ug,ub,ur,ur,ub,ub,ub,ub,ub,ux,ux,ux,ux,ux,ug,ux,ur,ux,ur
ux,ug,ux,ux,ug,ur,ur,ur,ug,ux,ux,ux,ug,ux,ux,ux,ux,ux,ug,ux,ur,ux,ur
ux,ug,ug,ug,ug,ur,ur,ur,ug,ug,ug,ug,ug,ux,ux,ux,ux,ux,ug,ux,ur,ux,ur
ur,ur,ur,ux,ur,ux,ux,ux,ur,ux,ux,ux,ux,ux,ux,ux,ux,ux,ug,ux,ur,ux,ur
ur,ur,ur,ux,ur,ux,ux,ux,ur,ux,ux,ux,ux,ux,ux,ux,ux,ux,ug,ux,ur,ux,ur
ur,ur,ur,ur,ur,ug,ug,ug,cb,ub,ub,ub,ub,ub,ub,ub,ub,ub,ub,ub,ub,ub,ub
ur,ur,ur,ur,ub,ub,ub,ub,ub,ub,ub,ub,ub,ub,ub,ub,ub,ub,ub,ux,ur,ur,ub
ur,ur,ux,ux,ux,ux,ux,ux,ur,ux,ux,ux,ux,ux,ux,ux,ux,ux,ub,ub,ur,ur,ub
ur,ux,ux,ux,ux,ux,ux,ux,ur,ux,ux,ux,ux,ux,ux,ux,ux,ux,ux,ub,ub,ub,ub
ur,ur,ur,ur,ur,ur,ur,ur,ur,ur,ur,ur,ur,ur,ur,ur,ur,ur,ur,ur,ur,ur,ur
ux,ux,ux,ux,ux,ux,ux,cg,ur,ur,ur,ur,ur,ur,ur,ur,ur,ur,ur,ur,ur,cb,ur