ur,ur,cb,ur,ur,ur,ur,ur,ur,ur,ur,ur,ur,ur,ur,ur,ur,ur,ur,cg,ur,ur,ur
ur,ur,ur,ur,ur,ur,ur,ur,ur,ur,ur,ur,ur,ur,ur,ur,ur,ur,ur,ur,ur,ur,ur
ur,ur,ur,ur,ur,ur,ur,ur,ur,ur,ur,ur,ur,ur,ur,ur,ur,ur,ur,ur,ur,ur,ur
ur,ur,ur,ur,ur,ur,ur,ur,ur,ur,ur,ur,ur,ur,ur,ur,ur,ur,ur,ur,ur,ur,ur
cb,ub,ur,ur,ur,ur,ur,ur,ur,ur,ur,ur,ur,ur,ur,ur,ur,ur,ur,ur,ur,ur,ur
ur,cr,ur,ur,cr,ur,ur,ur,ur,ug,cr,ur,ur,ur,ur,ur,ur,ur,ur,ur,ur,ur,ur
ur,ur,ur,ux,ub,ub,ug,ug,ug,ug,ug,ug,ub,ur,ur,ur,cb,ub,ub,ur,ur,ur,ur
cr,ug,ug,ux,ub,ub,ug,cg,ux,ux,ug,ug,ug,ug,ur,ur,ur,ub,ub,ur,ur,ur,ur
ug,ub,ug,ug,ub,ub,ug,ug,ug,ug,ug,ug,ub,ug,ur,ur,ur,ur,ub,ur,ur,ur,ur
cg,ur,ur,ug,ur,ug,ug,ug,ug,ug,ug,ug,ub,ug,cg,ur,ur,ub,ub,ur,ur,ur,ur
ur,ux,ux,ug,ux,ug,ug,ub,ug,ug,ug,ug,ug,cg,ug,ur,ur,cr,ub,ur,ub,ub,ur
ur,ur,ur,ug,ur,ug,ub,ub,ug,ug,cb,ug,ub,ub,ub,ub,ub,ub,ub,ur,ub,ub,cr
cg,ux,ux,ug,ux,ug,ug,ug,ug,ug,ub,ub,ub,ub,ub,ub,ug,ug,ux,ur,ub,ub,ub
ux,ux,ux,ug,ug,ug,ug,ug,ug,ub,ux,ub,ub,ub,ub,ug,ug,ux,ux,ur,ub,ub,ub
ux,ux,ux,ux,ux,ux,ur,ug,ug,ub,ub,ub,ub,ub,ug,ug,ux,ux,ux,ur,ub,ub,ub
ux,ux,ux,ux,ux,ux,ug,ug,ux,ux,ub,ub,ub,ub,ub,ug,ux,ux,ux,ur,ub,ub,ub
ux,ux,ux,ug,ub,ub,ub,ub,ug,ug,ub,ux,ux,ux,ux,ux,ux,ux,ub,cb,ub,ub,ug
cg,ux,ux,ub,ub,ub,ub,cb,ub,ub,ub,ux,ux,ux,ux,ux,ux,ux,ub,ub,ux,ug,ug
ub,ub,ub,ug,ug,ub,ug,ux,ux,ux,ux,ux,ux,ux,ux,ux,ux,ux,ub,ub,ub,ub,ub
ub,ub,ub,ub,ug,ux,ug,ug,ug,ug,ux,ux,ug,ug,ug,ug,ug,ug,ub,ub,ub,ub,ub
cr,ub,cb,ub,ug,ux,ur,ux,ux,ug,ug,ux,ug,ug,ug,ug,ug,ug,ug,ur,ug,ug,ux
cg,ub,ub,ub,ug,ug,ur,ug,ug,ug,ug,ux,ux,ux,ux,ux,ux,ux,ux,ur,ux,cb,cr
cr,ub,ub,ub,ub,ux,ur,ur,ur,ur,ur,ur,ur,ur,ur,ur,ur,ur,ur,ur,cb,ux,cr