ur,ur,cb,ur,ur,ur,ur,ur,ur,ur,ug,ug,ug,ug,ug,ur,ur,ur,ur,cg,ux,ux,ux
ur,ur,ur,ur,ur,ur,ur,ur,ur,ur,ur,ur,ug,ur,ug,ur,ur,ur,ur,ux,ux,ux,ur
ur,ur,ur,ur,ur,ur,ur,ur,ur,ur,ur,cr,ug,ug,ug,ux,ur,ur,ur,ur,ur,ur,cr
ur,ur,ur,ur,ur,ur,ur,ur,ur,ur,ur,ur,ur,ur,ug,ux,ux,ux,ux,ux,ur,ug,ug
ur,ur,ur,ur,ur,ur,ur,cr,ur,ur,ur,ug,ur,ug,ug,ug,ug,ub,ub,ub,ub,ub,ub
ur,ur,ur,ur,ur,ur,ur,ur,ug,ur,ur,ug,ur,ug,ur,ug,ub,ub,ux,ux,ur,cb,ub
ur,ur,ur,ur,ur,ur,cg,ur,ur,ur,cr,ub,ub,ub,ub,ub,ub,ug,ux,ux,ur,ux,ug
ur,ux,ux,cr,ur,ur,ug,ug,ur,ur,ub,ub,ub,ub,ub,ug,ux,ug,ux,ux,ur,ux,ug
ur,ux,ux,ux,ux,ug,ug,ug,ug,ug,ug,ug,ug,ub,ub,ug,ub,ub,cb,ux,ur,ux,ug
ur,ux,ur,ur,ur,ug,ug,ug,cg,ur,ug,ub,ug,ub,ub,ub,ub,ug,ub,ux,ur,ux,ug
ur,ur,ur,ur,ur,ur,ur,ur,ug,ug,ug,ub,ug,ug,ub,ug,ug,ug,ub,ub,ur,ub,ub
ur,ur,ur,ur,ux,ux,ug,ug,ug,ux,ug,ug,ub,ug,ub,ub,ug,ug,ux,ux,ur,ug,ub
cg,ux,ux,ux,ux,ux,ug,ug,ug,ux,ug,ux,ub,ug,ub,ub,ug,ug,ub,ub,ur,ug,ub
ux,ux,ux,ux,ux,ux,ug,ux,ug,ug,ub,cb,ub,ub,ug,ug,ug,ug,ub,ux,ur,ug,ub
ux,ux,ux,ux,ux,ux,ug,ug,ug,ux,ub,ub,ug,ub,ug,ug,ug,ug,ub,ux,ur,ug,ub
ux,ux,ux,ux,ux,ux,ux,ux,ux,ux,ux,ub,ug,ub,ub,ug,ug,ug,ux,ux,ur,ug,ub
ux,ux,ug,ug,ug,ug,ug,ug,ug,ux,ux,ub,ug,ug,ub,ub,ub,cb,ur,cr,ur,ug,ub
cg,ux,ug,ux,ux,ux,ub,ub,ub,ux,ux,ub,ug,cg,ub,ub,ug,ug,ux,ux,ub,ub,ub
ux,ux,ug,ux,ux,ux,ub,cg,ug,ux,ux,ub,ub,ub,ub,ub,ub,ub,ux,ux,ub,ub,ub
ux,ux,ug,ux,ux,ux,ux,ub,cb,ub,ug,ux,ub,ub,ub,ub,ub,ub,ub,ub,ub,ub,ub
cr,ux,ug,ux,ux,ux,ux,ub,ub,ux,ug,ug,ub,ub,ub,ub,ub,ub,ub,ub,ub,ub,ub
cg,cb,ur,ug,ug,ug,ug,ub,ub,ub,ub,ug,ub,ub,ub,ub,ub,ub,ub,ub,ub,cb,cr
cr,ux,ur,ug,ug,ug,ug,ug,ub,ub,ub,ur,ub,ub,ub,ub,ub,ub,ub,ub,cb,ux,cr