ux,cb,cb,cr,ux,ux,ux,ux,ur,ur,ur,ur,ur,ur,ur,ur,ur,ur,ur,ur,ur,ur,cb
ux,cb,cb,ux,ux,ux,ux,ux,ur,ur,ur,ur,ur,ur,ur,ur,ur,ur,ur,ur,cr,ur,cb
ur,ug,ug,ug,ur,ur,ur,ur,ur,ux,ur,ur,ur,ur,ur,ur,ur,ur,ur,ug,ur,ur,ux
ur,ug,ur,ug,ur,ug,ug,ug,ur,cr,ur,ug,cr,ur,ug,ur,ur,ub,ug,ux,ur,ur,ux
ur,ug,ur,ug,ur,ug,ur,ug,ur,ug,ur,cg,ur,ur,ur,ur,ub,ub,ug,ux,ur,ur,ux
ur,ug,ur,ug,ug,ug,ur,ug,ug,ug,ur,ur,ur,ur,ug,ug,ug,ub,ug,ug,cr,ur,ub
ur,ug,ur,ur,ur,ur,ur,ur,ur,ur,ur,ug,ur,cr,ub,ug,ug,ug,ug,ub,ub,ur,ub
cb,ug,ur,cr,ur,ur,ur,ur,ur,ur,ur,ug,ur,ur,ug,ug,ug,ug,ug,ug,ug,ur,ug
ur,ug,ur,ub,ub,ub,ub,ub,ub,ur,ug,ug,ur,ug,ug,ux,ub,ug,ug,ub,ub,ur,ub
ur,ug,ur,ub,ub,ub,ub,ub,cb,ub,ub,ub,ur,ug,ug,ux,ub,ux,ug,ug,ux,ur,ub
ur,ur,ur,ur,ur,ur,ur,ur,ub,ug,ug,ub,ur,ug,ug,ub,ub,ux,ug,ug,ug,ur,ug
ur,ur,ux,ub,ub,ub,ub,ug,ug,ug,cg,ug,cb,ub,ub,ub,ug,ug,ug,ug,ub,ur,ub
cb,ub,ux,ug,ub,ub,ub,ug,ug,ug,ug,ug,ub,ub,ug,ug,ug,ug,cb,ug,ur,ur,ub
ub,ub,ug,ug,ug,ub,ub,ub,ug,ug,ug,ug,ug,ug,ug,ux,ux,ux,ub,ub,ub,ub,ub
ux,ux,ug,ug,ug,ug,ub,ub,ug,ug,ug,ug,ub,ug,ug,ug,ug,ug,ub,ub,ub,ub,ur
cg,ux,ux,ug,ug,ug,ub,ub,ug,ug,ug,ug,ub,ub,ub,ub,ux,ug,ug,ug,ug,ub,ub
ub,ub,ub,ub,ub,ub,ug,ub,ub,ur,ug,ur,ug,ug,cg,ub,ug,ux,ub,ub,ug,cg,ub
ub,ub,cg,ug,ub,ub,ug,ux,ux,ux,ug,ug,ug,ub,ug,ug,ug,ux,ug,ux,ux,ur,ur
ub,ux,ug,ug,ub,ug,ug,ux,ux,ux,ug,ug,ug,ur,ug,ug,ug,ug,ug,ur,ur,ur,ur
ub,ub,cb,ub,ub,ug,ug,ur,ur,ur,ur,ur,ug,ug,ug,ur,ur,ur,ur,ur,ur,ur,ur
cr,ux,ux,ug,ug,ug,ux,ux,ux,ux,ux,ux,ux,ux,ux,ux,ux,ux,ux,ux,ux,ux,ur
cg,ux,ux,ux,ux,ux,ux,ux,ux,ux,ux,ux,ux,ux,ux,ux,ux,ux,ux,ub,ub,cb,cr
cr,cg,cg,cb,ux,ux,ux,ux,ux,ux,ux,ux,ux,ux,ux,cg,ux,ux,ux,cg,cb,ux,cr