ur,ur,ur,ur,ur,ur,ur,ur,ur,ur,ur,ur,ur,cr,ur,ur,cr,cb,ux,ux,ux,ux,ux
ur,ur,ur,ur,ur,ur,ur,ur,ur,ur,ur,ur,ur,ur,ur,ux,ux,ux,ux,ux,ux,ux,ux
ur,ur,ur,ur,ur,ur,ur,ur,ur,ur,ur,ur,ur,ur,ur,ux,ux,ux,ux,ux,ux,ux,ux
ur,ur,ur,ur,ur,ur,ur,ur,ur,ur,ur,ur,ur,ur,ur,ug,ug,ug,ug,ux,ux,ux,ux
cb,ur,ur,ur,ur,cr,ug,ug,ug,cg,ur,ur,ur,ur,ux,ux,ux,ux,ug,ux,ux,ux,ux
ur,ur,ur,ur,ur,ur,ug,ug,ur,ur,ur,ur,ug,ug,ug,ug,ug,ug,ug,ux,ux,ur,ux
ur,ur,ur,ur,ur,ur,ur,ug,ur,ur,ur,ur,ug,ug,ug,ug,ug,ug,ug,ux,ux,ur,ux
ur,ur,ur,ur,ur,ug,ug,ug,ur,ur,ur,cr,ug,ug,ug,ug,ug,ug,ug,ux,ur,ur,ur
ur,ur,ur,ur,ur,ug,cg,ur,ur,ur,cr,ug,ur,ux,ur,ur,ug,ug,ur,ur,ur,ur,ur
ur,ur,ur,ur,ur,ug,ur,ur,ug,ug,ur,ug,ug,ur,ub,ug,ug,ug,ur,ur,ux,ux,ux
ur,ur,ur,ur,ur,ug,ug,ur,ug,ug,ug,cb,ub,ub,ub,ur,ur,ub,ub,ux,ux,ux,ux
ur,ur,ur,ur,ur,ug,ur,ur,ug,ux,cg,ub,ub,ub,ub,ub,ub,ub,ub,ub,ux,ux,ux
ur,ur,ur,ur,ur,ur,ug,ur,ug,ux,ub,ub,ub,ub,ub,ub,ub,ub,ub,ub,ux,ux,cg
ur,ur,ur,ur,ur,ur,ug,ur,ug,ug,ug,ug,ug,ub,ub,ub,ub,ug,ug,ux,ux,ux,ux
ur,ur,ur,ur,ur,ur,ur,ur,ug,ug,ug,ug,ug,ub,cb,ub,ub,ub,ug,ub,ux,ux,ux
ux,ub,ub,cb,ur,ur,cr,ux,ux,ux,ux,ux,ux,ub,ub,ug,ug,ub,ub,ub,ux,ux,ux
ux,ub,ux,ux,ug,ug,ug,ug,ug,ub,ug,ug,ug,cb,ub,ub,ub,ub,ub,ub,ub,ub,ub
cg,ub,ux,ux,ux,ux,ux,ux,ux,ug,ug,ux,ub,ub,ub,ub,ub,ub,ub,ub,cg,ub,ub
ur,ub,ug,ug,ug,ug,ug,ug,ug,ug,ub,ub,ub,ub,ub,ub,ub,ub,ub,ug,ug,ub,ub
ur,ub,ub,ub,ub,ub,ub,ub,ub,ub,ub,ub,ub,ug,ug,ug,ug,ug,ug,ug,ub,ub,ub
ur,ur,ug,ub,ub,ub,ub,ub,ub,ub,ub,ub,ug,ug,ub,ug,ug,ub,ub,ub,ub,ub,ub
cr,ux,ug,ub,ub,ub,ub,ub,ug,ug,ug,ug,ug,ub,ub,ub,ub,ub,ux,ux,ux,cb,cr
cg,ux,ug,ug,ug,ug,ug,ug,ug,ux,ub,ub,ux,cb,ub,ub,ub,ub,ux,cg,cb,ux,cr