ur,ur,cb,ur,ur,ur,ur,ur,ur,ur,ur,ur,ur,ur,ur,ur,ur,ur,ur,cg,ur,ur,ux
ur,ur,ur,ur,ur,ur,ur,ur,ux,ur,ur,ur,ur,ur,ur,ur,ur,ur,ur,ux,ur,cr,ur
ur,ur,ur,ur,ur,ur,ur,ur,ur,ur,ur,ur,ur,ur,ur,ur,ur,ur,ur,ur,ur,ux,ur
ur,ur,ur,ur,ur,ur,ur,ur,ur,ur,ur,ur,ur,ur,ur,ur,ur,ur,ur,ur,ur,ux,ux
ur,ur,ur,ur,cr,ur,ur,ur,ur,ur,ur,ur,ur,ur,ur,cb,ur,ur,ur,ur,ub,ub,ub
ux,ur,ur,ug,ur,ur,ur,cg,ur,ur,ur,ur,ur,ur,ur,ub,cr,ur,ur,ub,ub,ub,ub
ux,ur,ur,ug,ur,ur,ur,ug,ur,ur,ur,ur,ur,ub,ub,ub,ub,ug,cr,ub,ub,ub,ub
ux,ur,ur,ug,ug,ug,ug,ug,ur,ur,ub,ur,ub,ub,ub,ub,ub,ub,ub,ub,ub,ub,ub
ux,ur,ur,ur,ur,ur,ur,ug,ug,cr,ur,ur,ug,ub,ub,ub,ub,ub,ub,ux,ur,ux,ux
ux,ux,ur,ur,ur,ug,ug,ug,ug,ug,ug,ug,ug,ub,ug,ug,ug,ug,ug,cg,ur,ux,ux
ur,ur,ur,ur,ur,ur,ur,ur,ug,ug,ug,ug,ug,ug,ug,ug,ug,ug,ux,ux,ur,ux,ux
ur,ur,ur,ur,ux,ux,ug,ug,ug,ux,ug,ug,ug,ub,ub,ub,ug,ug,ux,ux,ur,ux,ux
cg,ux,ux,ux,ux,ux,ug,ug,ug,ux,ug,ug,ub,ub,ub,ub,ug,ug,ub,ub,ur,ux,ux
ux,ux,ux,ux,ux,ux,ug,ux,ub,ug,ub,ug,ub,cb,ub,ug,ug,ug,ub,ux,ur,ux,ux
ux,ux,ux,ux,ux,ux,ug,ug,ub,ub,ub,ub,ub,ub,ub,ug,ug,ug,ub,ux,ur,ux,ux
ux,ux,ux,ux,ux,ux,ux,ux,cg,ug,ug,ub,ub,cb,ug,ug,ug,ug,ux,ux,ur,ux,ux
ux,ux,ug,ug,ug,ug,ug,ug,ug,ux,ug,ug,ub,cb,ur,cr,ub,ub,ub,ub,ur,ux,ux
cg,ux,ug,ug,ug,ux,ub,ub,ug,ug,ug,ug,ub,ug,ug,ug,ug,ug,ux,ub,ub,ub,ub
ug,ug,ug,ux,ug,ub,ub,ub,ug,ug,ug,ub,ub,ub,ub,ub,ub,ub,ux,ub,ub,ub,ub
ug,ug,ug,ug,ug,ub,cb,ub,ub,ub,ug,ux,ub,ub,ub,ub,ub,ub,ub,ub,ub,ub,ub
cr,ux,ug,ux,ug,ux,ub,ub,ub,ux,ug,ug,ub,ub,ub,ub,ub,ub,ub,ub,ub,ub,ub
cg,cb,ur,ub,ug,ug,ub,ub,ub,ub,ub,ug,ub,ub,ub,ub,ub,ub,ub,ub,ub,cb,cr
cr,ux,ur,ub,ug,ug,cg,ug,ub,ub,ub,ur,ub,ub,ub,ub,ub,ub,ub,ub,cb,ux,cr