ur,ur,ur,cr,ub,ur,cr,ub,cb,ur,ur,ur,ur,ur,ur,ur,ur,ur,ur,ur,ur,ub,ub
ur,ur,ur,ur,cb,ur,ur,ur,ur,ur,ur,ur,ux,ux,ux,ux,ux,ur,ur,ur,ur,ub,cb
ur,ur,ur,ur,ur,ur,ux,ux,ur,ur,ur,ur,ur,ur,ur,ur,ur,ur,ux,ur,ur,ub,ur
ub,ur,ur,ur,cr,ur,ux,ur,ur,ur,ur,ur,ur,ur,ur,ux,ur,ur,ur,ur,ur,ub,ur
ub,ur,ur,cb,ub,ur,ux,ur,ux,ur,ur,ur,ur,ur,ur,ur,ug,ug,ur,ur,ur,ub,ur
ub,ur,ur,ur,ur,cr,ur,ur,ur,ur,ur,ub,ur,ur,ur,cg,ug,ug,ux,ub,ug,ub,ub
ux,ur,ur,ur,ur,ur,ur,ur,ur,ub,ub,cr,ur,ur,ur,ug,ug,ug,ur,ug,ug,ub,ub
ur,ub,ug,ug,ub,ux,ug,ug,ub,cb,ub,ur,ur,ug,ug,ug,ug,ug,ug,ug,ux,ub,ub
cg,ub,ug,ug,ub,ux,ug,ug,ug,ug,ub,ub,ug,ug,ub,ug,ub,ub,ug,ug,ur,ub,ub
ub,ub,ug,ug,ug,ub,ug,ug,ug,ug,ub,ub,ub,ug,ub,ub,ub,ub,ug,ug,ur,ub,ub
ub,ub,ug,ub,ug,ux,ug,ug,ug,ub,ub,ub,ub,ub,ub,cb,ub,ub,ur,ur,ur,ub,ub
ux,ub,ug,ub,ug,ux,ug,ug,ug,ub,ub,ub,ub,ub,ub,ur,ur,ur,ur,ur,ur,ub,ub
ux,ub,ug,ub,ug,ux,ug,ug,ug,ub,ub,ux,ub,ur,ub,ub,ur,ur,ur,ux,ux,ux,ux
ux,ub,ug,ug,ug,cg,ug,ug,ug,ub,ub,ux,ub,ub,ux,ub,ux,ux,ux,ux,ux,ux,ux
cg,ux,ug,ug,ug,ug,ug,ug,ug,ub,ub,ux,ug,ub,ub,ub,ub,ux,ux,ux,ux,ux,ux
ug,ug,ug,ug,ug,ug,ug,ug,ug,ug,ug,ug,ug,ug,ug,ug,ug,ug,ug,ug,ug,ug,cg
ug,ux,ug,ug,ug,ug,ug,ug,ug,ux,ux,ux,ux,ux,ux,ux,ux,ux,ux,ux,ux,ux,ur
ug,ux,ug,ug,ug,ug,ug,ug,ug,ux,ux,ux,ux,ux,ux,ux,ux,ux,ux,ux,ux,ux,ur
ug,ux,ug,ug,ug,ug,ux,ux,ug,ux,ux,ux,ux,ux,ux,ux,ux,ux,ux,ux,ux,ux,ur
ug,ux,ug,ug,ug,ug,ux,ux,ug,ux,ux,ux,ux,ux,ux,ux,ux,ux,ux,ux,ux,ux,ur
ug,ux,ug,ug,ug,ug,ux,ux,ug,ux,ux,ux,ux,cr,ur,ur,ur,ur,ur,ur,ur,ur,ur
ug,ux,ux,ux,ux,ux,ux,ux,ug,ux,ux,ux,ux,ux,ux,ux,ux,ux,ux,ux,ux,ux,cb
ug,ug,ug,ug,ug,ug,ug,ug,ug,cg,ux,ux,ux,ux,ux,ux,ux,ux,ux,ux,ux,ux,ux