ur,ur,ur,ur,ur,ur,ur,ur,ur,ur,ug,ub,ug,ug,cr,ub,ur,ur,ug,cg,ur,ur,ur
ur,ur,ur,ur,ur,ur,ur,ur,ur,ug,ug,ug,ug,ub,ur,cb,ur,ur,cb,ub,ub,ub,ur
ur,ur,ur,ur,ur,cg,ug,ur,ug,ug,ur,ub,ug,ug,ur,ur,ur,ub,ug,ub,ub,ur,ur
ur,ur,ur,ur,ur,ur,ug,ur,ug,ug,ub,ug,ug,ub,ub,ub,ug,ur,ug,ub,ub,ur,ub
ur,ur,ur,ur,ur,ur,ug,ur,ur,ug,ur,ub,ug,ug,ur,ub,ug,ur,cb,ub,ub,ur,ub
ur,cr,ur,ur,ur,cr,ug,ug,ug,ug,ub,ub,ux,ug,ug,ub,ug,ub,ub,ub,ub,ur,ub
ub,ub,ur,ur,ur,ur,ur,ur,ub,ub,ub,ux,ux,ub,ug,ub,ug,ub,ub,ub,ub,ux,ub
cb,ub,cr,ux,ux,ur,ub,ux,ux,ux,ub,ux,ub,ub,ug,ub,ug,ub,ub,ub,ub,ux,ub
ux,ub,ux,ux,cr,ur,ub,ux,ux,ub,ub,ug,ug,ub,ug,ub,ub,ub,ub,ug,ug,ug,ug
ux,ub,ux,ub,ub,ub,ub,ux,ux,ub,ub,cg,ug,ug,ug,ug,ub,ub,ub,ux,ux,ux,ug
ux,ub,ux,ub,ub,ub,cg,ug,ug,ug,ug,ug,ug,ug,ug,ug,ug,ug,ux,ux,ux,ux,cg
ux,ub,ux,ux,ub,ub,ug,ug,ug,ug,ug,ug,ug,ug,ug,ug,ug,ug,ux,ux,ux,ux,ur
cg,ub,ub,ub,ub,ub,ug,ug,ub,ug,ux,ug,ug,ug,ug,ug,ub,ur,ub,ux,ux,ux,ur
ux,ux,ux,ub,ub,ub,ug,ub,ub,ux,ug,ug,ug,ug,ub,ug,ug,ub,ub,ub,ub,ux,ur
ux,ux,ux,ub,ub,ub,ug,ug,ug,ub,ub,ub,ug,ub,ub,ub,ug,ub,ux,ux,ub,ux,ur
ux,ux,ux,ux,ux,ux,ug,ub,ug,ub,ug,ug,ug,ub,ub,ub,ub,cb,ub,ux,ub,ux,ur
ux,ux,ux,ux,ux,ux,ug,ug,ug,ug,ug,ug,ug,ug,ug,ug,ub,ug,ub,ub,ub,ug,ur
cg,ux,ux,ux,ux,ub,ub,ub,cb,ug,ub,ug,ug,ub,ug,ux,ux,ub,ub,ub,ub,ub,ur
ux,ux,ux,ux,ux,ub,ub,ub,ug,ub,ub,ub,ub,ug,ug,ub,ub,ub,ub,ub,ub,ub,ur
ux,ux,ux,ux,ub,ub,ub,ub,ub,ub,ub,ub,ub,ur,ux,ub,ug,ub,ug,ug,ub,ug,ur
cr,ux,cb,ub,ub,ub,ub,ub,ub,ug,ug,ux,ug,ur,ur,ur,ur,ur,ur,ur,ur,ur,ur
cg,ux,ux,ux,ux,ub,ub,cr,ur,ur,ur,ur,ur,ur,ub,ub,ub,ub,ux,ub,ub,cb,cr
cr,ux,ux,ux,ux,ux,ux,ux,ub,ux,ux,ux,ux,ur,ur,ur,ur,ub,ub,ub,cb,ux,cr