ub,cb,cb,cr,ur,ur,ur,ur,ur,ur,cr,ub,ux,ub,ub,ur,ub,ub,ub,ub,ux,ux,cb
ur,ur,cb,ur,ur,ur,ub,ur,ur,ur,ur,ub,ux,ub,ub,ub,ub,ur,ur,ub,ur,ur,ur
ur,ur,ur,ur,ur,ub,ub,ur,ux,ur,ur,ub,ub,ub,ub,ub,ur,ur,ur,ur,ur,ur,ur
ur,ur,cb,ub,ub,ub,ur,ur,ur,ur,ur,ur,ur,ur,ur,ur,ur,ur,ur,ur,ur,ur,ur
ur,ur,ur,ur,ur,ur,ur,ur,ur,ur,ur,ur,ur,cr,ur,ur,ur,ur,ur,ur,ur,ur,ur
ur,ur,ur,ur,ur,ur,ur,ug,ug,ug,ur,ur,ur,ur,ur,cr,ug,ub,ub,ug,cr,ur,ur
ur,ur,ur,ur,ug,ug,ug,ug,ur,ug,cg,ur,ur,ur,ug,cg,ug,ug,ug,ug,ug,ug,ub
cb,ub,cr,ug,ug,ur,ur,ur,ur,ur,ur,ur,ug,ug,ug,ug,ug,ug,ug,ug,ug,ug,ub
ub,ub,ur,ug,ur,ur,ur,ur,ur,ur,ur,ug,ug,ug,ug,ug,ug,ug,ub,ug,ug,ug,ub
ub,cb,ur,ug,ug,ub,ux,ug,ur,ur,ub,ug,ug,ug,ux,ug,ug,ug,ub,ub,ug,ug,ub
ub,ub,ub,ub,ug,ub,ub,ug,ub,ub,ub,ug,ug,ug,ug,ug,ug,ux,cg,ub,ug,ug,ub
ux,ub,ub,ub,ug,ug,ug,ug,ub,ug,ug,ug,ug,ug,ug,ug,ux,ux,ug,ub,ug,ug,ub
cb,ub,ub,ub,ub,ug,ug,ug,ug,ub,ug,ug,ub,ug,ug,ug,ux,ux,ug,ub,ug,ug,ux
cb,ub,ug,ug,ub,ug,ug,ug,ug,ug,ub,ub,ub,ug,ug,ur,ub,ux,ug,ub,ug,ug,ux
ux,ux,ug,ug,ug,ug,ug,ug,ug,ug,ug,ug,ub,ug,cg,ur,ub,ux,ug,ub,ug,ug,ub
ux,ux,ug,ug,ug,ug,ug,ux,ug,ux,ux,cb,ub,ub,ug,ur,ub,ub,ug,ug,ug,ug,ub
ux,ux,ug,ug,ub,ug,ug,ug,ug,ux,ux,ub,ub,ur,ug,ur,ub,ub,ub,ug,ug,ug,ub
cr,ug,ug,ug,ux,cg,ug,ug,ur,ur,ur,ur,cr,ug,ug,ug,ug,ub,ub,ug,ug,ug,ub
cg,ug,ug,ug,ux,ux,ug,ur,ub,ux,ux,ux,ux,ur,ug,ug,ug,ux,ux,ug,ug,ug,ux
cb,ux,ug,ug,ug,ug,cb,ub,ub,ug,ug,ug,ug,ug,ug,ug,ug,ug,ug,ug,ug,ug,ux
ux,ur,ur,ur,ur,ug,ug,ub,ub,ub,ub,ug,ug,ur,ug,ug,ug,ug,ug,ug,ug,ug,cr
cr,ur,ur,ur,ur,cg,ur,ur,ub,ub,ub,ur,ug,ur,ug,ug,ug,ub,ub,cb,cb,ug,cr
cg,ur,cg,cb,ux,ux,ux,ux,ux,ur,ug,ug,ug,ur,ur,cg,ux,ux,ux,cg,cg,ug,cr