ur,ur,cb,ur,ur,ur,ur,ur,ur,cg,cb,ub,ub,ub,ub,ux,ux,cb,ux,cg,ux,ur,ur
ur,ur,ub,ub,ur,ur,ur,ur,ur,ur,ur,ux,ux,ux,ub,ux,ux,ux,ux,ug,ux,ur,ur
ur,ur,ur,cr,cr,ur,ur,ur,ug,ur,ur,ur,ub,ub,ub,ug,ug,ub,ub,ug,ub,ur,ur
ur,cg,ug,ug,ug,ur,ur,ug,ug,ur,ur,ur,ub,ub,ub,ux,ug,ug,ug,ug,ug,ur,ur
ur,ur,ur,ug,ug,ur,ug,ug,ug,cg,ur,ur,ub,ub,ub,ub,ub,ub,ub,ub,ug,ur,ur
ur,ur,cr,cr,cr,ur,ug,ug,ug,ur,ur,ur,ub,ub,ub,ub,ub,ux,ux,ux,ug,ur,ur
ur,ur,ur,ur,ur,ug,ug,ug,ug,ug,ux,ux,ux,ux,ub,ub,ub,ux,ux,ub,ub,ur,ur
ur,ug,ug,ux,ug,ug,ug,ub,ug,ug,ub,ub,ub,ug,ug,ug,ug,ug,ug,ug,ux,ur,ur
ur,ur,ur,ur,cr,ug,ub,ug,cg,ug,ug,ug,ub,ug,ug,ug,ug,ug,ug,ug,ux,ur,ur
ur,ux,ub,ub,ub,ug,ug,ug,ug,ug,ug,ug,ub,ug,ug,ug,ug,ug,ug,ug,ux,ur,ur
ur,ub,ub,ub,ub,ub,ub,ug,ub,ug,ug,ug,ux,ug,ug,ug,ug,ug,ug,ux,ug,ur,ur
ur,ub,ub,ub,ub,ub,ug,ug,ub,ub,ub,ub,ub,ug,ug,ux,ug,ug,ug,ux,ug,ur,ur
ur,ub,ub,ub,ub,ug,ug,cb,ub,ub,ub,ub,ug,ug,ug,ug,ug,ub,ug,ux,ux,ur,ur
ur,ub,ub,ub,ub,ub,ub,ub,ub,ub,ub,ub,ug,ub,ug,ug,ug,ug,ug,ux,ux,ur,ur
ur,ub,ub,ub,ub,ub,ub,ug,ug,cb,ug,ub,ug,ub,ug,ug,ug,ux,ux,ux,ux,ur,ur
ur,ub,ub,ub,ub,ub,ub,ug,ug,ub,ub,ub,ug,ub,ug,ug,ug,ug,ux,ux,ux,ur,ur
ur,ub,ub,ug,ub,cb,ub,ub,ug,ug,ub,ub,cg,ub,ug,ug,ux,ug,ux,ux,ux,ur,ur
ur,ub,ub,ub,ub,ub,ub,ub,ug,ug,ub,ub,ub,ub,ug,ug,ug,ug,ux,ux,ux,ur,ur
ur,ux,ux,ug,ug,ug,ub,ub,ub,ug,ug,ug,ux,ux,ug,ug,ux,ux,ux,ux,ux,ur,ur
ur,ux,ux,ub,ux,ub,ug,ub,ub,ub,ub,ub,ux,ub,ub,ub,ub,ux,ux,ux,ux,ur,ur
ur,ur,ur,ur,ur,ur,ur,ur,ur,ur,ur,ub,ur,ur,ur,ur,ur,ur,ur,ur,ur,ur,ur
cr,ux,ub,ub,ux,ub,ub,ub,ub,ux,ux,ub,ux,ux,ux,ub,ub,ub,cb,ux,ux,ur,cb
cg,ux,ub,ub,ux,ux,ux,ux,ux,ux,ux,ub,ub,ub,ub,ub,ub,ub,ub,ur,ur,ur,ur