ur,cb,cb,cr,ur,ur,ur,ur,ur,ur,ur,ur,ur,ur,ur,ur,cg,ur,ub,cr,ur,ur,cb
ur,cb,cb,ur,ur,ux,ux,cr,ur,ur,ur,ur,ur,ur,ur,ur,ug,ur,ub,ur,ur,ur,ur
ur,ur,ur,ur,ux,ux,ux,ux,ur,ur,ur,ur,ur,ur,ur,ur,cr,ur,ub,cb,ur,ur,ur
ub,ux,ub,ub,ur,ur,ur,ur,ur,ur,ur,cr,ug,ug,ug,ur,ur,ur,ur,ur,ur,ur,ur
ub,ux,ub,ub,ur,ur,ur,ur,ur,ur,ur,ur,ur,ug,ug,ug,ug,ug,cg,ur,ur,ur,ur
ub,ux,ux,ux,ur,ur,ur,ur,ux,ux,ur,ur,ur,ur,ur,ur,ur,ur,ur,ur,ur,ur,ur
ub,ub,ub,ur,ur,ur,ur,ur,ur,ur,ur,ur,ur,ug,ug,ug,ug,ug,ur,ur,ur,ur,ur
cb,ux,ub,ur,ur,ur,ur,ur,ur,ux,ur,ur,cg,ug,ug,ug,ux,ux,ux,ux,ub,ux,ux
ux,ur,ub,ug,ur,ur,ux,ub,ub,ub,ub,ur,ur,ur,ug,ug,ug,ug,ug,ug,ub,ub,ub
ux,ur,ub,ur,ur,ur,ur,ub,ub,ub,ub,ug,ug,ug,ug,cg,ug,ug,ux,ux,ux,ux,ub
ur,ur,ub,ur,ur,ur,ur,ub,ub,ub,ub,ux,ux,ux,ug,ug,ug,ug,ux,ub,ub,ub,ub
ur,ur,ub,ur,ur,ur,ug,ub,ub,ub,cb,ug,ug,ug,ug,ug,ug,ug,ux,ub,ub,ub,ub
cb,ur,ub,ur,ur,ur,ur,ub,ub,ur,ur,cr,ug,ug,ug,ug,ug,ug,ux,ux,ux,ux,ub
ur,ur,ub,ub,ub,ub,ub,ub,cb,ur,ub,ub,ub,ug,ug,ug,ug,ug,ug,ux,ux,ux,ux
ur,ur,cb,ub,ug,ug,ux,ug,cr,ur,cb,ub,ub,ub,ug,ug,ug,ug,ug,ux,ux,ux,ux
cg,ug,ug,ub,ux,ux,ug,ug,ug,ug,ug,ub,ub,ub,ug,ug,ug,ug,ug,ux,ux,ux,ux
ux,ug,ug,ub,ug,ug,ug,ug,ug,ug,ug,ub,ub,ub,ub,ub,ug,ug,ug,ub,ub,ub,ub
ux,ug,ug,ub,ug,ug,ug,ug,ux,ux,ug,ug,ux,ux,ub,ux,ub,ug,ug,ub,ub,ub,ub
ux,ug,ug,ub,ug,ux,ug,ug,ux,ux,ub,ux,ux,ux,ub,ux,ug,ug,ux,ux,ux,ux,ub
ux,ug,ug,ub,ug,ux,ug,ug,ug,ug,ug,ug,ug,ug,ug,ug,ug,ux,ub,ub,ub,ub,ub
cr,ug,ug,ub,ub,ub,ug,ug,ug,ug,ug,ux,ux,ux,ux,ux,ux,ux,ub,ux,ux,ux,cr
cg,ug,ug,ug,ug,ug,ug,ug,ug,ug,ug,ub,ub,ub,ub,ub,ub,ub,ub,cb,cb,ux,cr
cr,cg,cg,cb,ug,ug,cg,ug,ug,ux,ux,ux,ux,ux,ux,cg,ur,ur,ur,cg,cg,ux,cr