ux,ux,ur,ur,ur,ur,ur,ur,ur,ur,ur,ur,ur,ur,ur,ur,cr,ux,ur,ur,cr,ub,ub
ux,ux,ux,ur,ur,ur,ur,ur,ur,ur,ur,ur,ur,ux,ux,ux,ur,ur,ur,ur,ur,ur,cb
ux,ur,ur,ur,ur,ur,ur,ur,ur,ur,ur,ur,ur,cr,ux,ux,ur,ub,ub,ub,ub,ub,ub
ux,ur,ur,ur,ur,ur,ur,ur,ur,ur,ur,ur,ur,ur,ug,ug,ur,ub,ub,ub,ub,ux,ub
ux,ur,ur,ur,ur,ur,ur,ur,ur,ur,ur,ur,ur,ug,ur,ug,ur,ur,ub,ub,ub,ub,ub
ur,cb,ux,ur,ur,ur,ur,ur,ur,ur,ur,ur,ur,ur,ur,ug,ur,ur,ur,ur,ub,ub,ub
ur,ub,ux,ur,ur,ur,ur,ur,ur,ur,ur,ur,ur,ur,ur,cr,ur,ur,ux,ur,ub,ub,ub
ur,ub,ur,ur,ur,ur,cr,ur,ur,ur,ur,ur,ur,ur,ur,ur,ug,ug,ug,ug,ug,ug,ug
cg,ub,ur,ur,ur,ur,ug,ur,ur,ug,ug,cg,ur,ur,ur,ur,ub,ub,ub,ub,ub,ub,ug
ub,ub,ur,ur,ux,ux,ug,ug,ur,ug,ur,ub,ur,cb,ub,ub,ub,ub,ub,ub,ub,ub,ug
ub,ur,ur,ur,ux,cg,ug,ug,ub,ug,ug,ug,ug,ug,ub,ug,ub,ub,ur,ur,ur,ur,ug
ub,ub,ur,ur,ur,ur,ur,ub,ub,ub,ur,ub,ub,ub,ub,ug,ub,ub,ux,ub,ub,ub,cg
ub,ub,ur,ur,ur,ur,ur,ub,cb,ub,ur,ur,ur,ug,ug,ug,ub,ub,ux,ux,ux,ux,ux
ub,ub,ur,ur,ur,ur,ur,ur,ub,ux,ux,ux,ub,ug,ur,ub,ub,ub,ux,ux,ux,ux,ux
cg,ub,ux,ux,ux,ux,ub,ub,ub,ub,ub,ux,ub,ug,ub,ub,ux,ub,ux,ux,ux,ux,ux
ub,ub,ug,ug,ug,ug,ub,ub,ub,cb,ub,ub,ub,ub,ub,ub,ub,ub,ux,ux,ux,ux,ux
ub,ur,ug,ug,ug,ug,ub,ub,ub,ub,ub,ub,ub,ub,ub,ub,ub,ub,ux,ux,ux,ux,ux
ub,ub,ug,ux,ug,ug,ub,ub,ub,ub,ub,ub,ub,ux,ub,ux,ux,ub,ux,ux,ux,ux,ux
ub,ub,ug,ug,ug,ug,ub,ub,ug,ux,ub,ub,ux,ux,ub,ux,ux,ub,ux,ux,ux,ux,ux
ub,ub,ug,ug,ug,ug,ub,ub,ug,ug,ug,ux,ux,ux,ub,ux,ux,ub,ux,ux,ux,ux,ux
ub,ub,ux,ux,ux,ux,ux,ur,ux,ux,ux,ux,ux,ux,ub,ux,ub,ub,ux,ux,ux,ux,ux
ub,ub,ub,ub,ub,ub,ub,ub,ub,ub,ub,ub,ux,ux,ub,ux,ub,ux,ux,ux,ux,ux,cb
ub,ub,ux,ux,ux,ux,ux,ux,ux,cg,ux,ub,ub,ub,ub,cb,ur,ur,ur,ur,cr,ux,ux