ur,ux,ux,ur,ur,ur,ur,ur,ur,ur,ur,ur,ur,ur,ur,ur,ur,ur,ur,ur,ur,ur,ur
ur,ur,ur,ur,ur,ur,ur,ur,ur,ur,ur,ur,ur,ur,ur,ur,ur,ur,ur,ur,ur,ur,ur
ur,ur,ur,ur,ur,ur,ur,ur,ur,ur,ur,ur,ur,ur,ur,ur,ur,ur,ur,ur,ur,ur,ur
ur,ux,ur,cb,ur,ur,ur,ur,ur,ur,ur,ur,ur,ur,ur,ur,ur,ur,ur,ur,ur,ur,ur
ur,ur,ur,ub,ub,cr,ur,ur,ur,ur,ur,ux,ur,ur,ur,ur,ur,ur,ur,ur,ur,ur,ur
ur,ur,ur,ur,ur,ur,ur,ur,ur,ur,ur,ur,ur,ur,ur,ur,ur,ur,ur,ur,ur,ur,ur
ur,ur,ur,ur,ur,ur,ug,ug,ug,ur,ur,ur,ur,ug,cg,ur,ur,ur,ur,ur,ur,ur,ur
ur,ur,ur,ur,ur,ur,ur,ub,cb,ur,ur,ur,cr,ug,cr,ur,ug,ur,ur,ur,ur,ur,ur
cg,ur,ur,ur,ur,ur,ur,cr,ug,ub,ub,ug,ug,ug,ug,ug,ub,ur,ur,ur,ur,ur,ug
ur,ur,ur,ur,ur,ur,ub,ug,ug,ur,ur,ub,ug,ug,ub,ug,ub,ub,ub,ux,ux,ux,ug
ur,ur,ur,ur,ur,ux,ux,ug,cg,ur,ur,ub,ug,ux,ub,ug,ux,ux,ux,ux,ux,ux,ug
ux,ux,ux,cr,ux,ux,ux,ub,ub,ub,ub,ug,ug,ux,ub,ug,ux,ux,ug,ux,ux,ux,ug
ux,ux,ux,ux,ux,ux,ux,ub,ub,ub,ub,ug,ux,ux,ux,ug,ux,ux,ug,ux,ux,ux,ug
ux,ux,ux,ux,ux,ux,ux,ub,ug,ub,ub,ub,ux,ux,ug,cb,ub,ug,ug,ux,ux,ux,ug
cg,ux,ux,ux,ux,ux,ux,ux,ub,ub,cb,ub,ub,ub,ub,ub,ub,ub,ub,ub,ub,ub,ub
ux,ux,ux,ux,ux,ux,ux,ug,ub,ub,ub,ub,ub,ub,ub,ub,ub,ub,ub,ub,ux,ub,ub
ux,ux,ux,ux,ux,ux,ux,ug,ug,ug,ub,ub,ub,ub,ub,ub,ub,ub,ub,ub,ux,ub,ub
ub,ub,ub,ub,ub,ub,ub,ub,ub,ub,ub,ug,ur,ug,ug,ub,ug,ug,ug,ug,ug,ug,ug
ub,ux,ub,ub,ub,cb,ux,ux,ux,ug,ub,ub,ur,ux,ux,cb,ub,ub,ux,ux,ux,ub,ug
ub,ux,ub,ux,ux,ux,ux,ux,ux,ug,ub,ub,ur,ub,ub,ub,ub,ub,ub,ub,ub,ub,ug
ub,ux,ub,ub,ub,ub,ub,ub,ub,ux,ub,ux,ur,ux,ux,ux,ux,ux,ux,ux,ux,ux,ug
ub,ux,ux,ux,ub,ub,ub,ub,ub,ux,ub,ub,ur,ub,cr,cg,ub,ux,ub,ub,ub,ux,ug
ub,ub,ub,ub,ub,ub,ub,ub,ub,cg,ub,ub,ur,ur,ur,ug,ug,ug,ug,ug,ug,ug,ug