ur,ur,cb,ur,ur,ur,cr,ur,ur,ur,ur,ur,ur,ur,ur,ur,ux,ux,ux,cg,ug,ug,ug
ur,ur,ur,ur,ur,ur,ur,ub,cb,ur,ur,ur,ub,ub,ur,ur,ux,ux,ux,ug,ug,ug,ug
ur,ur,ur,ur,ur,ur,ub,ur,cr,ub,ur,ur,ub,ub,ur,ug,ug,ug,ub,ug,ug,ur,ug
ur,ur,ur,ur,ur,ur,ub,ub,ub,ub,ur,ub,ub,ur,ug,ug,ug,ug,ub,ug,ug,ug,ug
ur,ur,ub,ur,ur,ur,ur,ur,ub,ub,ur,ur,ur,cr,ur,ug,ub,ub,ub,ux,ug,ug,ug
ur,ur,ur,ur,ur,ur,ur,ur,ur,ub,cr,ur,ug,ug,ug,ug,ug,ug,ug,ug,ug,ug,ug
ur,cr,ug,ur,ur,ub,ux,ux,ux,ub,ux,ur,ur,ub,ur,ug,ug,ug,ug,ux,ux,ug,ug
ug,ux,ux,ub,ur,ub,ux,ux,ux,ub,ug,ug,ug,ub,ur,ug,ux,ub,ug,ux,ux,ug,ug
ug,ug,ug,ug,ug,ug,ug,ug,ug,ub,ug,ug,ug,ub,ub,ug,ug,ug,ug,ux,ux,ug,ug
ux,ux,ux,ux,ur,ur,ur,ux,ug,cb,ug,ug,ug,cb,ub,ug,ux,ug,ug,ub,ub,ub,ub
cb,ux,ux,ux,ux,ux,ux,ux,ug,ug,ug,ug,ub,ug,ub,ub,ub,ub,ug,ug,cg,ub,ub
ux,ux,ux,ux,ux,ux,ug,ug,ug,ux,ux,ub,ub,ub,ug,ug,ub,ub,ug,ub,ub,ub,ub
ux,ux,ux,ux,ux,ux,ug,ug,ug,cg,ug,ug,ug,ug,ug,ur,ur,ug,ug,ub,ub,ug,ug
ux,ux,ux,ux,ux,ux,ug,ug,ug,ug,ug,ug,ug,ug,ug,ug,ub,ug,ug,ub,cg,ug,ug
ux,ux,ux,ux,ug,ug,ug,ug,ug,ug,ug,ux,ug,ub,ub,ug,cb,cb,ug,ub,ug,ug,ug
cg,ur,ur,ur,ur,ur,ur,ur,ur,ur,ur,ur,ug,ur,ur,ub,ub,ub,ur,ub,ug,ug,ug
ux,ur,ug,ug,ug,ux,ug,ug,ug,ug,ug,ug,cg,ug,ug,ub,ug,ub,ub,ub,ug,ub,ug
ux,ur,ug,ug,ug,ux,ux,ug,ux,ug,ug,ug,ug,ug,ug,ub,ub,ug,ug,ug,ug,ub,ug
ux,ur,ug,ug,ug,ux,ux,ug,ug,ug,ug,ug,ug,ux,ux,ub,ub,ug,ug,ug,ub,ub,ug
ux,cr,ug,ug,ug,ux,ux,ug,ug,ug,ug,ug,ub,ub,ug,ub,ub,ug,ug,ug,ub,ug,ug
cr,ug,ug,ug,ug,ux,ux,ug,ux,ug,ug,ub,ub,ub,ug,ub,ub,ub,ub,ub,ub,ub,ub
cg,ug,cg,ux,ug,ux,ug,ug,ug,ug,ug,ug,ux,ux,ub,ub,ub,ub,ub,ub,ub,cb,cr
cr,ux,ux,ux,ug,ug,ug,ug,ug,ug,ug,ug,ub,ub,ub,ux,ux,ux,ux,ux,cb,ux,cr