ur,ur,ur,ur,ur,ur,ur,ur,ur,ur,ur,ur,ur,ur,ur,ur,ur,cb,ur,ur,ur,ub,ub
ur,ur,ur,ur,ur,ur,ur,ur,ur,ur,ur,ur,ur,cg,ug,ug,ur,ur,ur,ur,ub,ub,ub
ur,ur,ur,ur,ur,ur,ur,ur,ub,ub,ub,ub,ur,ur,ur,ug,cr,cr,ur,ur,ub,ur,ub
ur,ur,ur,ur,ur,ur,ur,ur,ub,ur,ur,cr,ur,ur,ur,ur,ug,ur,ur,ur,ub,ub,ub
ub,cb,ur,ur,ur,cg,ug,ur,cb,ug,ug,ub,ur,ug,ug,ug,ug,ug,ug,ur,ur,ub,ur
ur,ur,ur,ur,ur,ur,ug,ux,ur,ub,ub,ub,ug,ug,ug,ub,ug,ug,ug,ur,ur,cb,ur
ur,ur,ur,ur,ur,ur,ug,cr,ur,ug,ur,ur,ub,ug,ug,ux,ug,ug,ug,ur,ur,ur,ur
ur,ur,ur,ur,ur,ur,ur,ur,ur,ug,ug,ur,ug,ug,ug,ug,ug,ug,ug,ug,ux,ug,ux
ur,ur,ur,cr,ux,ug,ug,ug,ub,ug,ug,ug,ug,ug,ug,ug,ur,ug,ux,ux,ug,ug,ur
ux,ux,ux,ub,ug,ug,ug,ug,ub,ug,ug,ub,ug,ug,ug,ug,ur,ug,ur,ug,ug,ur,ur
ux,ux,ug,ug,ug,ug,ug,ug,ub,ug,ug,ug,ug,ug,ug,ug,ub,ub,ub,ug,ur,ur,ur
ux,ux,ug,ug,ug,ug,ux,ug,ub,ug,ub,ub,ug,ug,ub,ug,ub,ug,ug,ur,ur,ur,ur
ux,ux,ug,ug,ux,ux,ux,ug,ub,ug,ug,ug,ug,ug,ug,ug,ug,ug,ur,ur,ur,ur,cg
ur,ur,ug,ug,ug,ug,ug,ug,ug,ug,ug,ug,ug,ug,ug,ug,ug,ug,ur,ur,ur,ur,ur
ur,ux,ux,ug,ug,ug,ux,ug,ub,cb,ub,ub,ub,ub,ug,ub,ux,ux,ug,ur,ur,ur,ur
ur,ux,ux,ug,ux,ux,ux,cg,ub,ub,ug,ub,ub,ub,ug,ub,ux,ub,ug,ug,ur,ur,ur
ur,ur,ur,ur,ur,ur,ur,ur,ub,ur,ur,ur,ur,ur,ur,ur,ur,ur,ur,cr,ug,ur,ur
cg,ux,ux,ux,ux,ux,ug,ub,ub,ub,ub,ub,ub,ub,ub,ug,ug,ub,ub,ur,ug,ug,ur
ux,ub,ub,ub,ub,ux,ug,ub,ub,ub,ug,ug,ug,ux,ux,ub,ug,ug,ug,ug,ug,ug,ur
ux,ub,ub,ub,ub,ub,ug,ux,ux,ux,ux,ux,ux,ux,ux,ux,ux,ux,ux,ur,ur,ur,ur
ux,ub,cb,ub,ux,ux,ug,ux,ux,ux,ux,ug,ug,cg,ux,ux,ux,ux,ux,ur,ur,ur,ur
cr,ub,ub,ub,ux,ux,ug,ux,ux,ux,ux,ug,ux,ux,ux,ux,ux,ux,ux,ur,ur,cb,cr
cg,ux,ub,ub,ux,ux,ug,ug,ug,ug,ug,ug,ux,cb,ux,ux,ux,ux,ux,cg,cb,ux,cr