ur,ur,ur,ur,ur,ur,ur,ur,ur,cg,ur,ur,ur,ur,ur,ur,ur,cb,ux,ug,ug,ub,ub
ur,ur,ur,ur,ur,ur,ur,ub,ub,ub,ur,ur,ur,ux,ur,ux,ur,ux,ux,ug,ux,ub,ub
ur,ur,ur,ur,ur,ur,ur,cr,cr,cb,ux,ux,ur,cr,ur,ur,ur,ux,ux,ug,ux,ub,ub
ur,ur,ur,ur,ur,ur,ur,ur,ur,ub,ub,ub,ub,ur,ub,ux,ug,ug,ug,ug,ux,ub,ub
ur,ug,ug,ug,ur,ur,ur,ur,ur,cr,ub,ub,ub,ub,ub,ub,ub,ug,ug,ub,ug,ub,ub
cr,ug,ur,ug,ur,ur,ur,ur,ur,ub,ub,ub,ub,ux,ub,ub,ub,ug,ug,ug,ug,ub,ub
ur,ur,ur,ug,cg,ur,ur,ur,ur,ub,ub,ub,ub,ux,ux,ux,ux,ux,cb,ug,ug,ub,ub
ur,ur,ur,ur,ur,ur,ur,ur,ur,ur,ur,ur,cr,ub,ub,ub,ux,ux,ub,ux,ug,ub,ub
ur,ur,ug,ug,ug,ug,ur,ug,ur,ub,ub,ub,ub,ub,ub,ub,ug,ug,ub,ug,ug,ub,ub
ur,ur,ug,ug,ug,ur,ug,ug,ub,ub,ub,ub,ub,ub,ub,ux,ux,ug,ub,ux,ug,ub,ub
ur,ur,ur,ug,ug,ug,ug,ug,ug,ug,ub,cb,ub,ub,ub,ub,ub,ug,ub,ux,ug,ux,ub
ur,cg,ux,ug,ub,ub,ug,ug,cg,ug,ug,ug,ug,ug,cb,ub,ub,ub,ub,ux,ug,ux,ub
ur,ug,ux,ug,ug,ub,ub,ug,ug,ub,ug,ub,ub,ub,ug,ug,ub,ub,ub,ux,ug,ux,ub
ur,ug,ug,ur,cg,ux,ug,ug,ug,ub,ub,ub,ub,ub,ug,ug,ug,ug,ub,ux,ug,ux,ub
ur,ux,ug,ur,ug,ux,ub,ub,ub,ub,ub,ug,ub,ub,ug,ug,ug,ug,ub,ug,ug,ug,ub
ur,ux,ug,ug,ug,ug,ub,ug,ug,ub,ub,ug,ug,ub,ux,ux,ux,ux,ub,ux,ub,ug,ub
ur,ux,ux,ug,ux,ug,ub,ub,ug,ug,ug,cg,ug,ux,ux,ux,ux,ux,ub,ux,ub,ug,ub
ur,ux,ux,ug,ux,ug,ug,ub,ub,ug,ug,ug,ug,ux,ux,ug,ug,ug,ub,ug,ub,ug,ub
ur,ux,ux,ug,ux,ug,ug,ug,ub,ug,ub,cb,ug,ux,ux,ug,ux,ux,ub,ug,ub,ug,ub
ur,ux,ux,ug,ux,ug,ux,ub,ub,ub,ub,ub,ug,ux,ux,ug,ux,ux,ub,ub,ub,ug,ub
ur,ur,ub,ug,ux,ug,ug,ug,ug,ub,ux,ub,ub,ub,ux,ug,ux,ux,ub,ub,ub,ug,ux
cr,ub,ub,ug,ux,ub,ub,ub,ub,ub,ub,ub,ub,ub,ub,ug,ux,ux,ub,ub,ub,ug,cb
cg,ub,ub,ug,ug,ug,ug,ug,ug,ug,ub,ub,cb,ub,ub,ur,ur,ur,ur,ub,ub,ug,ug