ur,ur,ur,ur,ur,ur,ur,ub,ub,ur,ur,ur,ur,ur,ur,ur,ur,cb,ur,ur,ur,ur,ur
ur,ur,ur,ur,ur,ur,ur,ub,ub,ur,ur,ur,ur,ur,ur,ur,ur,ux,ur,ur,ur,ur,ur
ur,ur,ur,ur,ur,ur,cr,cr,cr,ur,ur,ur,ur,ur,ur,ur,ur,ug,ug,ug,ug,ug,ur
ur,ur,ur,ur,ur,ur,ur,ub,ug,ur,ur,ur,ur,ub,ur,ur,ur,ug,ug,ug,ug,ug,ur
ur,ur,ur,ur,ur,cb,ub,ub,ug,ub,ux,ug,ug,ub,ub,ur,ur,ur,ur,ug,ug,ug,ur
ur,ug,ur,ur,ur,ug,ur,cr,ug,ub,ux,ug,ug,ug,ub,ub,ub,ub,ur,ug,ug,ug,ur
cr,ug,ug,ur,ur,ur,cg,ug,ug,ub,ur,ug,ux,ux,ub,ub,cg,ug,ug,ug,ug,ug,ur
ur,ur,ug,ug,ug,ub,ug,ub,ub,ub,ux,ug,ux,ux,ub,ug,ug,ug,ug,ur,ug,ug,ur
ux,ur,ub,ug,ug,ub,ug,ug,ug,ug,ux,ug,ux,ub,ub,ug,ub,ub,ug,ug,ug,ug,ug
ux,ux,ub,ub,ug,ug,ug,ux,ug,ug,ux,ug,ub,ub,ub,ug,ub,ug,ux,ug,ux,ux,ug
ux,ux,ub,ub,ub,ub,ux,ux,ux,ux,ub,ug,ub,ub,ub,ub,ub,ub,ux,ug,ug,ux,ug
ux,ux,ub,ub,ub,ub,ux,ux,ux,ug,ug,ug,cb,ub,ub,ub,ub,ub,ux,ub,ug,ux,ug
ux,ux,ub,ub,ub,ub,ux,ub,ub,ug,ug,cg,cb,ub,ux,ux,ub,ug,ux,ub,ug,ug,ug
ux,ux,ub,ub,ub,ub,ux,ux,ux,ug,ug,ub,ub,ub,ub,ub,ub,ug,ux,ub,ux,ug,ug
cg,ux,ub,ub,ub,ub,ux,ux,ux,ug,ub,ub,ub,ub,ub,ub,ug,ug,ux,ub,ux,ug,ug
ur,ur,ur,ur,ur,ur,ur,ur,ur,ur,ur,ur,ur,ur,ur,cr,ux,ub,cb,ub,ux,ug,ug
ur,ux,ub,ub,ux,ux,ug,ux,ux,ug,cb,ub,ug,ug,ub,ub,ub,ub,ub,ub,ux,ug,ug
ur,ux,ub,ub,ux,ux,ug,ug,ug,ug,ub,ub,ub,ub,ub,ub,ub,ub,ub,ub,ux,ug,ug
ur,ux,ub,ub,ux,ux,ux,ub,ub,ux,ub,ub,ug,ug,ug,ub,ub,ub,ub,ur,ux,ug,ug
ur,ux,ub,ub,ux,ux,ux,ux,ub,ub,ub,ub,ub,ux,ux,ub,ub,ub,ub,ub,ux,ug,ug
ur,ur,ur,ur,ur,ur,cg,ug,ug,ug,ug,ug,ug,ug,ug,ug,cb,ub,ub,ug,ug,ug,ug
cr,ux,ub,ub,ux,ux,ux,ug,ux,ux,ub,ub,ub,ub,ux,ux,ux,ux,ub,ux,ux,ux,cb
cg,ux,ub,ub,ug,ug,ug,ug,ux,cg,ub,ub,ub,ux,ux,ux,ux,ux,ub,ub,ub,ub,ub