cb,ub,ur,ur,ur,ur,ur,ur,ur,ur,ux,ur,ur,ur,ur,ur,ur,cb,ur,ur,ur,ur,cg
ur,ub,cr,cr,ur,ur,ur,ur,cr,ug,ug,ug,ug,ug,ur,ur,ur,ur,ur,ur,ur,ur,ug
ur,ur,ur,cr,ur,ur,ur,ur,cg,ub,ur,ur,ur,ug,ur,ur,ur,ur,ur,ur,ur,ug,ug
ug,ug,ug,ug,ug,ug,cg,cr,cb,ub,ub,cb,ug,ug,ux,ug,ur,ur,ur,ur,ux,ug,ug
ug,ur,ur,ug,ub,ub,ub,ur,ur,ub,ur,ur,ug,ur,ub,ug,ur,ur,ur,ur,ug,ux,ug
ug,ur,ur,ug,ur,ug,ug,ub,ub,ub,ur,ur,ug,ug,ub,ub,ur,ur,ur,ur,ug,ux,ug
ug,ub,ub,ug,ug,ug,ug,ug,ub,ub,ug,ug,ug,ux,ub,ux,cg,ur,ur,ur,ux,ux,ug
ug,ub,ux,ux,ug,ub,ug,ug,ub,ux,ug,ub,ug,ub,ub,ux,ug,ur,ur,ur,ux,ux,ug
ug,ub,ux,ux,ug,ub,ug,ug,ux,ux,ug,ub,ub,ub,cb,ub,ug,ur,ur,ur,ux,ux,ug
ug,ub,ub,ux,ug,ub,ub,ug,ug,ug,ug,ub,ub,ug,ub,ub,ug,ur,ur,ur,ux,ux,ug
ug,ux,ub,ux,ug,ux,ux,ux,ug,ug,ub,ub,ub,ug,ub,ub,ug,ur,ur,ur,ux,ux,ug
ug,ux,ub,ux,ug,ux,ux,ux,ug,ub,ub,ub,ub,ug,ug,ug,ur,ur,ur,ur,ug,ug,ug
ug,ux,ub,ub,ug,ug,ug,ug,ug,ub,ub,ub,ub,ub,ug,ug,ur,ur,ur,ur,ux,ux,cg
ug,ux,ux,ub,ub,ux,ux,ux,ux,ub,ub,ub,ub,ub,ug,ux,ux,ug,ug,ur,ug,ux,ux
ug,ux,ux,ux,ux,ux,ux,ux,ux,ub,ub,ux,ux,ux,ug,ux,ux,ur,ux,ur,ug,ux,ux
ug,ug,ug,ug,ug,ug,ug,ug,ug,ub,cb,ug,ug,ug,ug,ub,ub,ub,ub,ur,ug,ux,ux
ux,ux,ux,ux,ux,ux,ux,ux,ux,ux,ux,ux,ux,ux,ux,ux,ub,ub,ub,ur,ux,ux,ux
cg,ux,ux,ux,ux,ux,ux,ux,ux,ux,ux,ux,ux,ux,ux,ux,ub,ur,ux,ur,ux,ux,ux
ub,ub,ub,ub,ub,ub,ub,ub,ub,ub,ub,ub,ub,ub,ub,ub,ub,ur,ux,ur,ur,ur,ur
ub,ux,ux,ux,ux,ux,ux,ux,ux,ux,ux,ux,ur,ur,ur,ur,ur,ur,ux,ux,ux,ux,ur
ub,ub,ub,ub,ub,ub,ub,ub,ub,ub,cb,ur,ur,ur,ur,ur,ur,ur,ur,ur,ur,ur,ur
cr,ux,ux,ux,ux,ux,ux,ux,ux,ux,ux,ux,ur,ur,ur,ur,ur,ur,ur,ux,ux,cb,cr
cg,ux,cr,ur,ur,ur,ur,ur,ur,ur,ur,ur,ur,ur,ur,ur,ur,ur,ur,cg,cb,ux,cr