ux,cb,ux,ux,cr,ur,ur,ur,ur,ur,ur,ur,ur,ur,ur,ur,ur,ur,ur,ur,ur,ur,ur
ux,ub,ub,ub,ur,ur,ur,ur,ur,ur,ur,ur,ur,ur,ur,ur,ur,ur,ur,ur,ur,ur,cr
ux,ux,ug,ug,ug,ug,ub,ub,ub,ub,ux,ux,ux,ur,ur,ur,ur,ur,ur,ur,ur,ur,ur
ux,ug,cg,ug,ug,ug,ur,ug,ug,ug,ug,ur,ur,ur,ur,ur,ur,ur,ur,ur,ur,ub,ur
ur,ug,ug,ug,ug,ug,ug,ug,ug,ug,ug,ur,ur,ur,ur,ur,ur,ur,ur,ur,ux,ub,ux
ur,ur,ur,cr,ug,ug,ub,ur,ur,ur,ur,ur,ur,ur,ur,ur,ur,ur,ur,ur,ux,ub,ux
ur,ur,ur,ur,ur,ug,ug,ur,ur,ur,ur,cg,ur,ur,ur,ur,cr,ug,ur,ur,ur,ub,ur
ur,ur,ur,ub,ub,ub,ub,ub,ub,ug,ug,ug,ur,ur,ug,ur,ur,cg,ur,ur,ur,ub,ur
ur,ur,ur,ug,ug,ug,ug,ug,ug,ug,ub,ub,ug,ug,ug,ug,ur,ur,ur,ur,ur,ub,ur
ur,ur,ur,ur,ur,ur,ur,ur,ur,ub,ub,ub,ur,ug,ug,ug,ug,ug,ur,ur,ur,ub,ur
ur,ur,ur,ur,ur,ur,ur,ur,ur,ur,ur,ub,ub,ub,ur,ug,ug,ug,ur,ur,ur,ub,ur
ur,ur,ur,ur,ur,ur,ur,cg,ur,cr,ug,ug,ub,ug,ug,ur,ug,ug,ux,ur,ur,ub,ur
ur,ur,ur,ur,ur,ur,ur,ug,ur,ub,ub,ub,ub,ub,ug,ug,ug,ug,ug,ur,ur,ub,ur
ur,ur,ur,ur,ur,ur,ur,ug,ug,ub,ub,cb,ub,ub,ub,ur,ur,ug,ug,ur,ur,ub,ur
ub,ug,ug,ug,ub,cb,ub,ub,ug,ub,cr,ur,ur,ur,ur,ur,ur,ur,ur,ur,ur,ub,ur
ug,ug,ug,ug,ux,ub,ub,ub,ub,ub,ub,ub,ub,ub,ub,ub,ux,ux,ux,ux,ur,ub,ur
ug,ux,ug,ux,ux,ug,ug,ug,ug,ug,ub,ug,ug,ub,ub,ub,ub,ub,ux,ux,ur,ub,ur
ug,ux,ug,ux,ux,ux,ux,ug,ug,ux,ug,ug,ug,ub,ub,ub,ub,ux,ux,ux,ur,ub,ur
ug,ux,ug,ug,ug,ug,ux,ux,ux,ux,ug,ug,ug,ug,ub,ub,ub,ux,ub,ub,ur,ub,ur
ug,ux,ux,ux,ux,ug,ug,ux,ux,ux,ug,ug,ug,ux,ub,ux,ub,ux,ub,ub,ur,ub,ur
ug,ug,ux,ux,ux,ux,ug,ux,ux,ux,ux,ux,ux,ux,ur,ux,ub,ux,ub,ub,ur,ub,ur
ur,ug,ug,ug,ug,ug,ug,ux,ux,ux,ux,ux,ux,ux,ur,ux,ur,ur,ur,ur,ur,cb,ub
ur,ur,ur,ur,ur,ur,ur,ur,ur,ur,ur,ur,ur,ur,ur,ux,ur,ur,ur,ur,ur,cb,cb