ur,ur,ur,ur,ur,ur,ur,ur,cr,cr,ux,ux,ux,ux,ux,ux,ux,cb,ur,ur,ur,ur,ur
ur,ur,ur,ur,ur,ur,ur,ur,ur,cg,ur,ur,ur,ur,ux,ux,ux,ux,ux,ur,ur,ur,ur
ur,ur,ur,ur,ur,ur,ur,cr,ub,ug,ub,ub,ub,ub,ub,ub,ub,ub,ub,ub,cb,ur,ur
ur,ur,ur,ur,ur,ur,ur,ur,ur,ug,ug,ur,ug,ug,ug,cr,ur,ur,ur,ur,ur,ur,cg
cb,ur,ur,ur,ur,ur,ur,ur,ur,ur,ug,ur,ug,ug,cg,ug,ur,ur,ug,ur,ur,ug,ug
ur,ur,ur,ur,ur,ur,ur,ur,ur,ur,ug,ur,ur,ur,ur,ur,ur,ur,ug,ur,ur,ug,ur
ur,ur,ur,ur,ur,ug,ur,ur,ur,cr,ur,ur,cb,ur,ur,ur,ug,ug,ug,ur,ur,ug,ur
ur,ur,ur,ur,ug,ug,ur,ur,ur,ub,ug,ug,cb,ub,ur,ur,ur,ur,ur,ur,ur,ug,ur
ur,ur,ur,ur,ur,ug,ug,ug,ug,cg,ug,ug,ub,ub,ur,ur,ur,ur,ur,ur,ug,ug,ur
ur,ur,ur,ur,ur,ug,ug,ug,ub,ug,ub,ug,ub,ub,ub,ub,ur,ur,ur,ug,ug,ur,ur
ur,ur,ur,ur,ur,ug,ug,ug,ub,ug,ug,ug,ub,ub,ub,ur,ur,ur,ug,ug,ur,ur,ur
ub,ub,ux,ug,ug,ug,ug,ug,ub,ug,ub,ug,ug,ug,ur,ur,ug,ug,ug,ur,ur,ur,ur
ub,ub,ux,ug,ug,ug,ug,ug,ub,ug,ug,ug,ub,ub,ux,ur,ur,ur,ur,ur,ux,ux,cg
ub,ub,ub,ug,ug,ug,ug,ug,ub,ub,ub,ub,ub,ub,ux,ug,ub,ub,ub,ur,cr,ux,ux
ub,ub,ub,ug,ug,ug,ug,ug,ug,ug,ub,ub,ug,ug,ug,ug,ub,ub,ub,ur,ur,ux,ux
ub,ux,ux,ug,ub,ug,ug,ug,ub,ub,ub,ub,ug,ub,ub,ug,ub,cb,ub,ur,ur,ug,ug
ub,ub,ub,ub,ub,ug,ug,ug,ub,ub,ug,ux,ug,ux,ux,ux,ub,ub,ug,ur,ur,ux,ug
cg,ub,ub,ub,ub,ub,ub,ub,ub,ub,ux,ux,ug,ux,ux,ux,ux,ux,ux,ur,ur,ux,ug
ub,ug,ug,ug,ug,ug,ug,ug,ug,ug,ug,ug,ug,ux,ux,ux,ux,ux,ux,ur,ur,ux,ug
ub,ug,ux,ux,ux,ux,ux,ux,ux,ux,ux,ux,ub,ux,ux,ux,ux,ux,ux,ur,ur,ug,ug
ub,ug,ug,ur,ug,ug,ug,ug,ug,ug,ug,ug,ub,ug,ug,ug,ug,ug,ug,ur,ur,ug,ur
cr,ub,ug,ug,ug,ux,ux,ux,ux,ux,ux,ux,ub,ux,ux,ux,ux,ux,ux,ur,ur,cb,cr
cg,ub,ub,ub,ub,ub,ub,ub,ub,ub,ub,ub,ub,cb,ux,ux,ux,ux,ux,cg,cb,ux,cr