ur,ur,ur,ur,ur,ur,ur,ur,ur,ur,ur,ur,ur,ur,ur,ur,ur,ur,ur,ur,ur,ur,ur
ur,ur,ur,ur,ur,ur,ur,ur,ur,ur,ur,ur,ur,ur,ur,ur,ur,ur,ur,ur,ur,ur,ur
ur,ug,ug,ug,ug,ux,ur,ux,ur,ur,ur,ur,ur,ur,ur,ur,ur,ur,ur,ur,ub,ub,ub
ur,ug,ug,ug,ug,ux,ur,ur,ur,ur,ur,ur,ur,ur,ur,ur,ur,ur,cb,ub,ub,ur,ub
ur,ug,ug,ug,ug,ug,ur,ur,ur,ur,ur,ur,ur,ur,ur,ur,ur,ur,ur,cr,cb,ur,ur
ur,ur,ur,ur,ug,cg,ur,ur,ur,ur,ur,cr,ur,ur,cr,ur,ur,ur,ur,ur,ur,ub,ub
ur,ur,ur,ur,ur,ur,ur,ur,ur,ur,ur,ug,ur,ur,ur,ur,ur,ur,ur,ub,ub,ub,ub
ur,ur,ur,ur,ur,ur,ur,ur,ur,ur,ur,cg,ur,ug,ug,ux,cr,cr,ub,ub,ub,ub,ub
cg,ur,ur,ur,ur,ur,ur,ur,ub,ub,ub,ub,ur,ur,ur,cb,ub,ur,ur,ur,cr,ub,ub
ur,ur,ur,ux,ur,ur,ur,ub,ub,ub,ub,ub,ub,ux,ug,ux,ux,ub,ub,ub,ub,ub,ub
ux,ux,ur,ur,ur,ur,ur,cb,ur,ub,ub,ub,ub,ug,ub,ux,ux,ub,ub,ux,ug,ux,cb
ux,ux,ug,ug,ug,ug,ux,ub,ur,ub,ub,ub,ub,ub,cb,ux,ux,ux,ub,ux,ug,ux,ur
ux,ux,ug,ug,ux,ux,ux,ub,ur,ub,ub,ub,ug,ug,ug,ux,ux,ux,ub,ux,ug,ux,ur
ux,ux,ux,ux,ux,ux,ux,ub,ur,ub,ub,ub,ug,ug,ug,ug,ug,ug,ub,ub,ub,ub,ub
cg,ux,ux,ux,ux,ux,ux,ux,ur,ub,ub,ug,ug,ug,ug,ug,ux,ux,ux,ux,ug,ub,ub
ug,ug,ug,ug,ug,ug,ug,ug,ug,ug,ug,ub,ug,ug,ug,ug,ug,ux,ux,ux,ug,ub,ub
ug,ux,ux,ux,ux,ux,ux,ux,ur,ub,ug,ub,ug,ug,ug,ug,ug,ux,ux,ub,ug,ub,ub
ug,ux,ux,ux,ux,ux,ux,ux,ur,ub,ug,ub,ug,ug,ug,ug,ug,ux,ux,ub,ug,ub,ub
ug,ux,ux,ux,ux,ux,ux,ux,ur,ux,ug,ux,ub,ux,ug,ug,ug,ub,ux,ub,ub,ub,ub
ug,ux,ux,ux,ux,ux,ux,ux,cg,ug,ug,ux,ub,ux,ux,ux,ux,ux,ux,ub,ub,ub,ub
ug,ug,ug,ug,ug,ug,ug,ug,ur,ug,ug,ug,ug,ug,ug,ur,ur,ur,ur,ub,ub,ub,ub
ur,ux,ux,ux,ux,ux,ux,ux,ur,ux,ux,ux,ux,ux,ug,ug,ux,ux,ux,ub,ub,ub,cb
ur,ur,ur,ur,ur,ur,ur,ur,ur,cg,ux,ux,ux,ux,ux,ug,ug,ug,ug,ub,ub,ux,ux