ur,ur,ur,ur,ur,cr,ux,ux,ux,ux,ux,ux,ux,ux,ux,ux,ux,ux,ux,ur,ur,ur,ur
ur,ur,ur,ur,ur,ux,ux,ux,ux,ux,ux,ur,ur,ur,ur,ur,ur,ur,ur,ur,ur,ur,ur
ur,ur,ur,ur,ur,ub,ub,ub,ub,ub,ub,ub,ub,ub,ub,ub,cb,ur,ur,ur,ur,ur,ur
ur,ur,ur,ur,ur,ur,ur,ur,ur,ur,ur,ur,ur,ur,ur,ur,ur,ur,ur,ur,ur,ur,ur
ur,ur,ur,ur,ug,ur,ur,ur,ur,ur,ur,ur,ub,ur,cr,ur,ur,ur,ur,ur,ur,ur,ur
ur,ur,ur,ub,ug,ur,ur,ur,ur,ur,ub,ub,ur,ur,ug,ur,ur,ur,ur,ur,ur,ur,ur
ur,ux,ug,ug,ug,ug,cr,ur,ur,ur,ub,ub,ub,ur,ug,ur,ur,ur,ur,ur,ur,ur,ur
ur,ur,ug,ug,ug,ug,ur,ug,ur,ur,cb,cr,ub,ur,ug,cg,ur,ur,ur,ur,ur,ur,ur
ux,ux,ug,ug,ur,ug,ur,ug,ur,ur,ur,ub,ub,ur,ur,ur,ur,ur,ur,ur,ur,ur,ur
ux,ux,ug,ug,ux,ug,ur,ug,ug,ug,ur,ur,ur,ur,ur,ur,ur,ur,ur,ur,ur,ur,ur
ux,ux,ug,ug,ux,ug,ux,ug,ug,ux,ub,ub,ub,ur,ur,ur,ur,ug,ux,ux,ur,ur,ur
ux,ux,ug,ug,ur,ug,ur,ug,ug,ur,ub,ub,cb,ur,ur,ur,ur,ur,ur,ur,ur,ur,ur
ur,ur,ug,ug,ug,ug,ur,ug,ug,ux,ug,ug,ur,ur,ur,ur,ug,ug,ub,ux,ux,ur,ur
ur,ur,ug,ub,ug,ug,ug,ug,ug,ug,ug,ub,ur,ur,ur,ur,ug,ug,ug,ux,ub,ur,ur
ur,ur,ug,cg,ug,ug,ug,ug,ug,ug,ux,ux,ur,ur,ur,ur,ug,ug,ug,ub,ub,ur,ur
ub,ub,ug,ug,ub,ub,ug,ug,ug,ug,ug,ug,ur,cr,ur,ur,ur,ur,cr,ug,ub,ur,ur
ub,ux,ux,ug,ux,ux,ug,ug,ug,ug,ux,ug,ug,ug,ug,ug,ug,ug,ug,ug,ux,ur,ur
ub,ux,ux,ug,ux,ux,ux,ug,ug,ug,ug,ux,ur,ux,ux,ub,ug,ub,ub,ux,ux,ur,ur
ub,ub,ub,ub,ub,ub,ub,ub,ub,ub,ub,ug,ur,ub,ub,ub,cg,ub,ub,ux,ub,ur,ur
ub,cb,ux,ub,ub,ub,ub,ub,ub,ub,ub,ux,ur,ub,ub,ub,ub,ub,ux,ub,ub,ur,ur
ub,ux,ux,ux,ug,ub,ub,ub,ub,ub,ub,ub,ub,ub,ub,ur,ur,ur,ur,ur,ur,ur,ur
ub,ub,ub,ub,ub,ub,ub,ub,ub,ur,ur,ur,ur,ur,ur,ur,ub,ur,ur,ur,ur,ur,ur
cb,ux,ux,ux,ux,ux,ux,ux,ub,ub,ub,ub,ub,ub,ub,ub,ub,ux,ux,ux,ux,cb,ur