ur,ur,cr,cr,ub,ur,ur,ur,ur,ur,ur,ur,ur,ur,ur,ur,ur,ur,ur,ur,ur,ur,ur
ur,ur,ur,ur,cb,ur,ur,ur,ux,ur,ur,ur,ur,ux,ux,ux,ux,cr,ux,ur,ur,ur,ur
ur,ur,ur,ur,ur,ur,cb,ur,ux,ur,ur,ur,ur,ur,ur,ur,ur,ur,ur,ur,ur,ur,ur
ur,ur,ur,ur,ur,cr,ub,ur,ur,ur,ur,ur,ur,ur,ur,ur,ur,ur,ur,ur,ur,ur,ur
ur,ur,ur,ur,ur,ur,ur,ur,ur,ur,ub,ub,ub,ur,ur,ur,ur,ur,ur,ur,ur,ur,ur
ur,ur,ur,ur,ur,ur,ur,ur,ur,ur,ub,ur,ub,ub,ur,ur,ur,ur,ur,ur,ur,ur,ux
ur,ub,ub,ub,ur,ur,ub,ub,ur,ur,ur,ub,ub,ub,ug,ug,ux,ur,ug,cr,ur,ux,ux
ur,ub,ub,ub,ub,ub,ub,ub,ur,ub,ub,cb,ub,cg,ug,ug,ur,ur,ug,ug,ug,ux,ux
cg,ub,ub,ur,ur,ub,ub,ub,ur,ub,ub,ub,ub,ub,ug,ug,ur,ur,ug,ug,ug,ux,ur
ur,ub,ub,ub,ub,ub,ub,ub,cg,ub,ub,cb,ur,ur,ug,ug,ur,ur,ug,ug,ug,ux,ur
ur,ub,ub,ub,ub,ub,ub,ub,ug,ub,ub,ub,ub,ur,ur,cr,ub,ur,ur,ur,ug,ur,ur
ux,ux,ub,ub,ub,ub,ub,ub,ug,ub,ug,ur,ur,ur,ug,ug,ug,ur,ur,ur,ug,ux,ux
ux,ub,ub,ub,ub,ub,ub,ug,ug,ub,ug,ug,ux,ub,ug,ug,ux,ur,ur,ur,ug,ux,ux
ux,ub,ub,ub,ub,ub,ub,ug,ug,ub,ub,ug,ux,ub,ug,ub,ux,ux,ux,ux,ug,ux,ur
cg,cb,ub,ub,ub,ub,ub,ux,ug,ub,ub,ug,ux,ug,ug,ug,ug,ug,ug,ux,ug,ux,ur
ub,ub,ub,ub,ux,ux,ug,ug,ug,ug,ug,ug,ug,ug,ug,ug,ug,ub,ug,ux,ug,ux,ur
ub,ub,ub,ux,ux,ub,ug,ub,ug,ux,ub,ug,ub,ub,ug,ug,ug,ug,ug,ux,ug,ux,ur
ux,ux,ub,ub,ub,ub,ug,ug,ug,ug,ug,ug,ug,ug,ug,ug,ug,ug,ug,ur,ug,ur,ur
ux,ux,ub,ub,ux,ux,ux,ux,ug,ux,ux,ug,ub,ub,ug,ux,ur,ur,ur,cg,ug,ux,ux
ur,ur,ug,ug,ug,ug,ug,ug,ug,ug,ug,ug,ur,cb,ub,ub,ub,ub,ub,ub,ub,ux,ux
ur,ug,ug,ux,ux,ux,ux,ux,ug,ux,ux,ub,ub,ug,ub,ux,ub,ub,ux,ub,ub,ux,ux
ur,ug,ux,ux,ux,ux,ux,ux,ug,ux,ux,ub,ux,ug,ug,ug,ub,ub,ur,ub,ub,ux,cb
ur,ug,ug,ug,ug,ug,ug,ug,ug,cg,ux,ux,ux,ux,ux,ux,ub,ub,ur,ub,ub,ux,ux