ur,ur,ur,ur,ur,ur,ur,ur,ur,ur,ur,ur,ur,ur,ur,ur,ur,ur,ur,ur,ur,ur,ur
ur,ur,ur,ur,ur,ur,ur,ur,cb,ub,cr,ur,ux,ux,ur,cb,ur,ur,ur,ur,ux,ur,ur
ur,ur,ur,ur,ur,ur,ur,ur,ur,ur,ur,ur,ur,ur,ur,ub,ur,ur,ur,ur,ux,ur,ur
ur,ur,ur,ur,ur,ur,ur,ur,ur,ur,ur,ur,ur,ur,ur,cr,cr,ur,ur,ur,ux,ur,ur
cb,ur,cr,ur,ur,ur,ur,cr,ug,ug,cg,ur,ur,ur,ur,ur,ur,ur,ur,ur,ux,ur,ur
ur,ur,ux,ur,ur,ur,ur,ur,ug,ur,ur,ur,ur,ur,ur,ur,ur,ur,ur,ur,ur,ur,ur
ur,ur,ur,ur,ur,ur,ur,ur,ug,ug,ug,ur,ur,ur,ur,ur,ur,ur,ur,ur,ur,ur,ur
ur,ur,ur,ub,ub,ur,ur,ur,ur,ug,cb,ub,ur,ur,ur,ug,ug,ug,ur,ur,ur,ur,ur
cg,ux,ux,ub,ub,ub,ur,ur,ur,ug,ug,ub,ub,ub,ur,ur,ug,ug,ur,ur,ur,ur,ur
ux,ux,ug,ug,ug,ub,ug,ug,ug,ug,ug,ur,ub,ur,ug,ug,ug,ur,ur,ur,ur,ur,ur
ub,ub,ug,ub,ug,ub,ux,ux,ub,ub,ub,ur,ub,ub,ug,ug,ug,ub,ub,ub,ub,ub,cb
ub,ux,ug,ub,ug,ub,ux,ux,ub,ub,ub,ub,ub,ub,ub,ub,cg,ux,ux,ux,ux,ub,ur
ub,ux,ug,ub,ug,ug,ux,ux,ux,ub,ub,ub,ub,cb,ub,ub,ub,ux,ux,ux,ux,ub,cr
ub,ub,ug,ub,ub,ug,ub,ux,ux,ub,ub,ub,ub,ub,ub,ub,ub,ux,ux,ux,ux,ub,ub
cg,ub,ug,ub,ub,ug,ub,ux,ux,ux,ux,ub,ub,ub,ug,ug,ug,ux,ux,ux,ux,ub,ub
ub,ub,ug,ub,ub,ug,ub,ub,ub,ux,ux,ub,ub,ub,ug,ug,ux,ux,ux,ux,ux,ub,ub
ub,ux,ug,ub,ub,ug,ux,ux,ub,ux,ux,ub,ub,ub,ub,ux,ux,ux,ux,ux,ux,ub,ub
ub,ug,ug,ux,ub,ug,ux,ux,ub,ux,ux,ub,ux,ux,ux,ux,ux,ux,ux,ux,ux,ub,ub
ub,cg,ux,ux,ub,ug,ux,ux,ub,ux,ux,ub,ux,ux,ux,ux,ux,ux,ux,ux,ux,ub,ub
ub,ux,ux,ug,ug,ug,ug,ug,ug,ug,ug,ug,ug,ug,ug,ug,ug,ug,ug,ug,ug,ub,ub
ub,ux,ub,ug,ux,ug,ug,ug,ug,ub,ub,ub,ub,ub,ub,ub,ub,ub,ub,ub,ub,ub,ub
ub,ub,ub,ug,ug,ug,ug,ug,ug,ub,ub,ub,ub,ub,ub,ub,ub,ub,ub,ub,ub,ub,cb
ub,ub,ux,ux,ux,ux,ux,ux,ux,cg,ub,ub,ur,ur,ur,ur,ur,ur,ur,ur,ur,ur,ur