ur,ur,ur,ur,ur,ur,ur,ur,ur,ur,ur,ur,cr,ub,cb,ur,ur,ur,ur,ur,ur,ur,ur
ur,ur,ur,ur,ur,ur,ur,ur,ur,ur,ur,ur,ur,ur,ur,ur,ur,ur,ur,ur,ur,ur,ur
ur,ur,ur,ur,ur,ur,ur,ur,ur,ur,ur,ur,ur,ur,ur,cr,cr,ur,ur,ur,ur,ur,ur
ur,ur,ur,ur,ur,ur,ur,ur,ur,ur,ur,ur,ur,ur,ur,cr,ub,cb,ur,ur,ur,ur,ur
ur,ur,ur,ur,ur,ur,ur,ur,ug,ug,ug,ug,ug,ur,ur,ur,ub,ur,ur,cb,ur,ur,ur
ur,ur,ur,ur,ur,ub,ub,ur,ug,ug,ur,ur,ug,ur,ur,ur,ub,ur,ub,ub,ub,ur,ur
ur,ur,ur,ur,ub,ub,ub,ur,ug,ug,ug,ug,ug,ub,ub,ub,ug,ug,ug,cg,ub,ur,ur
ur,ur,ur,ur,ub,ub,ub,ur,ur,ur,ug,ug,ub,ub,ur,ub,ug,ub,ug,ur,ub,ur,ur
cg,ux,ux,ux,ug,ub,ub,ur,ur,ur,ug,ug,ub,cb,ug,ub,ug,ub,ug,ub,ub,ur,ur
ux,ux,ux,ux,ug,ug,cr,ur,cb,ur,ug,ug,ub,ub,ug,ug,ug,ug,ug,ub,ug,ur,ur
ux,ux,ux,ux,ux,ux,ux,ub,ub,ug,cg,ug,ug,ug,ug,ug,ug,ub,ub,ub,cr,ur,ur
ur,ur,ur,ur,ur,ur,ur,ub,ub,ub,ug,ub,ub,ub,ub,ub,ub,ub,ub,ub,ur,ur,ur
ur,ur,ur,ur,ur,ux,ux,ux,ub,ug,ug,ub,ub,ub,ub,ug,ug,ug,ug,ux,ug,ug,ub
ux,ux,ux,ux,ux,ux,ux,ux,ub,ug,ub,cb,ub,ub,ub,ub,ub,ux,ux,ux,ug,ug,ub
cg,ux,ux,ux,ux,ux,ux,ux,ub,ug,ub,ub,ux,ux,ux,ux,ux,ux,ux,ug,ug,ug,ub
ux,ux,ux,ux,ux,ux,ux,ux,ub,ug,ub,ub,ux,ux,ux,ux,ux,cg,ug,ug,ux,ug,ub
ux,ux,ux,ux,ux,ux,ux,ux,ub,ug,ux,ux,ux,ux,ux,ux,ux,ux,ux,ux,ux,ug,ub
ux,ux,ux,ux,ux,ux,ux,ux,ub,ug,ux,ux,ux,ux,ux,ux,ux,ux,ux,ux,ux,ug,ub
ux,ux,ux,ux,ux,ux,ux,ux,ub,ug,ux,ux,ux,ux,ux,ux,ux,ux,ux,ux,ux,ux,ub
ux,ux,ux,ux,ux,ux,ux,ux,ub,ux,ux,ux,ux,ux,ux,ux,ux,ux,ux,ux,ux,ux,ub
ub,ub,ub,ub,ub,ub,ub,ub,ub,ub,ub,ub,ub,ub,ub,ub,ub,ub,ub,ub,ub,ub,ub
ub,ux,ux,ux,ux,ux,ux,ux,ub,ux,ux,ux,ux,ux,ux,ux,ux,ux,ux,ux,ux,ux,cb
ub,ub,ub,ub,ub,ub,ub,ub,ub,cg,ux,ux,ux,ux,ux,ux,ux,ux,ux,ux,ux,ux,ux