ux,ur,ur,ur,ur,ur,ur,ur,ur,ur,ur,ur,ur,ur,ur,ur,ur,ur,ur,ub,ub,ub,ug
ux,ur,ur,ur,ur,ur,ur,ur,ur,ur,ur,ur,ur,ur,ur,ur,ur,cr,ur,ub,ub,ub,ug
ur,ur,ur,ux,cr,ur,ur,ur,ur,ur,ur,ur,ur,ur,ur,ur,ur,ub,ur,ub,ur,cb,ug
ur,ur,ur,ux,ux,ux,ur,ur,ux,ur,ur,ur,ur,ur,ur,ur,ur,ub,ur,ub,ub,ub,ug
ur,ur,ur,ux,ur,ur,ur,ur,ug,ug,ug,ug,ug,ug,ur,ur,ur,cb,ur,ur,ur,cr,ug
ur,ur,ur,ur,ur,ur,ug,ug,ug,ug,ug,ug,ug,ug,ug,ug,ur,ur,ur,ur,ur,ur,ug
ur,ur,ur,ur,ur,ur,ug,ur,ur,ug,ug,ug,ug,ug,ug,ug,ur,ur,ur,ur,ur,ur,ux
ur,ur,ur,ur,ur,ur,ug,ug,ug,ug,ug,ug,cg,ug,ur,ur,ur,ur,ur,ur,ur,ux,ux
ur,ur,ur,ur,ur,ur,ug,ug,ug,ug,ug,ur,ur,ur,ur,ur,ur,ur,ur,ur,ur,ur,ur
ur,ur,ur,ur,ur,ug,cg,ub,ub,ub,ub,ub,ug,ug,ub,ug,ux,ug,ux,ux,ug,ux,ur
ur,ur,ur,ur,ur,ug,ur,ub,ub,ub,ub,ub,ub,ug,ub,ub,ux,ug,ux,ux,ug,ux,ur
ur,cb,ub,ur,ur,ug,cb,ub,ub,ug,ub,ub,ub,ub,ub,ub,ux,ug,ux,ux,ug,ux,cr
ur,ur,cr,ur,ur,cr,ur,ug,ub,ub,ub,ub,ub,ub,ub,ub,ub,ug,ux,ux,ug,ux,ux
ux,ux,ub,ub,ug,ug,ur,ug,ub,ub,ub,ub,ub,ug,ug,ug,ug,ug,ux,ux,ug,ux,ux
ux,ux,ux,ux,ug,ug,ur,ux,ub,ub,ur,ux,cb,ug,ux,ux,ux,ux,ux,ux,ug,ux,ux
ux,ux,ux,ux,ug,ug,ug,ug,ub,ub,ug,ux,ux,ug,ux,ux,ux,ux,ux,ux,ug,ux,ug
ux,ux,ux,ux,ux,ux,ug,ux,ub,ux,ug,ux,ux,ug,ux,ux,ux,ux,ux,ux,ug,ux,ug
ux,ux,ux,ux,ux,ux,ug,ug,ug,ug,ug,ux,ux,ug,ux,ux,ux,ux,ux,ux,ug,ux,ug
ux,ux,ux,ux,ux,ux,ur,ux,ub,ub,ur,ur,ur,ug,ur,ur,ur,ur,ur,ur,ug,ur,ur
ux,ux,ux,ux,ux,ux,ur,ux,ux,ux,ux,ux,ux,ug,ux,ux,ux,ux,ux,ux,ug,ux,ur
ux,ux,ux,ux,ux,ux,ur,ux,ux,ux,ux,ux,ux,ug,ux,ux,ux,ux,ux,ux,ug,ux,ur
ur,ur,ur,ur,ur,ur,ur,ur,ur,ur,ur,ur,cg,ug,ur,ur,ur,ur,ur,ur,ug,ur,ur
ur,ur,ur,ur,ur,ur,ur,cg,ug,ug,ug,ug,ug,ug,ug,ug,ug,ug,ug,ug,ug,cb,ur