ur,cr,cg,ur,cr,ur,ur,ur,ur,ur,ur,ur,ub,ub,ub,ub,ub,ub,ub,cg,ur,ur,ur
ur,ur,cb,ur,ur,ur,cr,ub,ub,ub,ub,ur,ub,ux,ub,ub,ub,ub,ub,ur,ur,ur,ur
ur,ug,ub,ur,ur,ur,ur,ub,ub,ub,ub,ur,ub,ug,ug,ug,ug,ug,ug,ur,ur,ur,ur
ur,cr,ur,ur,cr,ur,ur,ub,ug,ub,ub,ub,ub,ub,ub,ug,ug,ug,cr,ur,ug,ug,ub
ur,ur,ub,ur,ub,ub,ub,ub,ur,ur,ux,ux,ug,ug,ub,ub,cb,ug,ug,ur,ug,ug,ub
ur,ur,ub,ur,ur,ur,ur,ur,ur,ug,ux,ux,ux,ub,ug,ug,ug,ug,ug,ur,ug,ug,ub
ur,ur,ur,ur,ur,ur,ur,ub,ub,ub,ub,ub,ub,ub,ug,ub,ug,ub,ub,ug,ug,ug,ub
ur,ur,ur,ur,ur,ub,ub,ub,ux,ux,ux,ub,ub,ub,ug,ub,ug,ub,ub,ug,ug,ux,ub
ur,ur,ur,ur,ur,ub,ub,ub,ub,ub,ub,ub,ub,ug,ug,ub,ug,ug,ug,ug,ug,ug,ug
ur,ub,ur,ux,ux,ur,ur,ug,ug,ub,ub,cb,ub,ug,ug,ug,ub,ub,ub,ug,ux,ux,ug
ur,ur,ur,ux,ux,ug,ub,ub,cg,cb,cb,ub,ug,ug,ug,ug,ug,ug,ux,ug,ux,ux,ug
ub,ub,ub,ub,ub,ug,ub,ug,ug,ub,ub,ub,ug,ug,ug,ug,ug,ug,ux,ug,ux,ux,ug
cg,ub,ub,ub,ub,ub,ub,ux,ub,ub,ub,ux,ux,ux,ug,ug,ub,ux,ub,ug,ux,ux,ug
ux,ux,ux,ux,ub,ub,ub,ub,ub,ub,ub,ux,ux,ux,ux,ug,ug,ub,ub,ug,ux,ux,ug
ux,ux,ux,ub,ub,ub,ub,ub,ub,ub,ub,ub,ux,ux,ux,ub,ug,ub,cg,ug,ux,ug,ug
ux,ux,ux,ug,ub,ub,ub,ub,ub,ub,ug,ug,ux,ux,ux,ub,cb,ub,ug,ug,ug,ug,ur
ux,ux,ux,ug,ux,ux,ug,ub,ub,ug,ug,ug,ug,ug,ug,ug,ub,ug,ub,ur,ug,ux,ur
cg,ux,ux,ug,ux,ub,ug,ub,ub,ux,ub,ug,ug,ux,ux,ux,ux,ux,ux,ur,ug,ug,ur
ux,ux,ux,ug,ux,ub,ug,ub,ub,ux,ub,ux,ux,ux,ux,ux,ux,ux,ux,ur,ux,ug,ug
ux,ub,ub,ug,ub,ub,ug,ub,ub,ux,ux,ux,ux,ux,ux,ux,ux,ux,ux,ur,ug,ug,ug
cr,ux,ub,ug,ub,ub,ug,ug,ug,ug,ug,ug,ug,ug,ug,ug,ug,ug,ug,ur,ur,ur,ur
cg,cb,ub,ug,ug,ug,ur,ur,ur,ur,ur,ur,ur,ur,ux,ux,ux,ux,ux,ur,ux,cb,cr
cr,ur,ur,ur,ur,ug,ug,ug,ug,ug,ug,ug,ug,ug,ug,ug,ug,cg,ur,ur,cb,ux,cr