cb,cb,cb,cr,ur,ur,cr,ug,ug,ux,ux,ux,ux,ur,ur,ur,ur,ur,ur,ur,ur,ur,cb
ur,ur,ur,cg,ug,ur,ur,ur,cg,ur,ur,ur,ur,ur,ur,ur,ur,ur,ub,ub,ub,ub,ur
ur,ur,ur,ur,cr,ur,ur,ur,ur,ur,ug,ug,ug,cg,ur,ur,ur,ub,ub,ub,ub,ub,ur
ur,ur,ur,ur,ur,ur,ug,ur,ur,cr,ug,ur,ur,ur,ur,ur,cb,ub,ub,ub,ub,ub,ur
cr,ub,ub,ub,ug,ug,ug,ur,ur,ur,ur,ur,ur,ur,ur,ur,ur,ub,ub,ub,ub,ur,ur
ur,ub,ub,ub,ug,ur,ug,ur,ur,ur,ur,ur,ur,ur,ur,cr,ug,ug,ur,ub,ub,ub,ub
ur,cb,cb,ub,ug,ub,ur,ur,ur,ur,ug,ux,ux,ux,ub,ux,ux,ug,ub,ub,ub,ux,ub
cb,ux,ub,ub,ug,ug,ur,ur,ur,ur,ug,ux,ux,ug,ub,ug,ug,ug,ux,ux,ug,ux,ub
ux,ur,ur,ug,ug,ug,ug,ub,ub,ub,ug,ux,ug,ug,ub,ug,ug,ug,ux,ux,ug,ug,ub
ux,ur,ur,ur,ug,ur,ug,cb,ub,ub,ug,ub,ux,ux,ub,ub,ux,ug,ux,ux,ub,ug,ub
ux,ur,ur,ur,ug,ug,ug,ub,ub,ub,ub,ub,ug,ux,ug,ub,cr,ug,ub,ub,ub,ug,ub
ux,ur,ur,ur,ur,ug,ug,ug,ug,ug,ug,ub,ug,cg,ug,ug,ur,ug,cg,ub,ub,ug,ub
cb,ux,ux,ur,ur,ur,ug,ub,ub,ub,ug,ub,ub,ug,ug,ug,ur,ug,ug,ub,ub,ug,ub
ur,ur,ur,ur,ug,ug,ug,ub,ub,ub,ug,ug,ug,ug,ug,ug,ur,ug,ug,ux,ux,ug,ub
ur,ur,ur,ur,ug,ur,ub,ub,ub,ub,ug,ug,ug,ug,ug,ug,ur,ug,ug,ux,ux,ug,ub
ur,ur,ur,ux,ug,ur,ux,ub,ux,ub,ug,ug,ug,ug,ug,ux,ur,ug,ug,ub,ub,ug,ub
ux,ur,ur,ur,ug,ur,ux,ux,ux,ux,ug,ux,ug,ux,ux,ux,ur,ux,ux,ux,ux,ug,ux
cr,ux,ux,ux,ug,ub,ub,ub,ub,ub,ug,ug,ug,ub,ub,ub,ur,ub,ub,ub,ub,ug,ub
cg,ux,ux,ux,ug,ub,ux,ux,ux,ux,ux,ux,ux,ux,ux,ux,ur,ux,ux,ux,ux,ug,ub
cb,ub,ub,ub,cb,ub,ub,ub,ub,ub,ub,ub,ub,ub,ub,ub,ur,ug,ug,ug,ug,ug,ub
ux,ub,ux,ux,ux,ux,ux,ux,ux,ux,ux,ux,ux,ux,ux,ux,ur,ux,ux,ux,ux,ux,cr
cr,ub,ub,ub,ub,ub,ub,ub,ub,ub,ub,ub,ub,ub,ub,ub,ur,cb,cg,ux,cb,ux,cr
cg,cb,cg,cb,ux,ux,ux,ux,ux,ux,ux,ux,ux,ux,ux,cg,ur,ur,ur,cg,cg,ux,cr