ur,ur,ur,ur,ur,ur,ur,ur,ur,cg,ub,ub,ub,ub,ub,ux,ux,cb,ux,ug,ug,ug,ur
ur,ur,ur,ur,ur,ur,ur,ur,ur,ur,cr,ux,ux,ux,ub,ux,ux,ux,ux,ug,ux,ug,ur
ur,ur,ur,ur,ur,ur,ur,ur,ur,ur,ur,ux,ux,ux,ub,ug,ug,ub,ub,ug,ub,ug,ur
ur,ur,ur,ur,ur,ur,ur,ug,ur,ux,ux,ux,ub,ub,ub,ux,ug,ug,ug,ug,ux,ug,ur
ur,ub,ub,ur,ug,ug,cg,ur,ur,ub,ub,cg,ug,ug,cb,ub,ub,ug,ug,ub,ug,ug,ur
cr,cb,ub,ug,ug,ur,ur,ur,cr,ur,ux,ux,ub,ub,ub,ub,ub,ug,ug,ug,ug,ur,ur
ur,ur,cr,ur,ur,ug,ug,ug,ug,ur,ux,ux,ux,ux,ub,ub,ub,ux,ux,ug,ug,ur,ur
ub,ur,cr,ux,ux,ug,ug,ug,ug,ug,ub,ub,ub,ug,ug,ug,ug,ug,ug,ug,ug,ur,ur
ur,ug,ur,ur,ur,ur,ur,ug,ur,ur,ur,ur,ur,ur,ur,ur,ur,ur,ur,ur,ur,ur,ur
ur,ux,ub,ub,ub,ug,ug,ug,ug,ug,ug,ug,ux,ug,ug,ug,ug,ug,ug,ug,ur,ur,ur
ur,ub,ub,ub,ub,cb,ug,ub,ub,ug,ug,ug,ux,ug,ug,ug,ug,ug,ug,ux,cr,ur,ur
ur,ub,ub,ub,ub,ub,ub,ug,ub,ub,ub,ub,ub,ug,ug,ux,ug,ug,ug,ux,ug,ur,ur
ur,ub,ub,ub,ug,ub,ub,ub,ub,ub,ub,ub,ug,ug,ug,ug,ug,ux,ug,ux,cg,ur,ur
ur,ub,ub,ub,ug,ub,ug,ug,cg,cb,ub,ub,ug,ub,ug,ug,ug,ug,ug,ux,ux,ur,cb
ur,ub,ub,ub,ug,ub,ug,ug,ug,ub,ub,ub,ug,ub,ug,ug,ug,ux,ux,ux,ux,ux,ub
ur,ub,ub,ub,ug,cg,ug,ug,ux,ub,ub,ub,ug,ub,ug,ug,ug,ug,ux,ux,ux,ux,ub
ur,ub,ux,ug,ub,ub,ub,ub,ub,cb,ub,ub,ug,ub,ug,ug,ux,ug,ux,ux,ux,ux,ub
ur,ub,ub,ub,ub,ub,ub,ug,ux,ux,ub,ub,ug,ub,ug,ug,ug,ug,ux,ux,ux,ux,ub
ur,ux,ux,ug,ug,ug,ub,ug,ub,ug,ug,ug,ug,ux,ug,ug,ux,ux,ux,ux,ux,ux,ub
ur,ux,ux,ux,ux,ub,ug,ug,ug,ug,ug,ug,ug,ux,ux,ux,ux,ux,ux,ub,ub,ub,ub
ur,ur,ur,ur,ur,ur,ur,ur,ur,ur,ur,ub,ur,ur,ur,ur,ur,ur,ub,ub,ub,ur,ur
cr,ux,ux,ux,ux,ub,ub,ub,ub,ux,ux,ub,ux,ux,ux,ux,ux,ux,ub,ub,ub,ux,cb
cg,ux,ux,ux,ux,ux,ux,ux,ux,ux,ux,ub,ub,ub,ub,ub,ub,ub,ub,ub,ub,ux,ux