ur,ur,ur,ur,ur,ur,ur,ur,ur,ur,ur,ur,ur,ur,ur,ur,ux,cb,ux,ux,ur,ub,ub
ur,ur,ur,ur,ur,ur,ur,ur,ur,ur,ur,ur,ur,ur,ur,ur,ux,ug,ug,ur,ub,ub,ub
ur,ur,ur,ur,ur,ur,ur,ur,ur,ur,ur,ur,ur,ur,ur,ur,ug,ug,ug,ug,ug,ur,ur
ur,ur,ur,ur,ur,ug,cg,ur,ur,ur,ur,ur,ur,ur,ur,ug,ug,ug,ug,ug,ug,ur,ur
ur,ur,ur,ur,ur,ur,cr,ur,ur,ur,ur,ur,ur,cr,ur,ug,ug,ug,ug,ug,ug,ur,ur
ur,ur,ub,ub,ub,ub,ur,ur,ur,ur,cr,ug,ug,cg,ur,ug,ug,ur,ur,ur,ur,ur,ur
ub,ub,ub,ub,ub,ub,ur,ur,ug,ug,ur,ur,ur,ur,ur,ug,ug,ug,ug,ug,ur,ur,ur
cb,ur,cb,ub,ub,ub,ub,ub,ub,ub,ub,ub,ur,ur,ug,ug,ug,ug,ug,ug,ur,ux,ur
ur,ur,cr,ub,ub,ub,ub,ub,ub,ub,ub,ub,ur,ug,ug,ug,ug,ug,ug,ug,ur,ux,ux
cr,ux,ug,ug,ub,ub,ub,ur,ur,ug,ub,cb,ur,ux,ux,ug,ug,ug,ug,ub,ur,ux,ux
ug,ug,ug,ux,ub,ub,ub,ug,ub,ug,ug,ug,ug,ux,ux,ux,ug,ug,ug,ub,ur,ux,ux
ug,ux,ux,ub,cb,ub,ub,ug,cb,ub,ub,ug,ub,ug,ux,ux,ug,ug,ug,ub,ur,ux,ux
ug,ux,ub,ub,ux,ux,ub,ub,ub,ub,ub,ug,ug,ug,ux,ux,ug,ug,ug,ub,ur,ux,ux
ug,ug,ug,ub,ub,ug,ub,ug,ub,ub,ug,ug,ug,ux,ux,ux,ug,ug,ug,ub,ur,ux,ux
cg,ux,ux,ux,ub,ux,ub,ub,ub,ub,ub,ug,ug,ux,ux,ux,ug,ug,ug,ub,ur,ux,ur
ux,ux,ux,ux,ub,ub,ub,ub,ug,ug,ug,ug,ug,ug,ug,cg,ug,ug,ug,ub,ur,ux,ur
ux,ux,ux,ux,ux,ux,ug,ub,ug,ug,ug,ug,ug,ug,ug,ug,ug,ux,ux,ub,ur,ux,ur
ux,ux,ux,ux,ux,ux,ug,ug,ug,ug,ug,ug,ug,ux,ug,ux,ur,ux,ub,ub,ur,ux,ur
ux,ux,ux,ux,ub,cg,ug,ug,ug,ug,ug,ub,ug,ug,ug,ug,ur,ub,ub,ux,ur,ux,ur
ux,ux,ux,ub,ub,ux,ux,ux,ux,ux,ux,ux,ux,ux,ux,ux,ur,ux,ux,ux,ur,ux,ur
ux,ux,ub,ub,ux,ux,ux,ux,ux,ux,ux,ux,ur,ur,ur,ur,ur,ur,ur,ur,ur,ur,ur
cr,ux,ub,ux,ux,ux,ux,ux,ub,ub,ub,ub,cb,ux,cr,ur,ur,ur,ux,ux,ux,ur,cb
cg,ux,ub,ub,ub,ub,ub,ub,ub,cg,ux,ub,ub,ur,ur,ur,ur,ur,ur,ur,ur,ur,ux