ur,ur,cb,ur,cg,ur,ur,ur,ur,ur,ur,ur,cr,ur,ub,ub,ub,ub,ub,cg,ux,ux,ux
ur,ur,ur,ur,ug,cr,ur,ur,ur,ur,ur,ur,cr,ur,ub,ub,ub,ub,ub,ur,ur,ur,ur
ur,ur,ur,ur,cr,ur,ur,ur,ur,ur,ur,ur,ur,ug,ug,ug,ug,ug,ug,ur,ur,ur,ur
ur,ur,ur,ur,ur,ur,ur,ur,ur,ur,ur,ur,ur,ur,ur,ur,ur,ur,ur,ur,ug,ug,ux
ur,ur,ur,ur,ur,ur,ur,ur,ur,ur,cr,ur,ur,ug,ub,ub,ub,ub,ub,ub,ug,ug,ux
ur,ur,ur,ur,ur,ur,ur,ur,ur,ur,ur,ur,ur,ur,ur,ur,ur,cr,ug,ub,ug,ug,ux
ur,ur,ur,ur,ur,ur,ur,ur,ur,ur,ur,ur,ub,ub,ug,ux,ux,ux,ux,ub,ug,ug,ux
ur,ur,ur,ur,ur,ub,ug,ug,ux,ux,ux,ub,ub,ub,ug,ub,ux,ux,ux,ub,ug,ux,ux
ur,ur,ur,ur,ur,ub,ug,ug,ug,cb,ub,ub,ub,ub,ub,ub,ug,ug,ug,ub,ux,ux,ux
ur,cg,ur,ux,ux,ug,ug,ug,ug,ub,ub,ub,ug,ug,ug,cg,ux,ux,ux,ub,ub,ub,ub
ur,ug,ur,ux,ux,ug,ug,ug,ug,ub,cb,ub,ug,ug,ug,ug,ux,ux,ux,ug,ub,ub,ub
ub,ug,ub,ub,ub,ug,ub,ux,ub,ub,ub,ub,ug,ug,ug,ug,ux,ux,ux,ug,ub,ub,ub
cg,ug,ug,ug,ug,ug,ug,ug,ub,ug,ub,ub,ub,ug,ug,ug,ug,ug,ug,ub,ub,ub,ub
ux,ux,ux,ux,ub,ub,ub,ug,ub,ub,ub,ub,ub,ug,ug,ug,ux,ux,ub,cb,ux,ub,ub
ux,ux,ux,ub,ub,ub,ub,ug,ub,ub,ub,ub,ug,ug,ux,ub,ux,ub,ub,ug,ub,ub,ub
ux,ux,ux,ug,ub,ub,ub,ug,ub,ub,ub,cg,ug,ux,ux,ub,ub,ub,ug,ug,ub,ub,ub
ux,ux,ux,ug,ux,ux,ug,ug,ub,ub,ub,ug,ug,ux,ux,ux,ub,ux,ux,ur,ug,cb,ub
cg,ux,ux,ug,ux,ux,ug,ug,ub,ux,ux,ub,ug,ug,ug,ug,ug,ug,ux,ur,ug,ug,ux
ux,ux,ux,ug,ux,ux,ug,ug,ug,cb,ub,ub,ug,ug,ux,ux,ux,ug,ux,ur,ux,ug,ug
ux,ub,ub,ug,ux,ux,ug,ub,ub,ux,ux,ux,ux,ux,ux,ux,ux,ug,ux,ur,ug,ug,ug
cr,ux,ub,ug,ux,ux,ug,ug,ug,ug,ug,ug,ug,ug,ug,ug,ug,ug,ug,ur,ux,ux,ux
cg,cb,ub,ug,ug,ug,ur,ur,ux,ux,ux,ux,ux,ux,ux,ux,ux,ug,ux,ur,ux,cb,cr
cr,ur,ur,ur,ur,ug,ug,ug,ug,ug,ug,ug,ug,ug,ug,ug,ug,ug,ur,ur,cb,ux,cr