ur,ux,ux,ur,ur,ur,ur,ur,ur,ur,ur,ur,ur,ur,ur,ur,ur,ur,ur,ur,ur,ur,ur
ur,ur,ur,ur,ur,ur,ur,ur,ur,ur,ur,ur,ur,ur,ur,ur,ur,ur,ur,ur,ux,ux,ur
ur,ur,ur,ur,ur,ur,ur,ur,ur,ur,ur,ur,ur,ur,ur,ur,ur,ur,ur,ur,ur,ur,ur
ur,ux,ur,cr,ub,ub,ur,ur,ur,ur,ur,ur,ur,ur,ur,ur,ur,ur,ur,ur,ur,ur,ur
ur,ur,ur,ur,ur,cb,ur,ur,ur,ur,ur,ux,ur,ur,ur,ur,ur,ur,ur,ur,ur,ur,ur
ur,ur,ur,ur,ur,ur,ur,ur,ur,ur,ur,ur,ur,ur,ur,ur,cg,ur,ur,ur,ur,ur,ur
ur,ur,ur,ur,ur,ur,cr,ur,ub,ub,cb,ur,ur,ur,cr,ug,ug,ur,ur,ur,ur,ur,ur
ur,ur,ur,ur,ur,ur,ur,ur,ub,ur,ur,ur,ur,ur,ur,ur,ug,ur,ur,ur,ur,ur,ur
cg,ur,ur,ur,ur,ur,ur,ur,ug,ub,ub,cr,ur,ug,ug,ug,ub,ur,ur,ur,ur,ur,ug
ur,ur,ur,ur,ur,ur,ub,ug,ug,ug,cg,ub,ug,ug,ub,ug,ub,ub,ub,ux,ux,ux,ug
ur,ur,ur,ur,ur,ux,ux,ug,ug,ug,ur,ub,ug,ux,ub,cb,ux,ux,ux,ux,ux,ux,ug
cr,ur,ur,ur,ux,ux,ux,ub,ub,ub,ub,ug,ug,ux,ub,ub,ux,ux,ux,ux,ux,ux,ug
ux,ux,ux,ux,ux,ux,ux,ub,ub,ub,ub,ug,ux,ux,ux,ub,ux,ux,ux,ux,ux,ux,ug
ux,ux,ux,ux,ux,ux,ux,ub,ug,ub,ub,ub,ux,ux,ug,ub,ub,ug,ux,ux,ux,ux,ug
cg,ux,ux,ux,ux,ux,ux,ux,ub,cb,ub,ub,ub,ub,ub,ub,ub,ub,ub,ub,ub,ub,ub
ux,ux,ux,ux,ux,ux,ux,ug,ub,ub,ub,ub,ub,ub,ub,ub,ub,ub,ub,ub,ux,ub,ub
ux,ux,ux,ux,ux,ux,ux,ug,ug,ug,ub,ub,ub,ub,ub,ub,ub,ub,ub,ub,ux,ub,ub
ub,ub,ub,ub,ub,ub,ub,ub,ub,ub,ub,ug,ur,ug,ub,cb,ug,ug,ug,ug,ug,ug,ug
ub,ux,ub,ub,ub,ub,ub,ub,cb,ug,ub,ub,ur,ux,cr,cg,ub,ub,ux,ux,ux,ub,ug
ub,ux,ub,ux,ux,ux,ux,ux,ux,ug,ub,ub,ur,ub,ur,ug,ub,ub,ub,ub,ub,ub,ug
ub,ux,ub,ub,ub,ub,ub,ub,ub,ux,ub,ux,ur,ux,ur,ug,ux,ux,ux,ux,ux,ux,ug
ub,ux,ux,ux,ub,ub,ub,ub,ub,ux,ub,ub,ur,ub,ur,ug,ub,ux,ub,ub,ub,ux,ug
ub,ub,ub,ub,ub,ub,ub,ub,ub,cg,ub,ub,ur,ur,ur,ug,ug,ug,ug,ug,ug,ug,ug