ux,ux,ur,ur,ur,ur,ur,ur,ur,ur,ur,ur,ux,ux,ux,ux,ux,ux,ur,ur,ur,ur,ur
ux,ux,ux,ur,ur,ur,ur,ur,ux,ux,ux,ur,ux,ux,ux,ux,ur,ur,ur,ur,ur,ur,ur
ux,ur,ur,ur,ur,ur,ur,ur,ux,ux,ux,ur,ux,ux,ux,ux,ur,ur,cb,ub,ub,ub,ub
ux,ur,ur,ug,ur,ur,ur,ur,ux,ux,ux,ur,ux,ux,ux,ux,ur,cr,ub,ub,ub,ur,ub
ux,ur,ur,ug,ur,ur,cr,ug,ug,ug,cg,ur,ux,ux,ur,ux,ur,ur,ub,ub,ub,ub,ub
ur,ur,ux,ur,ur,ur,ur,ur,ug,ug,ug,cg,ur,ur,ur,ur,ur,ur,ur,ur,ub,ub,ub
ur,ur,ux,ur,ur,ur,ur,ug,ug,ur,ur,ur,ur,ur,ur,ur,ur,ur,ur,ur,ub,ub,ub
ur,ur,ur,ur,ur,ur,ur,ug,ug,ur,ur,ur,ur,ur,ur,ub,ub,ur,ur,ur,ub,ub,ub
cg,ur,ur,ur,ur,ur,ur,ug,ug,ur,ub,cr,ur,ur,ub,ub,ub,ub,ub,ub,ub,ub,ub
ur,ur,ur,ur,ur,ur,ur,cr,ug,ur,cb,ub,ur,ur,cb,ug,ub,ub,ub,ub,ub,ub,ub
ur,ur,ur,ur,ur,ur,ur,ur,ug,ur,ur,ur,ur,ub,ug,ub,ub,ub,ur,ur,ur,ur,ub
ur,ur,ur,ur,ur,ur,ur,cb,ug,ub,ub,ub,ub,ub,ug,cg,ug,ub,ub,ub,ub,ub,ub
ur,ur,ur,ur,ur,ur,ur,ub,ur,cr,ub,ub,ub,ub,ub,ub,ug,ub,ub,ux,ux,ux,ux
ur,ur,ur,ur,ur,ur,ur,cr,ub,ub,ux,ux,ub,ub,ub,ug,ux,ub,ub,ub,ub,ub,ub
cg,ur,ux,ux,ux,ux,ub,ub,cb,ub,ux,ux,ub,ug,ug,ug,ux,ub,ux,ux,ux,ub,ub
ug,ur,ug,ug,ug,ug,ub,ub,ub,ug,ug,ux,ub,ub,ub,ub,ub,ub,ux,ux,ux,ub,ub
ug,ur,ug,ug,ug,ug,ub,ub,ub,ub,ug,ux,ub,ub,ub,ub,ub,ub,ux,ux,ux,ux,ub
ug,ur,ug,ux,ug,ug,ub,ub,ub,ub,ub,ub,ub,ux,ug,ug,ug,ub,ux,ux,ux,ux,ub
ug,ur,ug,ug,ug,ug,ub,ub,ug,ux,ub,ub,ux,ux,ug,ug,ug,ub,ux,ux,ux,ux,ub
cb,ub,ug,ug,ug,ug,ub,ub,ug,ug,ug,ux,ux,ux,ux,ux,ux,ub,ux,ux,ux,ux,ub
ub,ub,ug,ug,ug,ug,ug,ur,ur,ug,ug,ug,ug,ug,ug,ux,ub,ub,ux,ux,ux,ub,ub
ub,ub,ub,ub,ub,ub,ub,ub,ub,ub,ub,ub,ux,ux,ug,ug,ub,ux,ux,ux,ux,ub,cb
ub,ub,ur,ur,ur,ur,ur,ur,ur,cg,ux,ub,ub,ub,ub,ub,ub,ux,ux,ux,ux,ux,ux