ur,ur,ur,ur,ur,ur,ur,ur,ur,ur,ur,ur,ur,ur,ur,ur,ur,ur,ur,ur,ur,ur,ur
ur,ur,ur,cr,ub,ur,ur,ur,ur,ur,ur,ur,ur,cr,ub,cb,ur,ur,ur,ur,ur,ur,ur
ur,ur,ur,ur,cb,ur,ur,ur,ur,ur,ur,ur,ur,ux,ux,ub,ub,ub,ug,ux,ux,ur,ur
ur,ur,ur,ur,ur,ur,ur,ur,ur,ur,ub,ub,ub,ub,ub,ub,ux,ub,ug,ux,ux,ur,ur
ur,ur,ur,ur,ur,ur,ur,ur,ur,ur,ub,ub,ub,ub,ug,ug,ub,ub,ug,ux,ux,ur,ur
ur,ur,ur,ur,ur,ur,ur,ur,ur,ur,ug,ub,ub,ub,ub,ug,ux,ub,ug,ux,ux,ur,ur
ur,cr,ur,ur,ur,cr,ur,ur,ug,ug,ub,ub,ub,ub,ux,ug,ux,ub,ug,ux,ux,ur,ur
ur,ug,ux,ur,ug,cr,ur,ur,ur,ug,ub,ub,ub,ub,ux,ug,ub,ub,ug,ux,ux,ur,ur
ur,ug,ux,ur,ug,ug,ur,ur,ug,ug,ub,ub,ub,ub,ub,ug,ux,ux,ug,ux,ux,ur,ur
ur,ug,ur,ur,ug,ub,ur,ur,ug,ug,ub,ub,cg,ub,ub,ub,ux,ux,ug,ux,ux,ur,ur
cg,ug,ur,ur,ug,ub,ur,ur,ub,ub,ub,ub,ug,ub,ub,ub,ux,ux,ug,ux,ux,ur,ur
ur,cg,ur,ur,ub,ub,ub,ub,ub,ub,ub,cb,ug,ur,ur,ur,ur,ur,ug,ur,cr,ur,ur
ur,ur,ur,ur,ub,ub,ur,ur,ub,ub,ub,ub,cb,ux,ux,ux,ux,ux,ug,ux,ur,ux,ur
ur,ur,ur,ur,ur,ur,ur,ur,ug,ux,ux,ub,ug,ux,ux,ux,ux,ux,ug,ux,ur,ux,ur
ur,ur,ur,ur,ur,ur,ur,ur,ug,ug,ug,ug,ug,ub,ux,ux,ux,ux,ug,ux,ur,ux,ur
ur,ur,ur,ur,ur,ux,ux,ux,ur,ux,ux,ux,ux,ux,ux,ux,ux,ux,ug,ux,ur,ux,ur
ur,ur,ur,ur,ur,ux,ux,ux,ur,ux,ux,ux,ux,ux,ux,ux,ux,ux,ug,ux,ur,ux,ur
ur,ur,ur,ur,ur,ug,ug,ug,ur,ug,ug,ug,ug,ug,ug,ug,ug,ug,cb,ub,ub,ub,ub
ur,ur,ur,ur,ub,ub,ub,ub,ub,ub,ub,ub,ub,ub,ub,ub,ub,ub,ub,ux,ur,ur,ub
ur,ur,ux,ux,ux,ux,ux,ux,ur,ux,ux,ux,ux,ux,ux,ux,ux,ux,ub,ub,ur,ur,ub
ur,ux,ux,ux,ux,ux,ux,ux,ur,ux,ux,ux,ux,ux,ux,ux,ux,ux,ux,ub,ub,ub,ub
ur,ur,ur,ur,ur,ur,ur,ur,ur,ur,ur,ur,ur,ur,ur,ur,ur,ur,ur,ur,ur,ur,ur
ux,ux,ux,ux,ux,ux,ux,cg,ur,ur,ur,ur,ur,ur,ur,ur,ur,ur,ur,ur,ur,cb,ur