ur,ur,ur,ur,cr,ur,ur,ur,ur,ur,ur,ur,ur,ur,ur,ux,ux,ur,ur,ur,ur,ub,ub
ur,ur,ur,ur,ur,ur,ur,ur,ur,ur,ur,ur,ur,ur,ur,ur,ur,ur,ur,ur,ur,cr,ub
ur,ur,ur,ur,ur,ur,ur,ur,ur,ur,ur,ur,ur,ur,ur,ur,ur,ur,ur,ub,ub,ur,ub
ur,ur,ur,ur,ur,ur,ur,ur,ur,ur,ur,ur,ur,ux,ur,ur,ur,ur,ub,ub,ur,ur,ub
ur,ur,ur,ur,ur,cr,ur,ur,ur,ur,ur,ur,ur,ur,ur,ur,ur,ub,ub,ux,ux,ur,ub
ur,ug,ux,ur,ug,ug,cr,ur,ub,ub,ug,ug,ug,ug,ug,ug,cg,ur,ur,ux,ux,ub,ub
ur,ug,ux,ur,ur,ug,ur,cb,ub,ub,ug,ur,ur,ur,ur,ur,ur,ur,ur,ux,ur,ub,ur
ur,ug,ux,ux,ux,ux,ux,ur,ur,ub,ug,ux,ug,ur,ur,ur,ur,ur,ur,ur,ur,ub,ub
ur,ug,ux,ux,ux,ux,ur,ur,ur,ub,ug,ug,ug,ug,cr,ur,ug,ug,ur,ux,ur,ur,ub
ur,ug,ug,ug,ug,ux,ur,ub,ub,ub,ug,ug,ug,ug,ug,ug,ug,ug,ur,ur,ur,ur,ub
ur,ux,ux,ux,ug,cg,ur,ub,ub,ub,ub,ur,ug,ug,ug,ug,ur,cg,ur,ur,ur,ur,cb
ur,ux,ux,ux,ux,ux,ub,ub,ub,ub,ub,ub,ug,ug,ug,ug,ur,cb,ub,ub,ub,ur,ur
ur,ux,ux,ux,ur,ur,ub,ub,ub,ur,ug,ub,ug,ub,ug,ug,ur,ub,ub,ub,ur,ur,ur
ur,ur,ur,ur,ur,ur,ur,ub,ub,ub,cb,ub,ub,ub,ub,ub,ub,ub,ub,ur,ur,ur,ur
ur,ur,ur,ur,ur,ur,ur,ur,ug,ug,ug,ug,ug,ub,ug,ug,ub,ub,ub,ur,ur,ur,ur
ur,ur,ur,ur,ur,ur,ur,ux,ug,ub,ug,ug,ug,ug,ug,ur,ub,ub,ub,ur,ur,ur,ur
ug,ux,ux,ux,ux,ub,ux,ux,cr,ur,ur,ur,ur,ur,ur,ur,ur,ur,ur,ur,ur,ur,ur
ug,ux,ux,ux,ux,ub,ub,ub,ug,ub,ub,ub,ub,ub,ub,ux,ux,ub,ug,ux,ur,ur,ur
ug,ux,ux,ux,ux,ux,ub,ub,ug,ub,ub,ub,ub,cb,ub,ux,ux,ub,ug,ux,ur,ur,ur
ug,ux,ux,ux,ux,ux,ub,ub,ug,cg,ub,ub,ub,ub,ub,ub,ux,ub,ug,ub,ur,ur,ur
ug,ux,ux,ub,ub,ux,ux,ub,ug,ug,ux,ux,ux,ux,ux,ub,ux,ux,ug,ub,ur,ur,ur
ug,ux,ub,ub,ub,ub,ux,ub,ux,ux,ux,ux,ux,ux,ux,ur,ur,ur,ur,ur,ur,ur,ur
ug,ug,ug,ug,ug,ug,ug,ug,ug,ug,ug,ug,ug,ug,ug,ur,ur,ur,ur,ur,ur,cb,ur