ur,ur,ur,ur,ur,ur,ur,ur,ur,ur,ur,ur,cr,ur,ur,ur,ur,cb,ur,ur,ur,ur,ur
ur,ur,ur,ur,ur,ux,ur,ur,ur,ur,ur,ug,cr,ur,ur,ur,ur,ux,ur,ur,ur,ur,ur
ur,ur,ur,ur,ug,cr,ug,ug,cb,ub,ur,ug,ub,ur,ur,ur,ur,ug,ug,ug,ug,ug,ur
ur,ur,ur,ur,ur,ur,ur,ug,ug,ub,ug,ug,ug,ub,ur,ur,ur,ug,ug,ug,ug,ug,ur
ur,ur,ur,ur,ur,ur,ur,ur,ug,ub,ux,ug,ug,ub,ub,ur,ur,ur,ur,ug,ug,ug,ur
ur,ug,ur,ur,ur,ug,cr,ur,ug,ub,ux,ug,ug,ug,cb,ub,ub,ub,ur,ug,ug,ug,ur
ur,ug,ug,ur,ur,ur,ur,ug,ug,ub,ur,ug,ux,ux,ug,ub,ub,ur,ur,ug,ug,cg,ur
ur,ur,ug,ug,ug,ub,ub,ub,ub,ub,ux,ug,ux,ux,ug,ug,ug,ug,ur,ur,ur,ur,ur
ux,cr,ub,cg,ug,ub,ug,ug,ug,ug,ux,ug,ux,ux,ug,ug,ub,ub,ur,ur,ur,ug,ug
ux,ux,ub,ub,ub,ub,ub,ub,ug,ug,ux,ug,ub,cb,ug,ug,ub,ug,ux,ug,ux,ux,ug
ux,ux,ub,ub,ub,ub,ug,ug,ux,ux,ub,ug,ub,ub,cg,ub,ub,ub,ux,ug,ug,ux,ug
ux,ux,ub,ub,ub,ub,ux,ug,ug,ub,ub,ub,ub,ub,ub,ub,ub,ub,ux,ub,ug,ux,ug
ux,ux,ub,ub,ub,ub,ux,ub,ub,ub,ub,ub,ug,ux,ux,ux,ub,ug,ux,ub,ug,ug,ug
ux,ux,ub,ub,ub,ub,ux,ux,ux,ug,ug,ub,ub,ub,ub,ub,ub,ug,ux,ub,ux,ug,ug
cg,ux,ub,ub,ub,ub,ux,ux,ux,ug,ub,ub,ub,ub,ub,ub,ug,ug,ux,ub,ux,ug,ug
ur,ur,ur,ur,ur,ur,cr,ux,ux,ug,ub,ub,ub,ug,ub,ub,ux,ug,ux,ub,ux,ug,ug
ur,ux,ub,ub,ux,ux,ug,ux,ux,ug,ux,ub,ug,ug,ub,ub,cb,ug,ub,ub,ux,ug,ug
ur,ux,ub,ub,ux,ux,ug,ug,ug,ug,ux,ub,ub,ub,ub,ug,ug,ug,ub,ub,ux,ug,ug
ur,ux,ub,ub,ux,ux,ux,ub,ub,ux,ux,ub,ug,ug,ug,ub,ub,ub,ub,ur,ux,ug,ug
ur,ux,ub,ub,ux,ux,ux,ux,ub,ub,ub,ub,ub,ug,ug,ub,ub,ub,ub,ub,ux,ug,ug
ur,ur,ur,ur,ur,ur,ur,ur,ur,ub,ub,ur,cb,ur,ur,cg,ug,ug,ug,ug,ug,ug,ug
cr,ux,ub,ub,ux,ux,ux,ug,ux,ux,ub,ub,ub,ub,ux,ux,ub,ub,ur,ur,ur,ur,cb
cg,ux,ub,ub,ug,ug,ug,ug,ux,cg,ub,ub,ub,ub,ub,ub,ub,ux,ur,ur,ur,ur,cb