cb,cb,cb,cr,ux,ur,ur,ur,ur,ur,ur,ur,ur,ur,ur,ur,ur,ur,ur,ur,ur,ur,cb
ux,ur,ur,ur,ur,ur,cr,ur,ur,ur,ur,ur,ur,ur,ur,ug,ur,ur,ur,ur,ur,ur,ur
ur,ur,ur,ur,ur,ur,ug,ug,cg,ur,ur,ug,ug,ug,ug,ux,ur,ux,ux,ux,ur,ur,cr
ur,ur,ur,ur,ur,ur,cr,ub,ub,cr,ug,ux,ux,ux,ug,cg,ur,ux,ux,ux,ur,ur,ur
ur,ur,ur,ur,ub,cb,ug,ug,cg,ur,ur,ux,ux,ux,ux,ux,ur,ux,ux,ux,ug,cr,ur
ur,ur,ur,ur,ub,ub,ub,ug,ug,ug,ug,ur,ur,ur,ur,ug,ur,ux,ux,ux,ug,ur,ur
ur,ur,ur,ur,ub,ub,ur,ug,ug,ug,ug,ur,ur,ur,ur,ur,ur,ur,ur,ur,ur,ur,ur
cb,ur,ur,ur,ur,ur,ur,ug,ur,ur,ur,ur,ur,ur,ur,ur,ur,ur,ur,ur,ur,ur,ur
ur,ur,ur,ur,ux,ur,ur,ug,ux,ub,ub,ug,ub,ug,cr,ur,ur,ur,ur,ur,cb,ub,ur
ur,ur,ur,ur,ur,ur,ug,ux,ux,ub,ub,ub,ub,ug,ug,ug,ug,ug,ur,ur,ug,ub,ux
ub,ub,ub,ug,ug,ug,ub,ux,ug,ug,ub,ub,ub,ug,ug,ug,ug,ug,ur,ur,ug,ub,ux
ug,ub,ub,ug,ug,ug,ub,ug,ug,ug,ug,ug,ug,ug,ug,ug,ug,ug,ur,ur,ug,ub,ux
cb,ub,ub,ug,ub,cb,ug,ux,ux,ux,ux,ub,ub,ug,ug,ug,ug,ug,ux,ux,ux,ub,ux
ux,ub,ub,ub,ub,ug,ug,ux,ux,ux,ub,ub,cg,ug,ug,ub,ug,ub,ux,ux,ux,ub,ux
ux,ux,ug,ug,ug,ug,ug,ug,ug,ux,ub,ub,ub,ub,cb,ug,ug,ub,ux,ux,ux,ub,ux
ux,ux,ug,ux,ug,ug,ug,ub,ub,ub,ub,ub,ux,ub,ub,ub,ub,ux,ux,ux,ux,ub,ux
ux,ux,ug,ux,ug,ug,cg,ug,ug,ub,cb,ub,ub,ub,ub,ug,ug,ug,ug,ug,ux,ub,ux
cr,ux,ug,ug,ug,ug,ug,ug,ub,ub,ub,ub,ub,ub,ub,ug,ug,ug,ug,ug,ux,ub,ux
cg,ux,ug,ux,ug,ug,ug,ug,ub,ub,ub,ub,ub,ub,ug,ub,ub,ub,ub,ub,ux,ub,ub
cb,ux,ug,ux,ug,ub,ug,ug,ub,ub,ub,ub,ub,ub,ub,ub,ub,ub,ub,ub,ub,ub,ub
ux,ux,ug,ug,ug,ug,ug,ug,ub,ub,ub,ub,ub,ux,ux,ux,ux,ux,ux,ux,ux,ux,cr
cr,ux,ug,ug,ux,ub,ub,ug,ug,ug,ub,ub,ux,ux,ux,ux,ux,cb,cg,ux,cb,ux,cr
cg,cb,cg,cb,ux,ub,ub,ux,ub,ub,ub,ub,ux,ux,ux,cg,ux,ux,ux,cg,cg,ux,cr