ur,cb,cb,cr,ux,ux,ux,ur,ur,ur,ur,ur,ur,ur,ur,cr,ur,ur,ur,ur,ur,ur,cb
ur,ur,cb,ur,ur,ur,ur,ur,ur,ur,ur,ur,cg,ug,ug,ur,cb,ur,ur,ur,ur,ur,ur
ur,ur,ur,ur,ur,ur,ur,ur,ur,ur,ur,ur,ur,ur,ub,ur,ub,ur,ur,ur,ur,ur,ur
ur,ur,ur,ur,ur,ur,ux,ur,ur,ur,ur,ug,ur,ur,cr,ug,ub,ur,ur,cg,ug,ur,ur
ub,cb,ur,ur,ur,ur,ur,ur,ur,ur,ur,ug,ur,ur,ur,ur,ub,ur,ur,ur,cr,ur,ur
ub,ur,ur,ur,ur,ur,ur,ur,ur,ur,ur,ug,ur,ur,ur,ur,ub,ub,ur,ur,ur,ub,ub
ub,ub,ur,ur,cr,ur,ur,ur,ur,ur,ub,ug,ur,cb,ug,ug,ub,ub,ug,ug,ug,ur,ub
cb,ub,ub,ux,ux,ug,ug,ub,cr,cg,ug,ug,ub,ub,ug,ub,ub,ug,ug,ug,ug,ur,ur
ub,ub,ub,ux,ux,ug,ug,ur,ub,ub,ur,ub,ug,ug,ug,ug,ug,ug,ub,ub,ug,ur,ur
ub,ub,ub,ux,ux,ug,ug,cg,ug,ug,ur,ub,ug,ug,ug,ug,ug,ug,ub,ub,ur,ur,ur
ux,ux,ux,ux,ux,ug,ug,ug,cb,ub,ub,ub,ug,ug,ug,ug,ug,ub,ug,ug,ug,ur,ur
ux,ux,ux,ux,ux,ug,ux,ug,ub,ub,ub,cb,ug,ug,ug,ug,ub,ub,ug,ux,ug,ur,ur
cb,ux,ux,ux,ux,ug,ug,ug,ub,ub,ub,ub,ug,ug,ug,ug,ug,ug,ug,cg,ug,ur,ur
ux,ux,ux,ux,ug,ug,ug,ug,ub,ug,ub,ug,ug,ug,ug,ug,ug,ug,ug,ux,ur,ur,ur
ux,ug,ug,ug,ug,ug,ug,ug,ug,ug,ug,ug,ug,ug,ug,ug,ug,ug,ug,ug,ur,ur,ur
ux,ug,ug,ug,ug,ug,ug,ug,ug,ug,ug,ug,ug,ug,ub,ub,ug,ug,ug,ug,ur,ur,ur
ux,ug,ug,ug,ug,ug,ug,ug,ug,ug,ug,ug,ug,ug,ux,ux,ub,ux,ux,ux,ur,ur,ur
ux,ug,ug,ug,ux,ux,ug,ug,ug,ug,ug,ug,ux,ug,ux,ux,ub,ux,ux,ux,ur,ur,ur
ux,ux,ug,ug,ux,cg,ug,ug,ug,ug,ug,ug,ug,ug,ux,ux,ub,ux,ux,ux,ur,ur,ur
cr,ur,ur,ur,ur,ug,ug,ug,ug,ug,ug,ur,ur,ur,ur,ur,ur,ur,ur,ur,ur,ur,ur
cg,ur,ux,ux,ux,ug,ug,ug,ug,ug,ug,ug,ug,ug,ux,ux,ub,ux,ux,ux,ur,ur,cr
cr,ur,ur,ur,cr,ug,ug,ug,ug,ug,ug,ug,ug,ug,ub,ub,ub,ub,ub,cb,cb,ur,cr
cg,ur,cg,cb,ux,ux,ux,ux,ux,ux,ux,ux,ux,ux,ux,cg,ub,ub,ub,cg,cg,cb,cr