ur,ur,ur,ur,ur,ur,ur,ur,ur,ur,ur,ur,ur,ur,ur,ur,ur,ur,ur,ur,ur,ur,ur
ur,ur,ur,ur,ug,ug,ur,ur,ur,ur,ur,ur,ur,ur,ur,ur,ur,ur,ur,ur,ur,ur,ur
ur,ug,ug,ur,ug,ug,ur,ur,ur,ur,ur,ur,ux,cr,ur,ur,ux,ux,ur,ur,ur,ur,ur
ur,ug,ug,ug,ug,cg,ur,ur,ur,ur,ur,ur,ur,cr,ur,cr,ur,ur,ur,ur,cr,ux,cr
ux,ug,ug,ug,ug,ug,ur,ur,ur,ur,ur,ur,ur,ur,ur,ur,ur,cr,ub,cb,ux,ux,ux
ux,ux,ux,ux,ur,ug,ur,ur,ur,ur,ur,ur,ur,ur,ur,ur,ub,ub,ux,ux,ux,ux,ux
ux,ux,ur,ur,ur,ur,ur,ur,ur,ur,ur,ur,ur,ur,ur,ur,ux,ux,ux,ux,ux,ux,ux
ux,ux,ur,ur,ur,ur,ur,ux,ug,cg,ur,ur,ur,ur,ur,ur,ux,ux,ux,ug,ux,ux,cb
cg,ur,ur,ur,ur,ur,ur,ur,ug,ur,ub,ur,ur,ur,ug,ur,ux,ux,ux,ug,ux,ux,ux
ur,ur,ur,ur,ur,ur,ur,ur,ug,ur,ub,cb,ur,ug,ug,ur,ug,ug,ug,ur,ur,ux,ux
ur,ur,ur,ur,ur,ur,ur,ur,ug,ur,ub,ur,ug,ug,ub,ur,ug,ux,ug,ug,ur,ux,ux
ur,ur,ur,ur,ur,ur,ur,ur,ug,ur,ub,ur,ub,ub,ub,cb,ux,ux,ug,ub,ur,ux,ux
ur,ur,ub,ub,ug,ur,ur,ur,ug,ur,ug,ug,ug,ub,ub,ub,ux,ux,ug,ub,ur,ub,ux
ur,ur,ur,ur,ug,ur,ur,ur,ug,ur,ug,ur,ug,ug,ub,ub,ub,ub,ug,ug,ur,ur,ur
cg,ur,ur,ur,ug,ur,ur,ur,ug,ub,ug,ub,ub,ub,ub,ur,ug,ug,ug,ux,ux,ux,ur
ur,ur,ur,ur,ug,ug,ug,ux,ug,ux,ug,ub,ub,ub,ub,ur,ug,ug,ug,ug,ug,ug,ur
ur,ur,ur,ux,ub,ub,ug,ub,ug,ug,ug,ub,ub,ub,ub,ur,ug,ug,ub,cb,ux,ux,ur
ux,ux,ug,ug,ug,ug,ug,ub,ug,ub,ug,cg,ub,ub,ub,ub,ub,ub,ub,ux,ux,ub,ur
ux,ux,ug,ux,ux,ug,ug,ub,ug,ub,ub,ug,ux,ux,ux,ur,ux,ux,ux,ub,ub,ub,ur
ux,ux,ug,ux,ux,ux,ux,ub,ug,ub,ub,ub,ux,ub,ub,ur,ub,ub,ub,ub,ux,ux,ur
ux,ux,ug,ug,ub,ug,ug,ux,ug,ub,ub,ub,ux,ub,ub,ur,ub,ub,ub,ub,ub,ub,ur
ux,ux,ub,ub,ub,ub,ub,ub,ub,ub,ub,ub,ub,ub,ub,ur,ub,ub,ub,ub,ub,ub,ur
ux,ux,ux,ux,ux,cb,ux,ub,ux,cg,ub,ub,ub,ub,ub,ur,ur,ur,ur,ur,ur,ur,ur