ur,ur,ur,ur,ur,ur,ur,ur,ur,cr,ub,cb,ux,ur,ur,ur,ur,ur,ur,ur,ur,ur,ur
ur,ur,ur,ur,ur,ur,ur,ur,ur,ur,ur,ur,ur,ur,ur,ur,ur,cr,ur,ur,ur,ur,ur
ur,ur,ub,cb,ur,ur,ur,ur,ur,ur,ur,ur,ur,ur,ur,ur,ur,ur,ur,ur,ur,ur,ur
ur,cr,ub,cr,ur,ur,ur,ur,ur,ur,ur,ur,ur,ur,ug,ug,ur,ur,ur,ur,ux,ur,ux
ur,ur,ug,ur,ur,ur,ur,ur,ur,ur,ur,ub,ub,cb,cr,cg,ur,ub,ur,ur,ur,ur,ur
ur,ur,cg,ur,ur,ur,ux,ub,ub,ub,ub,ub,ub,ub,ur,ur,ur,ub,ur,ur,ur,ur,ur
ug,ug,ux,ux,ub,ub,ug,ub,ub,ub,ur,ub,ub,ub,ur,cb,ub,ub,ur,ur,ur,ux,ux
ub,ug,ur,ub,ub,ug,ug,ug,ug,ug,ur,ub,ub,ub,ur,ur,ug,ug,ug,ug,ug,ux,ux
cg,ug,ub,ub,ug,ug,ug,ug,ug,ug,ur,ub,ub,cb,ub,ur,ug,ug,ug,ug,ug,ux,ux
ux,ug,ur,ur,ug,ur,ub,ug,ug,ug,ug,ug,ub,ub,ub,ub,ub,ub,ub,ub,ug,ux,ux
ug,ug,ur,ur,ug,ug,ug,ug,ug,ug,ug,ug,ub,ub,ub,ub,ub,ug,ug,ug,ux,ux,ux
ug,ur,ur,ur,ug,ug,ub,ub,ug,ug,ub,ub,ug,ug,cg,ub,ub,ug,ug,ug,ux,ux,ux
ug,ug,ug,ug,ug,ug,ur,ug,ur,ug,ub,ub,ug,ug,ug,ub,ux,ug,ug,ug,ux,ux,ux
ux,ux,ux,ux,ug,ug,ug,ug,ur,ug,ug,ug,ug,ub,ub,ux,ux,ux,ux,ux,ux,ux,ux
cg,ux,ux,ux,ug,ux,ug,ug,ug,ug,ug,ug,ug,ug,ug,ug,ug,ug,ug,ug,ub,ub,ub
ux,ux,ug,ux,ug,ux,ux,ug,ux,ux,ub,ux,ux,ux,ug,ug,ug,ug,ug,ug,ug,ux,ub
ux,ux,ug,ux,ug,ux,ux,ug,cr,ux,ub,ux,ux,ux,ug,ug,ug,ug,ug,ug,ug,ux,ub
ux,ux,ug,ux,ug,ux,ux,ug,ur,ux,ub,ux,ux,ux,ug,ug,ug,ub,ux,ug,ug,ux,ub
ux,ux,ug,ug,ug,ug,ug,ug,ur,ux,ub,ux,ux,ux,ux,ub,ug,ug,ux,ug,ug,ux,ub
ux,ux,ug,ug,ug,ux,ux,ux,ur,ux,ub,ux,ux,ux,ux,ux,ux,ug,ug,ug,ug,ux,ub
ub,ub,ub,ub,ub,ub,ub,ub,ur,ub,ub,ub,ub,ub,ub,ub,ub,ub,ub,ub,ub,ub,ub
ub,cb,ub,ub,ub,ub,ub,ux,ur,ux,ub,ub,ub,ub,ub,ub,ub,ub,ub,ub,ub,ux,ux
ub,ub,ub,ub,ub,ub,ub,ur,ur,cg,ub,ub,ub,ub,ub,ub,ub,ub,ub,ub,ub,ux,ux