ub,ub,ub,ub,ub,ub,ub,ub,ub,ub,ub,ub,ub,ub,ub,ub,ub,ub,ub,ub,ub,ub,ub
ub,ub,ub,ub,ur,ur,ur,ur,ur,ur,ur,ur,ur,ux,ux,ux,ux,ur,ur,ur,ur,ur,ub
ur,ur,ur,ub,ub,ub,ub,ub,ub,ub,ub,ub,ub,ub,cb,ur,ur,ur,ur,ur,ur,ur,ub
ur,ur,ur,cg,ug,ug,ug,ug,cr,ur,ur,ur,ur,ur,ur,ur,ur,ur,ur,cr,ub,ur,ub
ur,ur,ur,ur,ur,ur,ur,ur,ur,ur,ur,ur,ur,ur,ur,ur,ur,ur,ur,ur,ub,ur,ub
ur,ur,ur,ur,ur,ur,ur,ur,ur,cr,ur,ur,ur,ur,ug,ug,ug,ub,ub,ur,cb,ub,ub
ur,ur,ur,ur,ur,ur,ur,ur,ur,ub,ur,ur,ur,ur,cr,ub,cg,ub,ub,ub,ub,ub,ub
ur,ur,ur,ur,ur,ur,ur,ur,ur,ub,ur,ur,cr,ug,ug,ug,ug,ug,ub,ub,ub,ub,ub
cg,ur,ur,ur,ur,ur,ur,ur,ur,ub,cb,ub,ub,ux,ug,ug,ug,ug,ub,ux,ux,ux,ub
ux,ug,ug,ub,cb,ug,ug,cr,ur,ur,cb,ub,ub,ub,ux,ux,ux,ux,ub,ux,ux,ux,ub
ux,ug,ux,ub,ux,ug,ux,ux,ux,ub,ur,ub,ub,ub,ub,ub,ub,ux,ub,ux,ux,ux,ub
ux,ug,ub,ub,ux,ug,ux,ux,ux,ux,ur,ub,ub,ub,ux,ux,ub,ux,ub,ux,ux,ux,ub
ux,ub,ub,ux,ux,ug,ux,ux,ux,ux,ur,ux,ug,ub,cb,ub,ub,ux,ub,ux,ux,ux,ub
ux,ub,ub,ub,ux,ug,ux,ux,ux,ux,ur,ux,ug,ux,ub,ub,ub,ub,ub,ux,ux,ux,ub
cg,ub,ub,ub,ux,ug,ux,ux,ux,ux,ur,ux,ug,ux,ux,ux,ub,ub,ux,ux,ux,ux,ub
ub,ub,ub,ug,ux,ug,ux,ux,ux,ux,ur,ux,ug,ux,ux,ux,ub,ub,ux,ux,ux,ux,ub
ub,ug,ub,ug,ug,ug,ux,ux,ux,ux,ur,ux,ug,ug,ux,ux,ub,ub,ux,ux,ux,ux,ub
ub,ug,ub,ub,ub,ub,ub,ub,ub,ub,ur,ub,ub,ub,ub,ub,ub,ub,ub,ub,ub,ub,ub
ub,ug,ux,ux,ug,ug,ux,ux,ux,ug,ur,ug,ug,ug,ux,ux,ux,ux,ux,ux,ux,ux,ur
ub,ug,ux,ux,ux,ux,ux,ux,ux,ux,ur,ux,ux,ux,ux,ux,ux,ux,ux,ux,ux,ux,ur
ur,ug,ur,ur,ur,ur,ur,ur,ur,ur,ur,ur,ur,ur,ur,ur,ur,ur,ur,ur,ur,ur,ur
ur,ug,ub,ux,ux,ux,ux,ux,cg,ur,ur,ur,ur,ur,ur,ur,ur,ur,ur,ur,ur,ur,cb
ur,ug,ug,ug,ug,ug,ug,ug,ug,cg,ur,ur,ur,ur,ur,ur,ur,ur,ur,ur,ur,ur,ur